GEO_ID,NAME_x,P003001,P003002,P003003,P003004,P003005,P003006,P003007,P003008,P005001,P005002,P005003,P005004,P005005,P005006,P005007,P005008,P005009,P005010,P005011,P005012,P005013,P005014,P005015,P005016,P005017,GEOID10,DISTRICT,PSA,NAME,POLDIST_ID,GIS_ID,SECTOR
1000000US110010040021000,"Block 1000, Block Group 1, Census Tract 40.02, District of Columbia, District of Columbia",273,199,24,0,10,1,22,17,273,216,182,12,0,10,1,0,11,57,17,12,0,0,0,22,6,110010040021000,3,303,303,3,psa_37,3D3
1000000US110010040021001,"Block 1001, Block Group 1, Census Tract 40.02, District of Columbia, District of Columbia",407,346,27,1,17,0,9,7,407,362,313,23,1,17,0,1,7,45,33,4,0,0,0,8,0,110010040021001,3,303,303,3,psa_37,3D3
1000000US110010040022000,"Block 2000, Block Group 2, Census Tract 40.02, District of Columbia, District of Columbia",464,377,39,0,30,0,9,9,464,430,355,39,0,28,0,0,8,34,22,0,0,2,0,9,1,110010040022000,3,303,303,3,psa_37,3D3
1000000US110010040022001,"Block 2001, Block Group 2, Census Tract 40.02, District of Columbia, District of Columbia",345,298,26,0,7,0,2,12,345,325,282,25,0,7,0,0,11,20,16,1,0,0,0,2,1,110010040022001,3,303,303,3,psa_37,3D3
1000000US110010040022003,"Block 2003, Block Group 2, Census Tract 40.02, District of Columbia, District of Columbia",315,239,24,1,35,0,9,7,315,288,221,24,1,35,0,0,7,27,18,0,0,0,0,9,0,110010040022003,3,303,303,3,psa_37,3D3
1000000US110010042011004,"Block 1004, Block Group 1, Census Tract 42.01, District of Columbia, District of Columbia",211,165,18,1,19,0,5,3,211,188,150,18,1,18,0,0,1,23,15,0,0,1,0,5,2,110010042011004,3,301,301,3,psa_31,3D3
1000000US110010042011005,"Block 1005, Block Group 1, Census Tract 42.01, District of Columbia, District of Columbia",117,93,14,0,10,0,0,0,117,107,83,14,0,10,0,0,0,10,10,0,0,0,0,0,0,110010042011005,3,301,301,3,psa_31,3D3
1000000US110010042022000,"Block 2000, Block Group 2, Census Tract 42.02, District of Columbia, District of Columbia",206,165,7,0,25,0,3,6,206,190,156,6,0,25,0,2,1,16,9,1,0,0,0,1,5,110010042022000,2,208,208,2,psa_33,2D3
1000000US110010042022002,"Block 2002, Block Group 2, Census Tract 42.02, District of Columbia, District of Columbia",168,137,11,0,9,0,6,5,168,144,120,11,0,9,0,0,4,24,17,0,0,0,0,6,1,110010042022002,2,208,208,2,psa_33,2D3
1000000US110010042022003,"Block 2003, Block Group 2, Census Tract 42.02, District of Columbia, District of Columbia",157,109,25,2,8,0,5,8,157,137,94,25,2,8,0,1,7,20,15,0,0,0,0,4,1,110010042022003,2,208,208,2,psa_33,2D3
1000000US110010043002000,"Block 2000, Block Group 2, Census Tract 43, District of Columbia, District of Columbia",147,63,15,2,6,0,60,1,147,68,44,15,1,6,0,2,0,79,19,0,1,0,0,58,1,110010043002000,3,301,301,3,psa_31,3D3
1000000US110010043002001,"Block 2001, Block Group 2, Census Tract 43, District of Columbia, District of Columbia",225,43,147,0,8,0,21,6,225,193,38,144,0,8,0,2,1,32,5,3,0,0,0,19,5,110010043002001,3,301,301,3,psa_31,3D3
1000000US110010044001011,"Block 1011, Block Group 1, Census Tract 44, District of Columbia, District of Columbia",42,28,10,0,2,0,0,2,42,39,25,10,0,2,0,0,2,3,3,0,0,0,0,0,0,110010044001011,3,305,305,3,psa_32,3D2
1000000US110010044001012,"Block 1012, Block Group 1, Census Tract 44, District of Columbia, District of Columbia",234,168,32,0,21,0,5,8,234,218,158,31,0,21,0,0,8,16,10,1,0,0,0,5,0,110010044001012,3,305,305,3,psa_32,3D2
1000000US110010044002012,"Block 2012, Block Group 2, Census Tract 44, District of Columbia, District of Columbia",34,22,8,0,0,0,2,2,34,31,20,8,0,0,0,1,2,3,2,0,0,0,0,1,0,110010044002012,3,305,305,3,psa_32,3D2
1000000US110010044002014,"Block 2014, Block Group 2, Census Tract 44, District of Columbia, District of Columbia",5,3,2,0,0,0,0,0,5,5,3,2,0,0,0,0,0,0,0,0,0,0,0,0,0,110010044002014,3,305,305,3,psa_32,3D2
1000000US110010047011000,"Block 1000, Block Group 1, Census Tract 47.01, District of Columbia, District of Columbia",468,8,437,1,9,0,4,9,468,461,7,435,1,9,0,1,8,7,1,2,0,0,0,3,1,110010047011000,1,102,102,1,psa_18,1D1
1000000US110010047011002,"Block 1002, Block Group 1, Census Tract 47.01, District of Columbia, District of Columbia",207,0,187,2,18,0,0,0,207,207,0,187,2,18,0,0,0,0,0,0,0,0,0,0,0,110010047011002,1,102,102,1,psa_18,1D1
1000000US110010047011003,"Block 1003, Block Group 1, Census Tract 47.01, District of Columbia, District of Columbia",169,0,169,0,0,0,0,0,169,162,0,162,0,0,0,0,0,7,0,7,0,0,0,0,0,110010047011003,1,102,102,1,psa_18,1D1
1000000US110010047021012,"Block 1012, Block Group 1, Census Tract 47.02, District of Columbia, District of Columbia",427,307,46,0,59,1,3,11,427,401,285,46,0,59,1,1,9,26,22,0,0,0,0,2,2,110010047021012,1,101,101,1,psa_20,1D1
1000000US110010047021013,"Block 1013, Block Group 1, Census Tract 47.02, District of Columbia, District of Columbia",79,71,4,0,1,0,1,2,79,68,61,4,0,1,0,0,2,11,10,0,0,0,0,1,0,110010047021013,1,101,101,1,psa_20,1D1
1000000US110010048011006,"Block 1006, Block Group 1, Census Tract 48.01, District of Columbia, District of Columbia",1,0,0,0,1,0,0,0,1,1,0,0,0,1,0,0,0,0,0,0,0,0,0,0,0,110010048011006,3,308,308,3,psa_27,3D2
1000000US110010048011017,"Block 1017, Block Group 1, Census Tract 48.01, District of Columbia, District of Columbia",210,105,84,0,12,0,0,9,210,197,95,83,0,12,0,0,7,13,10,1,0,0,0,0,2,110010048011017,3,308,308,3,psa_27,3D2
1000000US110010048021006,"Block 1006, Block Group 1, Census Tract 48.02, District of Columbia, District of Columbia",407,282,55,1,41,1,17,10,407,375,269,55,1,41,0,0,9,32,13,0,0,0,1,17,1,110010048021006,3,308,308,3,psa_27,3D2
1000000US110010048021008,"Block 1008, Block Group 1, Census Tract 48.02, District of Columbia, District of Columbia",2,1,0,1,0,0,0,0,2,1,1,0,0,0,0,0,0,1,0,0,1,0,0,0,0,110010048021008,3,308,308,3,psa_27,3D2
1000000US110010048022004,"Block 2004, Block Group 2, Census Tract 48.02, District of Columbia, District of Columbia",247,156,46,1,31,0,3,10,247,234,146,46,1,30,0,1,10,13,10,0,0,1,0,2,0,110010048022004,3,308,308,3,psa_27,3D2
1000000US110010048022005,"Block 2005, Block Group 2, Census Tract 48.02, District of Columbia, District of Columbia",140,16,106,0,11,0,4,3,140,133,16,106,0,11,0,0,0,7,0,0,0,0,0,4,3,110010048022005,3,308,308,3,psa_27,3D2
1000000US110010048022007,"Block 2007, Block Group 2, Census Tract 48.02, District of Columbia, District of Columbia",17,8,5,0,0,0,1,3,17,15,7,5,0,0,0,0,3,2,1,0,0,0,0,1,0,110010048022007,3,308,308,3,psa_27,3D2
1000000US110010049021004,"Block 1004, Block Group 1, Census Tract 49.02, District of Columbia, District of Columbia",41,39,0,0,2,0,0,0,41,41,39,0,0,2,0,0,0,0,0,0,0,0,0,0,0,110010049021004,3,307,307,3,psa_28,3D3
1000000US110010049021007,"Block 1007, Block Group 1, Census Tract 49.02, District of Columbia, District of Columbia",0,0,0,0,0,0,0,0,0,0,0,0,0,0,0,0,0,0,0,0,0,0,0,0,0,110010049021007,3,307,307,3,psa_28,3D3
1000000US110010049022007,"Block 2007, Block Group 2, Census Tract 49.02, District of Columbia, District of Columbia",521,336,97,2,45,4,18,19,521,471,313,97,2,45,0,2,12,50,23,0,0,0,4,16,7,110010049022007,3,307,307,3,psa_28,3D3
1000000US110010049022008,"Block 2008, Block Group 2, Census Tract 49.02, District of Columbia, District of Columbia",295,206,28,0,30,0,24,7,295,260,190,28,0,30,0,6,6,35,16,0,0,0,0,18,1,110010049022008,3,307,307,3,psa_28,3D3
1000000US110010050011007,"Block 1007, Block Group 1, Census Tract 50.01, District of Columbia, District of Columbia",161,113,33,1,4,0,0,10,161,153,107,33,1,4,0,0,8,8,6,0,0,0,0,0,2,110010050011007,3,307,307,3,psa_28,3D3
1000000US110010050012004,"Block 2004, Block Group 2, Census Tract 50.01, District of Columbia, District of Columbia",155,115,19,2,11,0,0,8,155,147,111,18,0,11,0,0,7,8,4,1,2,0,0,0,1,110010050012004,3,307,307,3,psa_28,3D3
1000000US110010050021001,"Block 1001, Block Group 1, Census Tract 50.02, District of Columbia, District of Columbia",658,425,64,3,49,0,95,22,658,510,380,64,3,49,0,1,13,148,45,0,0,0,0,94,9,110010050021001,3,307,307,3,psa_28,3D3
1000000US110010050021002,"Block 1002, Block Group 1, Census Tract 50.02, District of Columbia, District of Columbia",658,92,454,4,8,1,85,14,658,543,74,453,1,8,0,0,7,115,18,1,3,0,1,85,7,110010050021002,3,307,307,3,psa_28,3D3
1000000US110010050022001,"Block 2001, Block Group 2, Census Tract 50.02, District of Columbia, District of Columbia",380,157,168,0,7,0,27,21,380,332,143,163,0,7,0,1,18,48,14,5,0,0,0,26,3,110010050022001,3,307,307,3,psa_28,3D3
1000000US110010050023001,"Block 3001, Block Group 3, Census Tract 50.02, District of Columbia, District of Columbia",67,54,6,0,2,0,2,3,67,61,51,6,0,2,0,0,2,6,3,0,0,0,0,2,1,110010050023001,3,307,307,3,psa_28,3D3
1000000US110010050023002,"Block 3002, Block Group 3, Census Tract 50.02, District of Columbia, District of Columbia",7,1,0,0,0,0,6,0,7,1,1,0,0,0,0,0,0,6,0,0,0,0,0,6,0,110010050023002,3,307,307,3,psa_28,3D3
1000000US110010050023004,"Block 3004, Block Group 3, Census Tract 50.02, District of Columbia, District of Columbia",155,106,8,0,13,0,24,4,155,124,101,8,0,13,0,0,2,31,5,0,0,0,0,24,2,110010050023004,3,307,307,3,psa_28,3D3
1000000US110010050023008,"Block 3008, Block Group 3, Census Tract 50.02, District of Columbia, District of Columbia",23,23,0,0,0,0,0,0,23,22,22,0,0,0,0,0,0,1,1,0,0,0,0,0,0,110010050023008,3,307,307,3,psa_28,3D3
1000000US110010050024000,"Block 4000, Block Group 4, Census Tract 50.02, District of Columbia, District of Columbia",780,253,40,0,49,0,408,30,780,250,160,30,0,47,0,6,7,530,93,10,0,2,0,402,23,110010050024000,3,307,307,3,psa_28,3D3
1000000US110010050024001,"Block 4001, Block Group 4, Census Tract 50.02, District of Columbia, District of Columbia",170,117,9,0,20,0,14,10,170,131,98,8,0,20,0,1,4,39,19,1,0,0,0,13,6,110010050024001,3,307,307,3,psa_28,3D3
1000000US110010052011001,"Block 1001, Block Group 1, Census Tract 52.01, District of Columbia, District of Columbia",495,381,35,2,49,0,12,16,495,451,354,34,1,48,0,2,12,44,27,1,1,1,0,10,4,110010052011001,2,208,208,2,psa_33,2D3
1000000US110010052011002,"Block 1002, Block Group 1, Census Tract 52.01, District of Columbia, District of Columbia",475,385,35,2,37,0,4,12,475,440,362,32,2,36,0,0,8,35,23,3,0,1,0,4,4,110010052011002,2,208,208,2,psa_33,2D3
1000000US110010052013000,"Block 3000, Block Group 3, Census Tract 52.01, District of Columbia, District of Columbia",211,148,30,0,11,0,13,9,211,182,132,29,0,11,0,2,8,29,16,1,0,0,0,11,1,110010052013000,2,208,208,2,psa_33,2D3
1000000US110010052013001,"Block 3001, Block Group 3, Census Tract 52.01, District of Columbia, District of Columbia",661,537,38,2,54,0,11,19,661,597,487,36,2,53,0,2,17,64,50,2,0,1,0,9,2,110010052013001,2,208,208,2,psa_33,2D3
1000000US110010053014002,"Block 4002, Block Group 4, Census Tract 53.01, District of Columbia, District of Columbia",167,132,3,0,15,0,11,6,167,150,123,3,0,15,0,3,6,17,9,0,0,0,0,8,0,110010053014002,3,301,301,3,psa_31,3D3
1000000US110010053014005,"Block 4005, Block Group 4, Census Tract 53.01, District of Columbia, District of Columbia",403,299,15,8,47,1,24,9,403,356,282,15,2,46,1,2,8,47,17,0,6,1,0,22,1,110010053014005,3,301,301,3,psa_31,3D3
1000000US110010055003001,"Block 3001, Block Group 3, Census Tract 55, District of Columbia, District of Columbia",363,316,5,1,24,0,5,12,363,343,303,5,0,24,0,1,10,20,13,0,1,0,0,4,2,110010055003001,2,208,208,2,psa_33,2D3
1000000US110010055003007,"Block 3007, Block Group 3, Census Tract 55, District of Columbia, District of Columbia",1,1,0,0,0,0,0,0,1,1,1,0,0,0,0,0,0,0,0,0,0,0,0,0,0,110010055003007,2,208,208,2,psa_33,2D3
1000000US110010056001002,"Block 1002, Block Group 1, Census Tract 56, District of Columbia, District of Columbia",369,298,17,1,31,0,6,16,369,339,277,16,1,30,0,1,14,30,21,1,0,1,0,5,2,110010056001002,2,207,207,2,psa_24,2D3
1000000US110010056001003,"Block 1003, Block Group 1, Census Tract 56, District of Columbia, District of Columbia",40,40,0,0,0,0,0,0,40,39,39,0,0,0,0,0,0,1,1,0,0,0,0,0,0,110010056001003,2,207,207,2,psa_24,2D3
1000000US110010056001006,"Block 1006, Block Group 1, Census Tract 56, District of Columbia, District of Columbia",300,204,11,0,70,0,7,8,300,277,190,10,0,70,0,1,6,23,14,1,0,0,0,6,2,110010056001006,2,207,207,2,psa_24,2D3
1000000US110010056001007,"Block 1007, Block Group 1, Census Tract 56, District of Columbia, District of Columbia",434,335,14,1,56,0,11,17,434,401,319,12,1,56,0,2,11,33,16,2,0,0,0,9,6,110010056001007,2,207,207,2,psa_24,2D3
1000000US110010056002000,"Block 2000, Block Group 2, Census Tract 56, District of Columbia, District of Columbia",115,96,3,0,10,0,0,6,115,105,86,3,0,10,0,0,6,10,10,0,0,0,0,0,0,110010056002000,2,207,207,2,psa_24,2D3
1000000US110010056002005,"Block 2005, Block Group 2, Census Tract 56, District of Columbia, District of Columbia",671,577,29,0,54,0,4,7,671,642,551,29,0,54,0,2,6,29,26,0,0,0,0,2,1,110010056002005,2,207,207,2,psa_24,2D3
1000000US110010056002012,"Block 2012, Block Group 2, Census Tract 56, District of Columbia, District of Columbia",1,0,0,0,0,0,1,0,1,1,0,0,0,0,0,1,0,0,0,0,0,0,0,0,0,110010056002012,2,207,207,2,psa_24,2D3
1000000US110010056002017,"Block 2017, Block Group 2, Census Tract 56, District of Columbia, District of Columbia",447,357,21,0,52,0,2,15,447,411,323,21,0,52,0,1,14,36,34,0,0,0,0,1,1,110010056002017,2,207,207,2,psa_24,2D3
1000000US110010056003002,"Block 3002, Block Group 3, Census Tract 56, District of Columbia, District of Columbia",346,284,10,0,39,0,6,7,346,322,269,10,0,39,0,0,4,24,15,0,0,0,0,6,3,110010056003002,2,207,207,2,psa_24,2D3
1000000US110010056004001,"Block 4001, Block Group 4, Census Tract 56, District of Columbia, District of Columbia",634,513,37,0,47,0,8,29,634,609,500,32,0,45,0,4,28,25,13,5,0,2,0,4,1,110010056004001,2,207,207,2,psa_24,2D3
1000000US110010056004002,"Block 4002, Block Group 4, Census Tract 56, District of Columbia, District of Columbia",119,86,4,3,24,0,0,2,119,111,80,4,3,24,0,0,0,8,6,0,0,0,0,0,2,110010056004002,2,207,207,2,psa_24,2D3
1000000US110010056004004,"Block 4004, Block Group 4, Census Tract 56, District of Columbia, District of Columbia",360,233,16,0,93,0,0,18,360,341,219,15,0,93,0,0,14,19,14,1,0,0,0,0,4,110010056004004,2,207,207,2,psa_24,2D3
1000000US110010058001017,"Block 1017, Block Group 1, Census Tract 58, District of Columbia, District of Columbia",9,7,1,0,0,0,0,1,9,9,7,1,0,0,0,0,1,0,0,0,0,0,0,0,0,110010058001017,2,209,209,2,psa_57,2D3
1000000US110010058001018,"Block 1018, Block Group 1, Census Tract 58, District of Columbia, District of Columbia",63,53,9,0,0,0,1,0,63,61,52,9,0,0,0,0,0,2,1,0,0,0,0,1,0,110010058001018,2,209,209,2,psa_57,2D3
1000000US110010058001026,"Block 1026, Block Group 1, Census Tract 58, District of Columbia, District of Columbia",299,239,25,0,19,0,5,11,299,267,219,24,0,18,0,1,5,32,20,1,0,1,0,4,6,110010058001026,1,102,102,1,psa_18,1D1
1000000US110010058001027,"Block 1027, Block Group 1, Census Tract 58, District of Columbia, District of Columbia",54,48,1,0,3,0,1,1,54,50,45,1,0,3,0,0,1,4,3,0,0,0,0,1,0,110010058001027,1,102,102,1,psa_18,1D1
1000000US110010059001008,"Block 1008, Block Group 1, Census Tract 59, District of Columbia, District of Columbia",127,51,16,0,14,0,40,6,127,79,46,16,0,14,0,0,3,48,5,0,0,0,0,40,3,110010059001008,1,101,101,1,psa_20,1D1
1000000US110010059001009,"Block 1009, Block Group 1, Census Tract 59, District of Columbia, District of Columbia",492,388,42,4,41,0,3,14,492,468,370,40,4,41,0,0,13,24,18,2,0,0,0,3,1,110010059001009,1,101,101,1,psa_20,1D1
1000000US110010059001023,"Block 1023, Block Group 1, Census Tract 59, District of Columbia, District of Columbia",134,0,128,1,0,0,5,0,134,129,0,128,1,0,0,0,0,5,0,0,0,0,0,5,0,110010059001023,1,102,102,1,psa_18,1D1
1000000US110010059001024,"Block 1024, Block Group 1, Census Tract 59, District of Columbia, District of Columbia",281,62,167,0,36,0,8,8,281,267,55,167,0,36,0,2,7,14,7,0,0,0,0,6,1,110010059001024,1,102,102,1,psa_18,1D1
1000000US110010064001004,"Block 1004, Block Group 1, Census Tract 64, District of Columbia, District of Columbia",101,0,98,0,0,0,3,0,101,98,0,98,0,0,0,0,0,3,0,0,0,0,0,3,0,110010064001004,1,105,105,1,psa_22,1D3
1000000US110010064001006,"Block 1006, Block Group 1, Census Tract 64, District of Columbia, District of Columbia",337,6,324,3,0,0,0,4,337,336,5,324,3,0,0,0,4,1,1,0,0,0,0,0,0,110010064001006,1,105,105,1,psa_22,1D3
1000000US110010065001010,"Block 1010, Block Group 1, Census Tract 65, District of Columbia, District of Columbia",51,46,0,0,2,0,2,1,51,51,46,0,0,2,0,2,1,0,0,0,0,0,0,0,0,110010065001010,1,106,106,1,psa_13,1D3
1000000US110010065001011,"Block 1011, Block Group 1, Census Tract 65, District of Columbia, District of Columbia",182,104,62,4,4,0,2,6,182,176,101,62,4,4,0,1,4,6,3,0,0,0,0,1,2,110010065001011,1,106,106,1,psa_13,1D3
1000000US110010065001012,"Block 1012, Block Group 1, Census Tract 65, District of Columbia, District of Columbia",13,13,0,0,0,0,0,0,13,12,12,0,0,0,0,0,0,1,1,0,0,0,0,0,0,110010065001012,1,106,106,1,psa_13,1D3
1000000US110010066001018,"Block 1018, Block Group 1, Census Tract 66, District of Columbia, District of Columbia",61,57,2,0,0,0,1,1,61,55,52,2,0,0,0,0,1,6,5,0,0,0,0,1,0,110010066001018,1,107,107,1,psa_16,1D2
1000000US110010066001019,"Block 1019, Block Group 1, Census Tract 66, District of Columbia, District of Columbia",6,6,0,0,0,0,0,0,6,6,6,0,0,0,0,0,0,0,0,0,0,0,0,0,0,110010066001019,1,107,107,1,psa_16,1D2
1000000US110010067001002,"Block 1002, Block Group 1, Census Tract 67, District of Columbia, District of Columbia",146,67,69,1,4,0,0,5,146,145,66,69,1,4,0,0,5,1,1,0,0,0,0,0,0,110010067001002,1,107,107,1,psa_16,1D2
1000000US110010067001005,"Block 1005, Block Group 1, Census Tract 67, District of Columbia, District of Columbia",16,11,0,0,1,0,1,3,16,13,10,0,0,1,0,0,2,3,1,0,0,0,0,1,1,110010067001005,1,107,107,1,psa_16,1D2
1000000US110010067001006,"Block 1006, Block Group 1, Census Tract 67, District of Columbia, District of Columbia",18,14,4,0,0,0,0,0,18,18,14,4,0,0,0,0,0,0,0,0,0,0,0,0,0,110010067001006,1,107,107,1,psa_16,1D2
1000000US110010067001008,"Block 1008, Block Group 1, Census Tract 67, District of Columbia, District of Columbia",147,96,38,1,5,0,0,7,147,138,88,38,0,5,0,0,7,9,8,0,1,0,0,0,0,110010067001008,1,107,107,1,psa_16,1D2
1000000US110010067001010,"Block 1010, Block Group 1, Census Tract 67, District of Columbia, District of Columbia",99,80,12,0,3,0,0,4,99,91,72,12,0,3,0,0,4,8,8,0,0,0,0,0,0,110010067001010,1,107,107,1,psa_16,1D2
1000000US110010067002003,"Block 2003, Block Group 2, Census Tract 67, District of Columbia, District of Columbia",62,59,0,0,3,0,0,0,62,60,58,0,0,2,0,0,0,2,1,0,0,1,0,0,0,110010067002003,1,107,107,1,psa_16,1D2
1000000US110010067002004,"Block 2004, Block Group 2, Census Tract 67, District of Columbia, District of Columbia",158,125,14,1,6,1,0,11,158,154,123,14,1,6,1,0,9,4,2,0,0,0,0,0,2,110010067002004,1,107,107,1,psa_16,1D2
1000000US110010067002010,"Block 2010, Block Group 2, Census Tract 67, District of Columbia, District of Columbia",53,47,3,0,2,0,0,1,53,52,46,3,0,2,0,0,1,1,1,0,0,0,0,0,0,110010067002010,1,107,107,1,psa_16,1D2
1000000US110010067003004,"Block 3004, Block Group 3, Census Tract 67, District of Columbia, District of Columbia",11,11,0,0,0,0,0,0,11,11,11,0,0,0,0,0,0,0,0,0,0,0,0,0,0,110010067003004,1,107,107,1,psa_16,1D2
1000000US110010067003005,"Block 3005, Block Group 3, Census Tract 67, District of Columbia, District of Columbia",88,76,8,0,3,0,1,0,88,83,71,8,0,3,0,1,0,5,5,0,0,0,0,0,0,110010067003005,1,107,107,1,psa_16,1D2
1000000US110010067003011,"Block 3011, Block Group 3, Census Tract 67, District of Columbia, District of Columbia",150,136,10,0,3,0,1,0,150,147,134,10,0,3,0,0,0,3,2,0,0,0,0,1,0,110010067003011,1,107,107,1,psa_16,1D2
1000000US110010068022004,"Block 2004, Block Group 2, Census Tract 68.02, District of Columbia, District of Columbia",141,88,50,1,0,0,0,2,141,138,87,49,0,0,0,0,2,3,1,1,1,0,0,0,0,110010068022004,1,107,107,1,psa_16,1D2
1000000US110010068022008,"Block 2008, Block Group 2, Census Tract 68.02, District of Columbia, District of Columbia",2,2,0,0,0,0,0,0,2,2,2,0,0,0,0,0,0,0,0,0,0,0,0,0,0,110010068022008,1,107,107,1,psa_16,1D2
1000000US110010068022010,"Block 2010, Block Group 2, Census Tract 68.02, District of Columbia, District of Columbia",85,32,50,1,2,0,0,0,85,84,31,50,1,2,0,0,0,1,1,0,0,0,0,0,0,110010068022010,1,107,107,1,psa_16,1D2
1000000US110010068022012,"Block 2012, Block Group 2, Census Tract 68.02, District of Columbia, District of Columbia",3,2,0,0,1,0,0,0,3,3,2,0,0,1,0,0,0,0,0,0,0,0,0,0,0,110010068022012,1,107,107,1,psa_16,1D2
1000000US110010068022013,"Block 2013, Block Group 2, Census Tract 68.02, District of Columbia, District of Columbia",130,59,61,0,4,0,2,4,130,125,57,61,0,4,0,0,3,5,2,0,0,0,0,2,1,110010068022013,1,107,107,1,psa_16,1D2
1000000US110010069001004,"Block 1004, Block Group 1, Census Tract 69, District of Columbia, District of Columbia",138,116,17,1,0,0,2,2,138,131,111,17,0,0,0,1,2,7,5,0,1,0,0,1,0,110010069001004,1,107,107,1,psa_16,1D2
1000000US110010069001007,"Block 1007, Block Group 1, Census Tract 69, District of Columbia, District of Columbia",30,26,0,0,1,0,1,2,30,29,26,0,0,1,0,0,2,1,0,0,0,0,0,1,0,110010069001007,1,107,107,1,psa_16,1D2
1000000US110010069001012,"Block 1012, Block Group 1, Census Tract 69, District of Columbia, District of Columbia",72,52,18,0,0,0,0,2,72,70,50,18,0,0,0,0,2,2,2,0,0,0,0,0,0,110010069001012,1,106,106,1,psa_13,1D3
1000000US110010069002004,"Block 2004, Block Group 2, Census Tract 69, District of Columbia, District of Columbia",95,69,25,0,1,0,0,0,95,93,67,25,0,1,0,0,0,2,2,0,0,0,0,0,0,110010069002004,1,106,106,1,psa_13,1D3
1000000US110010069002005,"Block 2005, Block Group 2, Census Tract 69, District of Columbia, District of Columbia",128,100,24,0,2,0,0,2,128,125,97,24,0,2,0,0,2,3,3,0,0,0,0,0,0,110010069002005,1,106,106,1,psa_13,1D3
1000000US110010069002008,"Block 2008, Block Group 2, Census Tract 69, District of Columbia, District of Columbia",38,23,13,0,0,0,0,2,38,37,23,12,0,0,0,0,2,1,0,1,0,0,0,0,0,110010069002008,1,106,106,1,psa_13,1D3
1000000US110010069002009,"Block 2009, Block Group 2, Census Tract 69, District of Columbia, District of Columbia",73,49,19,0,5,0,0,0,73,73,49,19,0,5,0,0,0,0,0,0,0,0,0,0,0,110010069002009,1,106,106,1,psa_13,1D3
1000000US110010069002011,"Block 2011, Block Group 2, Census Tract 69, District of Columbia, District of Columbia",59,23,27,3,5,0,1,0,59,58,23,27,3,5,0,0,0,1,0,0,0,0,0,1,0,110010069002011,1,106,106,1,psa_13,1D3
1000000US110010070001008,"Block 1008, Block Group 1, Census Tract 70, District of Columbia, District of Columbia",142,125,6,1,3,0,0,7,142,139,122,6,1,3,0,0,7,3,3,0,0,0,0,0,0,110010070001008,1,106,106,1,psa_13,1D3
1000000US110010070001009,"Block 1009, Block Group 1, Census Tract 70, District of Columbia, District of Columbia",114,86,23,0,0,0,0,5,114,111,83,23,0,0,0,0,5,3,3,0,0,0,0,0,0,110010070001009,1,106,106,1,psa_13,1D3
1000000US110010070001010,"Block 1010, Block Group 1, Census Tract 70, District of Columbia, District of Columbia",109,69,33,0,0,0,2,5,109,103,66,32,0,0,0,1,4,6,3,1,0,0,0,1,1,110010070001010,1,106,106,1,psa_13,1D3
1000000US110010070001011,"Block 1011, Block Group 1, Census Tract 70, District of Columbia, District of Columbia",88,36,50,0,0,0,1,1,88,85,34,50,0,0,0,0,1,3,2,0,0,0,0,1,0,110010070001011,1,106,106,1,psa_13,1D3
1000000US110010070001012,"Block 1012, Block Group 1, Census Tract 70, District of Columbia, District of Columbia",56,25,28,0,1,0,0,2,56,50,19,28,0,1,0,0,2,6,6,0,0,0,0,0,0,110010070001012,1,106,106,1,psa_13,1D3
1000000US110010070002021,"Block 2021, Block Group 2, Census Tract 70, District of Columbia, District of Columbia",8,1,7,0,0,0,0,0,8,8,1,7,0,0,0,0,0,0,0,0,0,0,0,0,0,110010070002021,1,106,106,1,psa_13,1D3
1000000US110010071002002,"Block 2002, Block Group 2, Census Tract 71, District of Columbia, District of Columbia",369,285,38,3,21,0,4,18,369,340,260,38,3,21,0,3,15,29,25,0,0,0,0,1,3,110010071002002,1,106,106,1,psa_13,1D3
1000000US110010071002003,"Block 2003, Block Group 2, Census Tract 71, District of Columbia, District of Columbia",76,34,36,0,2,0,0,4,76,68,29,36,0,2,0,0,1,8,5,0,0,0,0,0,3,110010071002003,1,106,106,1,psa_13,1D3
1000000US110010072001021,"Block 1021, Block Group 1, Census Tract 72, District of Columbia, District of Columbia",133,54,69,0,7,0,0,3,133,129,52,69,0,7,0,0,1,4,2,0,0,0,0,0,2,110010072001021,1,106,106,1,psa_13,1D3
1000000US110010072002004,"Block 2004, Block Group 2, Census Tract 72, District of Columbia, District of Columbia",1,0,1,0,0,0,0,0,1,1,0,1,0,0,0,0,0,0,0,0,0,0,0,0,0,110010072002004,1,106,106,1,psa_13,1D3
1000000US110010072002005,"Block 2005, Block Group 2, Census Tract 72, District of Columbia, District of Columbia",172,3,162,0,2,0,0,5,172,172,3,162,0,2,0,0,5,0,0,0,0,0,0,0,0,110010072002005,1,106,106,1,psa_13,1D3
1000000US110010072002021,"Block 2021, Block Group 2, Census Tract 72, District of Columbia, District of Columbia",256,40,199,0,7,0,4,6,256,242,33,197,0,6,0,0,6,14,7,2,0,1,0,4,0,110010072002021,1,106,106,1,psa_13,1D3
1000000US110010073011014,"Block 1014, Block Group 1, Census Tract 73.01, District of Columbia, District of Columbia",254,143,63,0,14,1,15,18,254,213,127,54,0,14,1,0,17,41,16,9,0,0,0,15,1,110010073011014,7,707,707,7,psa_4,7D2
1000000US110010073011017,"Block 1017, Block Group 1, Census Tract 73.01, District of Columbia, District of Columbia",19,8,11,0,0,0,0,0,19,19,8,11,0,0,0,0,0,0,0,0,0,0,0,0,0,110010073011017,7,707,707,7,psa_4,7D2
1000000US110010073011039,"Block 1039, Block Group 1, Census Tract 73.01, District of Columbia, District of Columbia",35,33,2,0,0,0,0,0,35,35,33,2,0,0,0,0,0,0,0,0,0,0,0,0,0,110010073011039,7,707,707,7,psa_4,7D2
1000000US110010073011041,"Block 1041, Block Group 1, Census Tract 73.01, District of Columbia, District of Columbia",7,2,5,0,0,0,0,0,7,7,2,5,0,0,0,0,0,0,0,0,0,0,0,0,0,110010073011041,7,707,707,7,psa_4,7D2
1000000US110010073011043,"Block 1043, Block Group 1, Census Tract 73.01, District of Columbia, District of Columbia",4,0,4,0,0,0,0,0,4,4,0,4,0,0,0,0,0,0,0,0,0,0,0,0,0,110010073011043,7,707,707,7,psa_4,7D2
1000000US110010073011093,"Block 1093, Block Group 1, Census Tract 73.01, District of Columbia, District of Columbia",0,0,0,0,0,0,0,0,0,0,0,0,0,0,0,0,0,0,0,0,0,0,0,0,0,110010073011093,7,708,708,7,psa_1,7D3
1000000US110010073011097,"Block 1097, Block Group 1, Census Tract 73.01, District of Columbia, District of Columbia",132,75,36,0,9,3,0,9,132,110,57,36,0,7,3,0,7,22,18,0,0,2,0,0,2,110010073011097,7,708,708,7,psa_1,7D3
1000000US110010073011134,"Block 1134, Block Group 1, Census Tract 73.01, District of Columbia, District of Columbia",21,12,7,0,0,0,2,0,21,16,9,7,0,0,0,0,0,5,3,0,0,0,0,2,0,110010073011134,7,707,707,7,psa_4,7D2
1000000US110010073041003,"Block 1003, Block Group 1, Census Tract 73.04, District of Columbia, District of Columbia",35,0,35,0,0,0,0,0,35,35,0,35,0,0,0,0,0,0,0,0,0,0,0,0,0,110010073041003,7,704,704,7,psa_5,7D2
1000000US110010073041007,"Block 1007, Block Group 1, Census Tract 73.04, District of Columbia, District of Columbia",174,0,173,1,0,0,0,0,174,174,0,173,1,0,0,0,0,0,0,0,0,0,0,0,0,110010073041007,7,705,705,7,psa_3,7D2
1000000US110010073041008,"Block 1008, Block Group 1, Census Tract 73.04, District of Columbia, District of Columbia",695,0,687,0,1,0,0,7,695,695,0,687,0,1,0,0,7,0,0,0,0,0,0,0,0,110010073041008,7,705,705,7,psa_3,7D2
1000000US110010074011032,"Block 1032, Block Group 1, Census Tract 74.01, District of Columbia, District of Columbia",51,0,51,0,0,0,0,0,51,51,0,51,0,0,0,0,0,0,0,0,0,0,0,0,0,110010074011032,7,703,703,7,psa_8,7D1
1000000US110010074011037,"Block 1037, Block Group 1, Census Tract 74.01, District of Columbia, District of Columbia",429,2,421,2,0,0,0,4,429,429,2,421,2,0,0,0,4,0,0,0,0,0,0,0,0,110010074011037,7,703,703,7,psa_8,7D1
1000000US110010074011038,"Block 1038, Block Group 1, Census Tract 74.01, District of Columbia, District of Columbia",415,0,410,5,0,0,0,0,415,415,0,410,5,0,0,0,0,0,0,0,0,0,0,0,0,110010074011038,7,703,703,7,psa_8,7D1
1000000US110010074011039,"Block 1039, Block Group 1, Census Tract 74.01, District of Columbia, District of Columbia",319,5,313,0,1,0,0,0,319,319,5,313,0,1,0,0,0,0,0,0,0,0,0,0,0,110010074011039,7,703,703,7,psa_8,7D1
1000000US110010074011040,"Block 1040, Block Group 1, Census Tract 74.01, District of Columbia, District of Columbia",16,0,16,0,0,0,0,0,16,16,0,16,0,0,0,0,0,0,0,0,0,0,0,0,0,110010074011040,7,703,703,7,psa_8,7D1
1000000US110010074012003,"Block 2003, Block Group 2, Census Tract 74.01, District of Columbia, District of Columbia",555,7,523,1,4,0,11,9,555,534,6,517,1,4,0,0,6,21,1,6,0,0,0,11,3,110010074012003,7,703,703,7,psa_8,7D1
1000000US110010074012004,"Block 2004, Block Group 2, Census Tract 74.01, District of Columbia, District of Columbia",252,0,246,0,0,0,0,6,252,248,0,246,0,0,0,0,2,4,0,0,0,0,0,0,4,110010074012004,7,703,703,7,psa_8,7D1
1000000US110010074031000,"Block 1000, Block Group 1, Census Tract 74.03, District of Columbia, District of Columbia",116,0,116,0,0,0,0,0,116,112,0,112,0,0,0,0,0,4,0,4,0,0,0,0,0,110010074031000,7,704,704,7,psa_5,7D2
1000000US110010074031002,"Block 1002, Block Group 1, Census Tract 74.03, District of Columbia, District of Columbia",1322,9,1304,0,4,0,1,4,1322,1315,9,1300,0,3,0,0,3,7,0,4,0,1,0,1,1,110010074031002,7,704,704,7,psa_5,7D2
1000000US110010074031004,"Block 1004, Block Group 1, Census Tract 74.03, District of Columbia, District of Columbia",225,0,217,0,0,0,0,8,225,223,0,215,0,0,0,0,8,2,0,2,0,0,0,0,0,110010074031004,7,704,704,7,psa_5,7D2
1000000US110010074031005,"Block 1005, Block Group 1, Census Tract 74.03, District of Columbia, District of Columbia",635,1,621,1,1,0,0,11,635,628,1,614,1,1,0,0,11,7,0,7,0,0,0,0,0,110010074031005,7,704,704,7,psa_5,7D2
1000000US110010074041000,"Block 1000, Block Group 1, Census Tract 74.04, District of Columbia, District of Columbia",1073,1,1034,3,1,0,11,23,1073,1051,1,1025,1,1,0,2,21,22,0,9,2,0,0,9,2,110010074041000,7,704,704,7,psa_5,7D2
1000000US110010074041001,"Block 1001, Block Group 1, Census Tract 74.04, District of Columbia, District of Columbia",23,0,23,0,0,0,0,0,23,23,0,23,0,0,0,0,0,0,0,0,0,0,0,0,0,110010074041001,7,704,704,7,psa_5,7D2
1000000US110010074041003,"Block 1003, Block Group 1, Census Tract 74.04, District of Columbia, District of Columbia",45,0,44,0,0,0,0,1,45,45,0,44,0,0,0,0,1,0,0,0,0,0,0,0,0,110010074041003,7,704,704,7,psa_5,7D2
1000000US110010074041005,"Block 1005, Block Group 1, Census Tract 74.04, District of Columbia, District of Columbia",183,0,181,0,1,0,0,1,183,182,0,180,0,1,0,0,1,1,0,1,0,0,0,0,0,110010074041005,7,704,704,7,psa_5,7D2
1000000US110010074041006,"Block 1006, Block Group 1, Census Tract 74.04, District of Columbia, District of Columbia",72,1,71,0,0,0,0,0,72,72,1,71,0,0,0,0,0,0,0,0,0,0,0,0,0,110010074041006,7,704,704,7,psa_5,7D2
1000000US110010074041007,"Block 1007, Block Group 1, Census Tract 74.04, District of Columbia, District of Columbia",2,2,0,0,0,0,0,0,2,2,2,0,0,0,0,0,0,0,0,0,0,0,0,0,0,110010074041007,7,704,704,7,psa_5,7D2
1000000US110010074041011,"Block 1011, Block Group 1, Census Tract 74.04, District of Columbia, District of Columbia",76,0,76,0,0,0,0,0,76,76,0,76,0,0,0,0,0,0,0,0,0,0,0,0,0,110010074041011,7,704,704,7,psa_5,7D2
1000000US110010074042000,"Block 2000, Block Group 2, Census Tract 74.04, District of Columbia, District of Columbia",99,0,96,0,0,0,3,0,99,96,0,96,0,0,0,0,0,3,0,0,0,0,0,3,0,110010074042000,7,704,704,7,psa_5,7D2
1000000US110010074042001,"Block 2001, Block Group 2, Census Tract 74.04, District of Columbia, District of Columbia",34,0,26,0,1,0,7,0,34,29,0,26,0,1,0,2,0,5,0,0,0,0,0,5,0,110010074042001,7,704,704,7,psa_5,7D2
1000000US110010074042004,"Block 2004, Block Group 2, Census Tract 74.04, District of Columbia, District of Columbia",89,10,75,0,3,0,0,1,89,89,10,75,0,3,0,0,1,0,0,0,0,0,0,0,0,110010074042004,7,704,704,7,psa_5,7D2
1000000US110010074042006,"Block 2006, Block Group 2, Census Tract 74.04, District of Columbia, District of Columbia",102,0,100,1,1,0,0,0,102,102,0,100,1,1,0,0,0,0,0,0,0,0,0,0,0,110010074042006,7,703,703,7,psa_8,7D1
1000000US110010074042008,"Block 2008, Block Group 2, Census Tract 74.04, District of Columbia, District of Columbia",49,0,47,0,0,0,0,2,49,49,0,47,0,0,0,0,2,0,0,0,0,0,0,0,0,110010074042008,7,704,704,7,psa_5,7D2
1000000US110010074043000,"Block 3000, Block Group 3, Census Tract 74.04, District of Columbia, District of Columbia",296,2,279,0,0,0,5,10,296,286,2,279,0,0,0,0,5,10,0,0,0,0,0,5,5,110010074043000,7,704,704,7,psa_5,7D2
1000000US110010074043001,"Block 3001, Block Group 3, Census Tract 74.04, District of Columbia, District of Columbia",60,0,60,0,0,0,0,0,60,60,0,60,0,0,0,0,0,0,0,0,0,0,0,0,0,110010074043001,7,704,704,7,psa_5,7D2
1000000US110010074043003,"Block 3003, Block Group 3, Census Tract 74.04, District of Columbia, District of Columbia",4,0,4,0,0,0,0,0,4,4,0,4,0,0,0,0,0,0,0,0,0,0,0,0,0,110010074043003,7,704,704,7,psa_5,7D2
1000000US110010074061000,"Block 1000, Block Group 1, Census Tract 74.06, District of Columbia, District of Columbia",708,3,700,1,0,0,0,4,708,698,2,692,1,0,0,0,3,10,1,8,0,0,0,0,1,110010074061000,7,703,703,7,psa_8,7D1
1000000US110010074061001,"Block 1001, Block Group 1, Census Tract 74.06, District of Columbia, District of Columbia",731,10,700,0,0,0,5,16,731,699,7,684,0,0,0,2,6,32,3,16,0,0,0,3,10,110010074061001,7,703,703,7,psa_8,7D1
1000000US110010074071005,"Block 1005, Block Group 1, Census Tract 74.07, District of Columbia, District of Columbia",176,2,169,1,0,0,0,4,176,176,2,169,1,0,0,0,4,0,0,0,0,0,0,0,0,110010074071005,7,702,702,7,psa_6,7D1
1000000US110010074071008,"Block 1008, Block Group 1, Census Tract 74.07, District of Columbia, District of Columbia",9,0,9,0,0,0,0,0,9,9,0,9,0,0,0,0,0,0,0,0,0,0,0,0,0,110010074071008,7,703,703,7,psa_8,7D1
1000000US110010074071011,"Block 1011, Block Group 1, Census Tract 74.07, District of Columbia, District of Columbia",20,0,20,0,0,0,0,0,20,20,0,20,0,0,0,0,0,0,0,0,0,0,0,0,0,110010074071011,7,702,702,7,psa_6,7D1
1000000US110010074072009,"Block 2009, Block Group 2, Census Tract 74.07, District of Columbia, District of Columbia",141,0,139,0,0,0,0,2,141,141,0,139,0,0,0,0,2,0,0,0,0,0,0,0,0,110010074072009,7,703,703,7,psa_8,7D1
1000000US110010074081010,"Block 1010, Block Group 1, Census Tract 74.08, District of Columbia, District of Columbia",440,0,438,0,0,0,0,2,440,438,0,436,0,0,0,0,2,2,0,2,0,0,0,0,0,110010074081010,7,702,702,7,psa_6,7D1
1000000US110010074081012,"Block 1012, Block Group 1, Census Tract 74.08, District of Columbia, District of Columbia",533,0,527,1,0,0,1,4,533,531,0,525,1,0,0,1,4,2,0,2,0,0,0,0,0,110010074081012,7,702,702,7,psa_6,7D1
1000000US110010074091000,"Block 1000, Block Group 1, Census Tract 74.09, District of Columbia, District of Columbia",372,2,361,1,0,0,4,4,372,372,2,361,1,0,0,4,4,0,0,0,0,0,0,0,0,110010074091000,7,704,704,7,psa_5,7D2
1000000US110010074091002,"Block 1002, Block Group 1, Census Tract 74.09, District of Columbia, District of Columbia",222,0,216,0,0,0,0,6,222,218,0,213,0,0,0,0,5,4,0,3,0,0,0,0,1,110010074091002,7,704,704,7,psa_5,7D2
1000000US110010074092000,"Block 2000, Block Group 2, Census Tract 74.09, District of Columbia, District of Columbia",546,6,527,0,0,0,0,13,546,546,6,527,0,0,0,0,13,0,0,0,0,0,0,0,0,110010074092000,7,704,704,7,psa_5,7D2
1000000US110010075021000,"Block 1000, Block Group 1, Census Tract 75.02, District of Columbia, District of Columbia",1495,23,1435,2,1,0,8,26,1495,1475,17,1428,2,1,0,1,26,20,6,7,0,0,0,7,0,110010075021000,7,701,701,7,psa_9,7D1
1000000US110010075021002,"Block 1002, Block Group 1, Census Tract 75.02, District of Columbia, District of Columbia",35,0,35,0,0,0,0,0,35,35,0,35,0,0,0,0,0,0,0,0,0,0,0,0,0,110010075021002,7,702,702,7,psa_6,7D1
1000000US110010075022007,"Block 2007, Block Group 2, Census Tract 75.02, District of Columbia, District of Columbia",146,0,142,2,1,0,0,1,146,145,0,141,2,1,0,0,1,1,0,1,0,0,0,0,0,110010075022007,7,702,702,7,psa_6,7D1
1000000US110010075041006,"Block 1006, Block Group 1, Census Tract 75.04, District of Columbia, District of Columbia",0,0,0,0,0,0,0,0,0,0,0,0,0,0,0,0,0,0,0,0,0,0,0,0,0,110010075041006,7,701,701,7,psa_9,7D1
1000000US110010076034003,"Block 4003, Block Group 4, Census Tract 76.03, District of Columbia, District of Columbia",491,28,447,0,0,0,5,11,491,480,28,441,0,0,0,0,11,11,0,6,0,0,0,5,0,110010076034003,6,606,606,6,psa_7,6D2
1000000US110010076034008,"Block 4008, Block Group 4, Census Tract 76.03, District of Columbia, District of Columbia",110,18,87,1,1,0,2,1,110,97,7,87,1,1,0,0,1,13,11,0,0,0,0,2,0,110010076034008,6,606,606,6,psa_7,6D2
1000000US110010076034009,"Block 4009, Block Group 4, Census Tract 76.03, District of Columbia, District of Columbia",21,1,20,0,0,0,0,0,21,21,1,20,0,0,0,0,0,0,0,0,0,0,0,0,0,110010076034009,6,606,606,6,psa_7,6D2
1000000US110010076041001,"Block 1001, Block Group 1, Census Tract 76.04, District of Columbia, District of Columbia",20,1,19,0,0,0,0,0,20,19,1,18,0,0,0,0,0,1,0,1,0,0,0,0,0,110010076041001,6,607,607,6,psa_10,6D2
1000000US110010076041005,"Block 1005, Block Group 1, Census Tract 76.04, District of Columbia, District of Columbia",111,6,104,1,0,0,0,0,111,105,3,101,1,0,0,0,0,6,3,3,0,0,0,0,0,110010076041005,6,607,607,6,psa_10,6D2
1000000US110010076041008,"Block 1008, Block Group 1, Census Tract 76.04, District of Columbia, District of Columbia",233,2,227,0,0,0,0,4,233,232,2,226,0,0,0,0,4,1,0,1,0,0,0,0,0,110010076041008,6,607,607,6,psa_10,6D2
1000000US110010076042018,"Block 2018, Block Group 2, Census Tract 76.04, District of Columbia, District of Columbia",415,6,397,0,3,0,0,9,415,415,6,397,0,3,0,0,9,0,0,0,0,0,0,0,0,110010076042018,6,606,606,6,psa_7,6D2
1000000US110010076052001,"Block 2001, Block Group 2, Census Tract 76.05, District of Columbia, District of Columbia",1281,20,1210,6,6,0,9,30,1281,1261,15,1205,5,6,0,0,30,20,5,5,1,0,0,9,0,110010076052001,6,607,607,6,psa_10,6D2
1000000US110010076052002,"Block 2002, Block Group 2, Census Tract 76.05, District of Columbia, District of Columbia",199,1,195,0,1,0,0,2,199,199,1,195,0,1,0,0,2,0,0,0,0,0,0,0,0,110010076052002,6,607,607,6,psa_10,6D2
1000000US110010077031000,"Block 1000, Block Group 1, Census Tract 77.03, District of Columbia, District of Columbia",302,3,291,2,0,0,0,6,302,301,3,290,2,0,0,0,6,1,0,1,0,0,0,0,0,110010077031000,6,603,603,6,psa_15,6D3
1000000US110010077031001,"Block 1001, Block Group 1, Census Tract 77.03, District of Columbia, District of Columbia",22,3,16,0,0,0,0,3,22,22,3,16,0,0,0,0,3,0,0,0,0,0,0,0,0,110010077031001,6,603,603,6,psa_15,6D3
1000000US110010077034001,"Block 4001, Block Group 4, Census Tract 77.03, District of Columbia, District of Columbia",32,0,32,0,0,0,0,0,32,32,0,32,0,0,0,0,0,0,0,0,0,0,0,0,0,110010077034001,6,603,603,6,psa_15,6D3
1000000US110010077034002,"Block 4002, Block Group 4, Census Tract 77.03, District of Columbia, District of Columbia",2,0,1,0,0,0,0,1,2,2,0,1,0,0,0,0,1,0,0,0,0,0,0,0,0,110010077034002,6,603,603,6,psa_15,6D3
1000000US110010077071001,"Block 1001, Block Group 1, Census Tract 77.07, District of Columbia, District of Columbia",262,0,262,0,0,0,0,0,262,259,0,259,0,0,0,0,0,3,0,3,0,0,0,0,0,110010077071001,6,604,604,6,psa_14,6D3
1000000US110010077071002,"Block 1002, Block Group 1, Census Tract 77.07, District of Columbia, District of Columbia",761,4,740,0,0,0,3,14,761,760,4,739,0,0,0,3,14,1,0,1,0,0,0,0,0,110010077071002,6,604,604,6,psa_14,6D3
1000000US110010077072005,"Block 2005, Block Group 2, Census Tract 77.07, District of Columbia, District of Columbia",191,2,188,1,0,0,0,0,191,188,2,185,1,0,0,0,0,3,0,3,0,0,0,0,0,110010077072005,6,605,605,6,psa_11,6D2
1000000US110010077072010,"Block 2010, Block Group 2, Census Tract 77.07, District of Columbia, District of Columbia",2,1,1,0,0,0,0,0,2,2,1,1,0,0,0,0,0,0,0,0,0,0,0,0,0,110010077072010,6,605,605,6,psa_11,6D2
1000000US110010077081003,"Block 1003, Block Group 1, Census Tract 77.08, District of Columbia, District of Columbia",239,1,236,0,0,2,0,0,239,235,1,232,0,0,2,0,0,4,0,4,0,0,0,0,0,110010077081003,6,603,603,6,psa_15,6D3
1000000US110010077082006,"Block 2006, Block Group 2, Census Tract 77.08, District of Columbia, District of Columbia",303,1,289,0,1,0,0,12,303,302,1,289,0,1,0,0,11,1,0,0,0,0,0,0,1,110010077082006,6,603,603,6,psa_15,6D3
1000000US110010077082017,"Block 2017, Block Group 2, Census Tract 77.08, District of Columbia, District of Columbia",49,2,42,0,0,0,0,5,49,39,0,39,0,0,0,0,0,10,2,3,0,0,0,0,5,110010077082017,6,605,605,6,psa_11,6D2
1000000US110010077091011,"Block 1011, Block Group 1, Census Tract 77.09, District of Columbia, District of Columbia",52,0,51,0,0,0,1,0,52,52,0,51,0,0,0,1,0,0,0,0,0,0,0,0,0,110010077091011,6,605,605,6,psa_11,6D2
1000000US110010077091012,"Block 1012, Block Group 1, Census Tract 77.09, District of Columbia, District of Columbia",66,0,66,0,0,0,0,0,66,66,0,66,0,0,0,0,0,0,0,0,0,0,0,0,0,110010077091012,6,605,605,6,psa_11,6D2
1000000US110010077091018,"Block 1018, Block Group 1, Census Tract 77.09, District of Columbia, District of Columbia",5,0,4,0,0,0,0,1,5,5,0,4,0,0,0,0,1,0,0,0,0,0,0,0,0,110010077091018,6,605,605,6,psa_11,6D2
1000000US110010077091030,"Block 1030, Block Group 1, Census Tract 77.09, District of Columbia, District of Columbia",60,3,55,0,0,0,0,2,60,60,3,55,0,0,0,0,2,0,0,0,0,0,0,0,0,110010077091030,6,605,605,6,psa_11,6D2
1000000US110010077091031,"Block 1031, Block Group 1, Census Tract 77.09, District of Columbia, District of Columbia",2,0,2,0,0,0,0,0,2,2,0,2,0,0,0,0,0,0,0,0,0,0,0,0,0,110010077091031,6,605,605,6,psa_11,6D2
1000000US110010078041006,"Block 1006, Block Group 1, Census Tract 78.04, District of Columbia, District of Columbia",205,0,192,0,0,0,5,8,205,199,0,191,0,0,0,0,8,6,0,1,0,0,0,5,0,110010078041006,6,602,602,6,psa_25,6D1
1000000US110010078041015,"Block 1015, Block Group 1, Census Tract 78.04, District of Columbia, District of Columbia",5,0,5,0,0,0,0,0,5,5,0,5,0,0,0,0,0,0,0,0,0,0,0,0,0,110010078041015,6,602,602,6,psa_25,6D1
1000000US110010078042000,"Block 2000, Block Group 2, Census Tract 78.04, District of Columbia, District of Columbia",170,0,168,0,0,0,0,2,170,170,0,168,0,0,0,0,2,0,0,0,0,0,0,0,0,110010078042000,6,602,602,6,psa_25,6D1
1000000US110010078042001,"Block 2001, Block Group 2, Census Tract 78.04, District of Columbia, District of Columbia",1,0,1,0,0,0,0,0,1,1,0,1,0,0,0,0,0,0,0,0,0,0,0,0,0,110010078042001,6,602,602,6,psa_25,6D1
1000000US110010078042002,"Block 2002, Block Group 2, Census Tract 78.04, District of Columbia, District of Columbia",54,0,49,0,0,0,5,0,54,49,0,49,0,0,0,0,0,5,0,0,0,0,0,5,0,110010078042002,6,602,602,6,psa_25,6D1
1000000US110010078042003,"Block 2003, Block Group 2, Census Tract 78.04, District of Columbia, District of Columbia",103,3,98,0,2,0,0,0,103,103,3,98,0,2,0,0,0,0,0,0,0,0,0,0,0,110010078042003,6,602,602,6,psa_25,6D1
1000000US110010078042004,"Block 2004, Block Group 2, Census Tract 78.04, District of Columbia, District of Columbia",20,0,15,0,0,0,5,0,20,15,0,15,0,0,0,0,0,5,0,0,0,0,0,5,0,110010078042004,6,602,602,6,psa_25,6D1
1000000US110010078062002,"Block 2002, Block Group 2, Census Tract 78.06, District of Columbia, District of Columbia",56,0,56,0,0,0,0,0,56,56,0,56,0,0,0,0,0,0,0,0,0,0,0,0,0,110010078062002,6,602,602,6,psa_25,6D1
1000000US110010078062011,"Block 2011, Block Group 2, Census Tract 78.06, District of Columbia, District of Columbia",131,0,130,0,0,1,0,0,131,121,0,121,0,0,0,0,0,10,0,9,0,0,1,0,0,110010078062011,6,602,602,6,psa_25,6D1
1000000US110010078062021,"Block 2021, Block Group 2, Census Tract 78.06, District of Columbia, District of Columbia",12,0,12,0,0,0,0,0,12,12,0,12,0,0,0,0,0,0,0,0,0,0,0,0,0,110010078062021,6,602,602,6,psa_25,6D1
1000000US110010078082009,"Block 2009, Block Group 2, Census Tract 78.08, District of Columbia, District of Columbia",117,0,113,0,0,0,4,0,117,113,0,113,0,0,0,0,0,4,0,0,0,0,0,4,0,110010078082009,6,608,608,6,psa_19,6D1
1000000US110010078082018,"Block 2018, Block Group 2, Census Tract 78.08, District of Columbia, District of Columbia",22,0,21,1,0,0,0,0,22,22,0,21,1,0,0,0,0,0,0,0,0,0,0,0,0,110010078082018,6,608,608,6,psa_19,6D1
1000000US110010078092014,"Block 2014, Block Group 2, Census Tract 78.09, District of Columbia, District of Columbia",67,7,58,1,1,0,0,0,67,66,6,58,1,1,0,0,0,1,1,0,0,0,0,0,0,110010078092014,6,602,602,6,psa_25,6D1
1000000US110010078092015,"Block 2015, Block Group 2, Census Tract 78.09, District of Columbia, District of Columbia",52,0,46,0,0,0,5,1,52,47,0,46,0,0,0,0,1,5,0,0,0,0,0,5,0,110010078092015,6,602,602,6,psa_25,6D1
1000000US110010079031012,"Block 1012, Block Group 1, Census Tract 79.03, District of Columbia, District of Columbia",116,17,81,0,0,0,18,0,116,93,12,81,0,0,0,0,0,23,5,0,0,0,0,18,0,110010079031012,5,507,507,5,psa_23,5D3
1000000US110010079031013,"Block 1013, Block Group 1, Census Tract 79.03, District of Columbia, District of Columbia",35,4,29,0,0,0,0,2,35,30,4,26,0,0,0,0,0,5,0,3,0,0,0,0,2,110010079031013,5,507,507,5,psa_23,5D3
1000000US110010079031018,"Block 1018, Block Group 1, Census Tract 79.03, District of Columbia, District of Columbia",16,0,16,0,0,0,0,0,16,16,0,16,0,0,0,0,0,0,0,0,0,0,0,0,0,110010079031018,5,507,507,5,psa_23,5D3
1000000US110010080012008,"Block 2008, Block Group 2, Census Tract 80.01, District of Columbia, District of Columbia",5,0,5,0,0,0,0,0,5,4,0,4,0,0,0,0,0,1,0,1,0,0,0,0,0,110010080012008,1,108,108,1,psa_17,1D2
1000000US110010080012009,"Block 2009, Block Group 2, Census Tract 80.01, District of Columbia, District of Columbia",163,99,50,1,7,0,0,6,163,151,91,50,1,7,0,0,2,12,8,0,0,0,0,0,4,110010080012009,1,108,108,1,psa_17,1D2
1000000US110010080021002,"Block 1002, Block Group 1, Census Tract 80.02, District of Columbia, District of Columbia",19,4,12,0,2,0,0,1,19,19,4,12,0,2,0,0,1,0,0,0,0,0,0,0,0,110010080021002,1,108,108,1,psa_17,1D2
1000000US110010080021006,"Block 1006, Block Group 1, Census Tract 80.02, District of Columbia, District of Columbia",69,41,27,0,0,0,0,1,69,67,40,27,0,0,0,0,0,2,1,0,0,0,0,0,1,110010080021006,1,108,108,1,psa_17,1D2
1000000US110010080021007,"Block 1007, Block Group 1, Census Tract 80.02, District of Columbia, District of Columbia",15,15,0,0,0,0,0,0,15,15,15,0,0,0,0,0,0,0,0,0,0,0,0,0,0,110010080021007,1,108,108,1,psa_17,1D2
1000000US110010080021009,"Block 1009, Block Group 1, Census Tract 80.02, District of Columbia, District of Columbia",13,0,13,0,0,0,0,0,13,13,0,13,0,0,0,0,0,0,0,0,0,0,0,0,0,110010080021009,1,108,108,1,psa_17,1D2
1000000US110010080022006,"Block 2006, Block Group 2, Census Tract 80.02, District of Columbia, District of Columbia",106,64,37,0,0,0,0,5,106,104,62,37,0,0,0,0,5,2,2,0,0,0,0,0,0,110010080022006,1,108,108,1,psa_17,1D2
1000000US110010081001002,"Block 1002, Block Group 1, Census Tract 81, District of Columbia, District of Columbia",10,10,0,0,0,0,0,0,10,9,9,0,0,0,0,0,0,1,1,0,0,0,0,0,0,110010081001002,1,104,104,1,psa_21,1D2
1000000US110010081001003,"Block 1003, Block Group 1, Census Tract 81, District of Columbia, District of Columbia",113,75,29,0,5,0,0,4,113,112,74,29,0,5,0,0,4,1,1,0,0,0,0,0,0,110010081001003,1,108,108,1,psa_17,1D2
1000000US110010081003006,"Block 3006, Block Group 3, Census Tract 81, District of Columbia, District of Columbia",103,90,7,0,0,0,2,4,103,100,90,6,0,0,0,0,4,3,0,1,0,0,0,2,0,110010081003006,1,108,108,1,psa_17,1D2
1000000US110010081003007,"Block 3007, Block Group 3, Census Tract 81, District of Columbia, District of Columbia",10,9,1,0,0,0,0,0,10,7,6,1,0,0,0,0,0,3,3,0,0,0,0,0,0,110010081003007,1,108,108,1,psa_17,1D2
1000000US110010082001000,"Block 1000, Block Group 1, Census Tract 82, District of Columbia, District of Columbia",89,71,8,0,5,0,0,5,89,89,71,8,0,5,0,0,5,0,0,0,0,0,0,0,0,110010082001000,1,108,108,1,psa_17,1D2
1000000US110010082001001,"Block 1001, Block Group 1, Census Tract 82, District of Columbia, District of Columbia",9,9,0,0,0,0,0,0,9,8,8,0,0,0,0,0,0,1,1,0,0,0,0,0,0,110010082001001,1,108,108,1,psa_17,1D2
1000000US110010083012006,"Block 2006, Block Group 2, Census Tract 83.01, District of Columbia, District of Columbia",94,83,9,0,0,0,1,1,94,92,83,9,0,0,0,0,0,2,0,0,0,0,0,1,1,110010083012006,1,108,108,1,psa_17,1D2
1000000US110010083012007,"Block 2007, Block Group 2, Census Tract 83.01, District of Columbia, District of Columbia",42,34,0,0,6,0,0,2,42,42,34,0,0,6,0,0,2,0,0,0,0,0,0,0,0,110010083012007,1,108,108,1,psa_17,1D2
1000000US110010084021005,"Block 1005, Block Group 1, Census Tract 84.02, District of Columbia, District of Columbia",245,118,103,3,10,1,1,9,245,236,113,101,2,10,1,0,9,9,5,2,1,0,0,1,0,110010084021005,1,104,104,1,psa_21,1D2
1000000US110010084021008,"Block 1008, Block Group 1, Census Tract 84.02, District of Columbia, District of Columbia",3,3,0,0,0,0,0,0,3,1,1,0,0,0,0,0,0,2,2,0,0,0,0,0,0,110010084021008,1,104,104,1,psa_21,1D2
1000000US110010084022007,"Block 2007, Block Group 2, Census Tract 84.02, District of Columbia, District of Columbia",93,73,16,0,0,0,0,4,93,92,73,16,0,0,0,0,3,1,0,0,0,0,0,0,1,110010084022007,1,104,104,1,psa_21,1D2
1000000US110010084022010,"Block 2010, Block Group 2, Census Tract 84.02, District of Columbia, District of Columbia",9,6,3,0,0,0,0,0,9,9,6,3,0,0,0,0,0,0,0,0,0,0,0,0,0,110010084022010,1,108,108,1,psa_17,1D2
1000000US110010084101007,"Block 1007, Block Group 1, Census Tract 84.10, District of Columbia, District of Columbia",51,8,41,0,0,0,0,2,51,48,5,41,0,0,0,0,2,3,3,0,0,0,0,0,0,110010084101007,1,104,104,1,psa_21,1D2
1000000US110010087011009,"Block 1009, Block Group 1, Census Tract 87.01, District of Columbia, District of Columbia",183,61,117,0,3,0,1,1,183,169,60,104,0,3,0,1,1,14,1,13,0,0,0,0,0,110010087011009,5,502,502,5,psa_40,5D1
1000000US110010087011010,"Block 1010, Block Group 1, Census Tract 87.01, District of Columbia, District of Columbia",6,0,5,0,0,1,0,0,6,6,0,5,0,0,1,0,0,0,0,0,0,0,0,0,0,110010087011010,5,502,502,5,psa_40,5D1
1000000US110010088031005,"Block 1005, Block Group 1, Census Tract 88.03, District of Columbia, District of Columbia",28,1,25,0,0,0,0,2,28,26,1,25,0,0,0,0,0,2,0,0,0,0,0,0,2,110010088031005,5,506,506,5,psa_26,5D3
1000000US110010088031006,"Block 1006, Block Group 1, Census Tract 88.03, District of Columbia, District of Columbia",238,0,234,0,1,0,3,0,238,233,0,232,0,1,0,0,0,5,0,2,0,0,0,3,0,110010088031006,5,506,506,5,psa_26,5D3
1000000US110010088031015,"Block 1015, Block Group 1, Census Tract 88.03, District of Columbia, District of Columbia",181,14,161,0,0,0,2,4,181,165,7,155,0,0,0,0,3,16,7,6,0,0,0,2,1,110010088031015,5,501,501,5,psa_35,5D1
1000000US110010088031018,"Block 1018, Block Group 1, Census Tract 88.03, District of Columbia, District of Columbia",907,655,120,6,41,4,25,56,907,815,603,113,5,40,4,2,48,92,52,7,1,1,0,23,8,110010088031018,5,501,501,5,psa_35,5D1
1000000US110010088041002,"Block 1002, Block Group 1, Census Tract 88.04, District of Columbia, District of Columbia",262,21,217,0,0,0,19,5,262,226,7,216,0,0,0,0,3,36,14,1,0,0,0,19,2,110010088041002,5,506,506,5,psa_26,5D3
1000000US110010088042011,"Block 2011, Block Group 2, Census Tract 88.04, District of Columbia, District of Columbia",296,13,269,1,1,0,6,6,296,289,13,268,1,1,0,0,6,7,0,1,0,0,0,6,0,110010088042011,5,506,506,5,psa_26,5D3
1000000US110010089031004,"Block 1004, Block Group 1, Census Tract 89.03, District of Columbia, District of Columbia",10,0,10,0,0,0,0,0,10,10,0,10,0,0,0,0,0,0,0,0,0,0,0,0,0,110010089031004,5,507,507,5,psa_23,5D3
1000000US110010089031007,"Block 1007, Block Group 1, Census Tract 89.03, District of Columbia, District of Columbia",86,1,85,0,0,0,0,0,86,86,1,85,0,0,0,0,0,0,0,0,0,0,0,0,0,110010089031007,5,507,507,5,psa_23,5D3
1000000US110010090001002,"Block 1002, Block Group 1, Census Tract 90, District of Columbia, District of Columbia",23,1,17,0,0,0,0,5,23,13,1,12,0,0,0,0,0,10,0,5,0,0,0,0,5,110010090001002,5,503,503,5,psa_45,5D2
1000000US110010090001010,"Block 1010, Block Group 1, Census Tract 90, District of Columbia, District of Columbia",735,37,629,1,32,0,9,27,735,712,32,624,1,32,0,0,23,23,5,5,0,0,0,9,4,110010090001010,5,503,503,5,psa_45,5D2
1000000US110010090002000,"Block 2000, Block Group 2, Census Tract 90, District of Columbia, District of Columbia",59,0,54,1,0,0,0,4,59,56,0,54,0,0,0,0,2,3,0,0,1,0,0,0,2,110010090002000,5,503,503,5,psa_45,5D2
1000000US110010090002001,"Block 2001, Block Group 2, Census Tract 90, District of Columbia, District of Columbia",12,0,12,0,0,0,0,0,12,12,0,12,0,0,0,0,0,0,0,0,0,0,0,0,0,110010090002001,5,503,503,5,psa_45,5D2
1000000US110010090002002,"Block 2002, Block Group 2, Census Tract 90, District of Columbia, District of Columbia",630,7,588,0,0,0,16,19,630,613,6,585,0,0,0,3,19,17,1,3,0,0,0,13,0,110010090002002,5,503,503,5,psa_45,5D2
1000000US110010092011006,"Block 1006, Block Group 1, Census Tract 92.01, District of Columbia, District of Columbia",250,40,183,1,1,0,10,15,250,226,36,178,0,1,0,0,11,24,4,5,1,0,0,10,4,110010092011006,5,502,502,5,psa_40,5D1
1000000US110010092011007,"Block 1007, Block Group 1, Census Tract 92.01, District of Columbia, District of Columbia",19,3,12,0,0,0,0,4,19,18,3,11,0,0,0,0,4,1,0,1,0,0,0,0,0,110010092011007,5,502,502,5,psa_40,5D1
1000000US110010092042000,"Block 2000, Block Group 2, Census Tract 92.04, District of Columbia, District of Columbia",212,5,196,0,6,0,3,2,212,206,2,196,0,6,0,0,2,6,3,0,0,0,0,3,0,110010092042000,5,502,502,5,psa_40,5D1
1000000US110010092042003,"Block 2003, Block Group 2, Census Tract 92.04, District of Columbia, District of Columbia",1196,26,976,23,1,0,140,30,1196,1014,17,966,6,1,0,2,22,182,9,10,17,0,0,138,8,110010092042003,5,502,502,5,psa_40,5D1
1000000US110010093013010,"Block 3010, Block Group 3, Census Tract 93.01, District of Columbia, District of Columbia",21,0,16,0,0,0,0,5,21,21,0,16,0,0,0,0,5,0,0,0,0,0,0,0,0,110010093013010,5,504,504,5,psa_43,5D2
1000000US110010093013011,"Block 3011, Block Group 3, Census Tract 93.01, District of Columbia, District of Columbia",6,1,5,0,0,0,0,0,6,6,1,5,0,0,0,0,0,0,0,0,0,0,0,0,0,110010093013011,5,504,504,5,psa_43,5D2
1000000US110010094001000,"Block 1000, Block Group 1, Census Tract 94, District of Columbia, District of Columbia",21,0,21,0,0,0,0,0,21,20,0,20,0,0,0,0,0,1,0,1,0,0,0,0,0,110010094001000,5,503,503,5,psa_45,5D2
1000000US110010094001002,"Block 1002, Block Group 1, Census Tract 94, District of Columbia, District of Columbia",25,0,23,0,0,0,2,0,25,25,0,23,0,0,0,2,0,0,0,0,0,0,0,0,0,110010094001002,5,503,503,5,psa_45,5D2
1000000US110010094001003,"Block 1003, Block Group 1, Census Tract 94, District of Columbia, District of Columbia",58,8,49,1,0,0,0,0,58,54,8,46,0,0,0,0,0,4,0,3,1,0,0,0,0,110010094001003,5,503,503,5,psa_45,5D2
1000000US110010094001012,"Block 1012, Block Group 1, Census Tract 94, District of Columbia, District of Columbia",30,4,23,0,0,0,2,1,30,29,4,23,0,0,0,2,0,1,0,0,0,0,0,0,1,110010094001012,5,503,503,5,psa_45,5D2
1000000US110010094001013,"Block 1013, Block Group 1, Census Tract 94, District of Columbia, District of Columbia",50,3,44,0,0,0,0,3,50,50,3,44,0,0,0,0,3,0,0,0,0,0,0,0,0,110010094001013,5,503,503,5,psa_45,5D2
1000000US110010094002001,"Block 2001, Block Group 2, Census Tract 94, District of Columbia, District of Columbia",16,3,13,0,0,0,0,0,16,14,1,13,0,0,0,0,0,2,2,0,0,0,0,0,0,110010094002001,5,504,504,5,psa_43,5D2
1000000US110010094003008,"Block 3008, Block Group 3, Census Tract 94, District of Columbia, District of Columbia",26,0,26,0,0,0,0,0,26,26,0,26,0,0,0,0,0,0,0,0,0,0,0,0,0,110010094003008,5,503,503,5,psa_45,5D2
1000000US110010094003009,"Block 3009, Block Group 3, Census Tract 94, District of Columbia, District of Columbia",97,9,80,1,0,0,1,6,97,94,8,79,1,0,0,0,6,3,1,1,0,0,0,1,0,110010094003009,5,503,503,5,psa_45,5D2
1000000US110010094004014,"Block 4014, Block Group 4, Census Tract 94, District of Columbia, District of Columbia",2,0,0,0,0,0,0,2,2,2,0,0,0,0,0,0,2,0,0,0,0,0,0,0,0,110010094004014,5,503,503,5,psa_45,5D2
1000000US110010095011001,"Block 1001, Block Group 1, Census Tract 95.01, District of Columbia, District of Columbia",1025,81,567,15,2,4,301,55,1025,605,25,557,2,2,4,0,15,420,56,10,13,0,0,301,40,110010095011001,4,405,405,4,psa_49,4D2
1000000US110010095011002,"Block 1002, Block Group 1, Census Tract 95.01, District of Columbia, District of Columbia",116,5,83,1,0,0,25,2,116,83,5,77,1,0,0,0,0,33,0,6,0,0,0,25,2,110010095011002,4,405,405,4,psa_49,4D2
1000000US110010095011007,"Block 1007, Block Group 1, Census Tract 95.01, District of Columbia, District of Columbia",277,38,211,2,7,0,2,17,277,267,37,206,0,7,0,1,16,10,1,5,2,0,0,1,1,110010095011007,4,405,405,4,psa_49,4D2
1000000US110010095012000,"Block 2000, Block Group 2, Census Tract 95.01, District of Columbia, District of Columbia",0,0,0,0,0,0,0,0,0,0,0,0,0,0,0,0,0,0,0,0,0,0,0,0,0,110010095012000,4,405,405,4,psa_49,4D2
1000000US110010095012002,"Block 2002, Block Group 2, Census Tract 95.01, District of Columbia, District of Columbia",286,17,216,0,1,1,39,12,286,224,7,211,0,0,0,0,6,62,10,5,0,1,1,39,6,110010095012002,4,405,405,4,psa_49,4D2
1000000US110010095012006,"Block 2006, Block Group 2, Census Tract 95.01, District of Columbia, District of Columbia",53,4,49,0,0,0,0,0,53,52,4,48,0,0,0,0,0,1,0,1,0,0,0,0,0,110010095012006,4,405,405,4,psa_49,4D2
1000000US110010095013005,"Block 3005, Block Group 3, Census Tract 95.01, District of Columbia, District of Columbia",361,98,245,0,2,0,9,7,361,340,93,239,0,2,0,0,6,21,5,6,0,0,0,9,1,110010095013005,4,405,405,4,psa_49,4D2
1000000US110010095013008,"Block 3008, Block Group 3, Census Tract 95.01, District of Columbia, District of Columbia",29,4,22,1,0,0,2,0,29,27,4,22,1,0,0,0,0,2,0,0,0,0,0,2,0,110010095013008,4,405,405,4,psa_49,4D2
1000000US110010095032014,"Block 2014, Block Group 2, Census Tract 95.03, District of Columbia, District of Columbia",69,17,50,0,1,0,0,1,69,59,8,50,0,1,0,0,0,10,9,0,0,0,0,0,1,110010095032014,5,503,503,5,psa_45,5D2
1000000US110010095032015,"Block 2015, Block Group 2, Census Tract 95.03, District of Columbia, District of Columbia",5,0,5,0,0,0,0,0,5,5,0,5,0,0,0,0,0,0,0,0,0,0,0,0,0,110010095032015,5,503,503,5,psa_45,5D2
1000000US110010095041011,"Block 1011, Block Group 1, Census Tract 95.04, District of Columbia, District of Columbia",76,27,47,0,2,0,0,0,76,76,27,47,0,2,0,0,0,0,0,0,0,0,0,0,0,110010095041011,5,504,504,5,psa_43,5D2
1000000US110010095041020,"Block 1020, Block Group 1, Census Tract 95.04, District of Columbia, District of Columbia",62,25,30,2,0,0,1,4,62,48,16,29,0,0,0,0,3,14,9,1,2,0,0,1,1,110010095041020,5,504,504,5,psa_43,5D2
1000000US110010095041024,"Block 1024, Block Group 1, Census Tract 95.04, District of Columbia, District of Columbia",39,8,17,2,1,0,10,1,39,27,8,17,0,1,0,0,1,12,0,0,2,0,0,10,0,110010095041024,5,504,504,5,psa_43,5D2
1000000US110010095042006,"Block 2006, Block Group 2, Census Tract 95.04, District of Columbia, District of Columbia",200,2,192,0,5,0,0,1,200,200,2,192,0,5,0,0,1,0,0,0,0,0,0,0,0,110010095042006,4,405,405,4,psa_49,4D2
1000000US110010095042008,"Block 2008, Block Group 2, Census Tract 95.04, District of Columbia, District of Columbia",123,1,116,0,0,0,1,5,123,123,1,116,0,0,0,1,5,0,0,0,0,0,0,0,0,110010095042008,4,405,405,4,psa_49,4D2
1000000US110010095052008,"Block 2008, Block Group 2, Census Tract 95.05, District of Columbia, District of Columbia",44,0,40,0,0,0,0,4,44,44,0,40,0,0,0,0,4,0,0,0,0,0,0,0,0,110010095052008,4,406,406,4,psa_54,4D2
1000000US110010095052009,"Block 2009, Block Group 2, Census Tract 95.05, District of Columbia, District of Columbia",5,0,5,0,0,0,0,0,5,5,0,5,0,0,0,0,0,0,0,0,0,0,0,0,0,110010095052009,4,406,406,4,psa_54,4D2
1000000US110010095053002,"Block 3002, Block Group 3, Census Tract 95.05, District of Columbia, District of Columbia",77,3,61,0,1,0,9,3,77,68,2,61,0,1,0,1,3,9,1,0,0,0,0,8,0,110010095053002,4,406,406,4,psa_54,4D2
1000000US110010095053003,"Block 3003, Block Group 3, Census Tract 95.05, District of Columbia, District of Columbia",2,0,2,0,0,0,0,0,2,2,0,2,0,0,0,0,0,0,0,0,0,0,0,0,0,110010095053003,4,406,406,4,psa_54,4D2
1000000US110010095083000,"Block 3000, Block Group 3, Census Tract 95.08, District of Columbia, District of Columbia",300,6,268,0,0,0,21,5,300,266,2,260,0,0,0,0,4,34,4,8,0,0,0,21,1,110010095083000,4,406,406,4,psa_54,4D2
1000000US110010095083007,"Block 3007, Block Group 3, Census Tract 95.08, District of Columbia, District of Columbia",76,0,71,1,0,0,4,0,76,72,0,71,1,0,0,0,0,4,0,0,0,0,0,4,0,110010095083007,4,405,405,4,psa_49,4D2
1000000US110010096011006,"Block 1006, Block Group 1, Census Tract 96.01, District of Columbia, District of Columbia",348,0,348,0,0,0,0,0,348,347,0,347,0,0,0,0,0,1,0,1,0,0,0,0,0,110010096011006,6,601,601,6,psa_30,6D1
1000000US110010096011008,"Block 1008, Block Group 1, Census Tract 96.01, District of Columbia, District of Columbia",234,0,228,0,0,0,6,0,234,228,0,228,0,0,0,0,0,6,0,0,0,0,0,6,0,110010096011008,6,601,601,6,psa_30,6D1
1000000US110010096011011,"Block 1011, Block Group 1, Census Tract 96.01, District of Columbia, District of Columbia",324,0,322,0,0,0,0,2,324,324,0,322,0,0,0,0,2,0,0,0,0,0,0,0,0,110010096011011,6,601,601,6,psa_30,6D1
1000000US110010096011012,"Block 1012, Block Group 1, Census Tract 96.01, District of Columbia, District of Columbia",201,4,191,0,0,0,0,6,201,201,4,191,0,0,0,0,6,0,0,0,0,0,0,0,0,110010096011012,6,601,601,6,psa_30,6D1
1000000US110010096011013,"Block 1013, Block Group 1, Census Tract 96.01, District of Columbia, District of Columbia",27,0,26,0,0,0,0,1,27,27,0,26,0,0,0,0,1,0,0,0,0,0,0,0,0,110010096011013,6,601,601,6,psa_30,6D1
1000000US110010096011015,"Block 1015, Block Group 1, Census Tract 96.01, District of Columbia, District of Columbia",53,0,53,0,0,0,0,0,53,53,0,53,0,0,0,0,0,0,0,0,0,0,0,0,0,110010096011015,6,601,601,6,psa_30,6D1
1000000US110010096011036,"Block 1036, Block Group 1, Census Tract 96.01, District of Columbia, District of Columbia",5,0,5,0,0,0,0,0,5,5,0,5,0,0,0,0,0,0,0,0,0,0,0,0,0,110010096011036,6,601,601,6,psa_30,6D1
1000000US110010096011037,"Block 1037, Block Group 1, Census Tract 96.01, District of Columbia, District of Columbia",34,1,28,0,0,0,0,5,34,33,0,28,0,0,0,0,5,1,1,0,0,0,0,0,0,110010096011037,6,602,602,6,psa_25,6D1
1000000US110010096011038,"Block 1038, Block Group 1, Census Tract 96.01, District of Columbia, District of Columbia",65,0,63,0,1,0,0,1,65,65,0,63,0,1,0,0,1,0,0,0,0,0,0,0,0,110010096011038,6,602,602,6,psa_25,6D1
1000000US110010096011039,"Block 1039, Block Group 1, Census Tract 96.01, District of Columbia, District of Columbia",47,0,47,0,0,0,0,0,47,47,0,47,0,0,0,0,0,0,0,0,0,0,0,0,0,110010096011039,6,602,602,6,psa_25,6D1
1000000US110010096011040,"Block 1040, Block Group 1, Census Tract 96.01, District of Columbia, District of Columbia",5,0,5,0,0,0,0,0,5,5,0,5,0,0,0,0,0,0,0,0,0,0,0,0,0,110010096011040,6,602,602,6,psa_25,6D1
1000000US110010096021000,"Block 1000, Block Group 1, Census Tract 96.02, District of Columbia, District of Columbia",408,4,389,3,1,0,0,11,408,399,1,388,0,1,0,0,9,9,3,1,3,0,0,0,2,110010096021000,6,601,601,6,psa_30,6D1
1000000US110010096021001,"Block 1001, Block Group 1, Census Tract 96.02, District of Columbia, District of Columbia",38,1,33,1,0,0,0,3,38,38,1,33,1,0,0,0,3,0,0,0,0,0,0,0,0,110010096021001,6,601,601,6,psa_30,6D1
1000000US110010096021002,"Block 1002, Block Group 1, Census Tract 96.02, District of Columbia, District of Columbia",644,3,629,4,0,0,0,8,644,640,3,625,4,0,0,0,8,4,0,4,0,0,0,0,0,110010096021002,6,601,601,6,psa_30,6D1
1000000US110010096021005,"Block 1005, Block Group 1, Census Tract 96.02, District of Columbia, District of Columbia",122,2,107,0,0,0,5,8,122,116,2,106,0,0,0,0,8,6,0,1,0,0,0,5,0,110010096021005,6,601,601,6,psa_30,6D1
1000000US110010096021011,"Block 1011, Block Group 1, Census Tract 96.02, District of Columbia, District of Columbia",356,12,330,0,0,0,1,13,356,355,11,330,0,0,0,1,13,1,1,0,0,0,0,0,0,110010096021011,6,601,601,6,psa_30,6D1
1000000US110010096021017,"Block 1017, Block Group 1, Census Tract 96.02, District of Columbia, District of Columbia",2,0,2,0,0,0,0,0,2,2,0,2,0,0,0,0,0,0,0,0,0,0,0,0,0,110010096021017,6,601,601,6,psa_30,6D1
1000000US110010096022003,"Block 2003, Block Group 2, Census Tract 96.02, District of Columbia, District of Columbia",679,2,663,1,1,0,6,6,679,672,2,663,1,1,0,0,5,7,0,0,0,0,0,6,1,110010096022003,6,601,601,6,psa_30,6D1
1000000US110010096022004,"Block 2004, Block Group 2, Census Tract 96.02, District of Columbia, District of Columbia",841,0,826,0,0,0,6,9,841,831,0,825,0,0,0,0,6,10,0,1,0,0,0,6,3,110010096022004,6,601,601,6,psa_30,6D1
1000000US110010096032004,"Block 2004, Block Group 2, Census Tract 96.03, District of Columbia, District of Columbia",46,0,46,0,0,0,0,0,46,46,0,46,0,0,0,0,0,0,0,0,0,0,0,0,0,110010096032004,6,603,603,6,psa_15,6D3
1000000US110010096032009,"Block 2009, Block Group 2, Census Tract 96.03, District of Columbia, District of Columbia",89,0,88,0,0,0,0,1,89,87,0,86,0,0,0,0,1,2,0,2,0,0,0,0,0,110010096032009,6,603,603,6,psa_15,6D3
1000000US110010097001002,"Block 1002, Block Group 1, Census Tract 97, District of Columbia, District of Columbia",18,0,18,0,0,0,0,0,18,18,0,18,0,0,0,0,0,0,0,0,0,0,0,0,0,110010097001002,7,706,706,7,psa_2,7D3
1000000US110010097001003,"Block 1003, Block Group 1, Census Tract 97, District of Columbia, District of Columbia",360,0,345,1,0,0,2,12,360,357,0,344,1,0,0,0,12,3,0,1,0,0,0,2,0,110010097001003,7,706,706,7,psa_2,7D3
1000000US110010097001004,"Block 1004, Block Group 1, Census Tract 97, District of Columbia, District of Columbia",72,0,72,0,0,0,0,0,72,72,0,72,0,0,0,0,0,0,0,0,0,0,0,0,0,110010097001004,7,706,706,7,psa_2,7D3
1000000US110010097001006,"Block 1006, Block Group 1, Census Tract 97, District of Columbia, District of Columbia",119,2,115,2,0,0,0,0,119,118,2,114,2,0,0,0,0,1,0,1,0,0,0,0,0,110010097001006,7,706,706,7,psa_2,7D3
1000000US110010097001009,"Block 1009, Block Group 1, Census Tract 97, District of Columbia, District of Columbia",105,0,100,1,0,0,0,4,105,105,0,100,1,0,0,0,4,0,0,0,0,0,0,0,0,110010097001009,7,706,706,7,psa_2,7D3
1000000US110010097001010,"Block 1010, Block Group 1, Census Tract 97, District of Columbia, District of Columbia",8,0,8,0,0,0,0,0,8,8,0,8,0,0,0,0,0,0,0,0,0,0,0,0,0,110010097001010,7,706,706,7,psa_2,7D3
1000000US110010097001011,"Block 1011, Block Group 1, Census Tract 97, District of Columbia, District of Columbia",160,0,160,0,0,0,0,0,160,157,0,157,0,0,0,0,0,3,0,3,0,0,0,0,0,110010097001011,7,706,706,7,psa_2,7D3
1000000US110010097002000,"Block 2000, Block Group 2, Census Tract 97, District of Columbia, District of Columbia",508,2,501,0,2,0,0,3,508,507,2,500,0,2,0,0,3,1,0,1,0,0,0,0,0,110010097002000,7,706,706,7,psa_2,7D3
1000000US110010001004040,"Block 4040, Block Group 4, Census Tract 1, District of Columbia, District of Columbia",8,7,0,0,1,0,0,0,8,8,7,0,0,1,0,0,0,0,0,0,0,0,0,0,0,110010001004040,2,206,206,2,psa_29,2D2
1000000US110010001004041,"Block 4041, Block Group 4, Census Tract 1, District of Columbia, District of Columbia",33,30,1,1,0,0,0,1,33,32,29,1,1,0,0,0,1,1,1,0,0,0,0,0,0,110010001004041,2,206,206,2,psa_29,2D2
1000000US110010001004042,"Block 4042, Block Group 4, Census Tract 1, District of Columbia, District of Columbia",0,0,0,0,0,0,0,0,0,0,0,0,0,0,0,0,0,0,0,0,0,0,0,0,0,110010001004042,2,206,206,2,psa_29,2D2
1000000US110010002011000,"Block 1000, Block Group 1, Census Tract 2.01, District of Columbia, District of Columbia",28,25,2,0,1,0,0,0,28,27,24,2,0,1,0,0,0,1,1,0,0,0,0,0,0,110010002011000,2,206,206,2,psa_29,2D2
1000000US110010002021010,"Block 1010, Block Group 1, Census Tract 2.02, District of Columbia, District of Columbia",167,158,4,0,5,0,0,0,167,157,149,3,0,5,0,0,0,10,9,1,0,0,0,0,0,110010002021010,2,206,206,2,psa_29,2D2
1000000US110010002021011,"Block 1011, Block Group 1, Census Tract 2.02, District of Columbia, District of Columbia",217,198,0,0,11,0,4,4,217,197,184,0,0,9,0,0,4,20,14,0,0,2,0,4,0,110010002021011,2,206,206,2,psa_29,2D2
1000000US110010002024023,"Block 4023, Block Group 4, Census Tract 2.02, District of Columbia, District of Columbia",183,146,13,0,20,0,0,4,183,172,135,13,0,20,0,0,4,11,11,0,0,0,0,0,0,110010002024023,2,206,206,2,psa_29,2D2
1000000US110010002024027,"Block 4027, Block Group 4, Census Tract 2.02, District of Columbia, District of Columbia",79,66,4,0,5,0,0,4,79,73,60,4,0,5,0,0,4,6,6,0,0,0,0,0,0,110010002024027,2,206,206,2,psa_29,2D2
1000000US110010002024028,"Block 4028, Block Group 4, Census Tract 2.02, District of Columbia, District of Columbia",64,51,0,0,11,0,0,2,64,59,46,0,0,11,0,0,2,5,5,0,0,0,0,0,0,110010002024028,2,206,206,2,psa_29,2D2
1000000US110010002024030,"Block 4030, Block Group 4, Census Tract 2.02, District of Columbia, District of Columbia",16,12,1,0,3,0,0,0,16,15,11,1,0,3,0,0,0,1,1,0,0,0,0,0,0,110010002024030,2,206,206,2,psa_29,2D2
1000000US110010002024031,"Block 4031, Block Group 4, Census Tract 2.02, District of Columbia, District of Columbia",70,67,0,0,3,0,0,0,70,68,65,0,0,3,0,0,0,2,2,0,0,0,0,0,0,110010002024031,2,206,206,2,psa_29,2D2
1000000US110010003002004,"Block 2004, Block Group 2, Census Tract 3, District of Columbia, District of Columbia",615,514,18,4,36,0,18,25,615,564,484,17,4,35,0,3,21,51,30,1,0,1,0,15,4,110010003002004,2,204,204,2,psa_44,2D2
1000000US110010003003003,"Block 3003, Block Group 3, Census Tract 3, District of Columbia, District of Columbia",439,395,8,0,25,0,4,7,439,416,375,8,0,25,0,1,7,23,20,0,0,0,0,3,0,110010003003003,2,206,206,2,psa_29,2D2
1000000US110010003003004,"Block 3004, Block Group 3, Census Tract 3, District of Columbia, District of Columbia",46,45,0,0,0,0,0,1,46,37,37,0,0,0,0,0,0,9,8,0,0,0,0,0,1,110010003003004,2,206,206,2,psa_29,2D2
1000000US110010003003005,"Block 3005, Block Group 3, Census Tract 3, District of Columbia, District of Columbia",82,73,0,0,4,0,0,5,82,65,56,0,0,4,0,0,5,17,17,0,0,0,0,0,0,110010003003005,2,206,206,2,psa_29,2D2
1000000US110010003003006,"Block 3006, Block Group 3, Census Tract 3, District of Columbia, District of Columbia",246,216,7,0,19,0,2,2,246,219,191,7,0,19,0,0,2,27,25,0,0,0,0,2,0,110010003003006,2,206,206,2,psa_29,2D2
1000000US110010003003008,"Block 3008, Block Group 3, Census Tract 3, District of Columbia, District of Columbia",0,0,0,0,0,0,0,0,0,0,0,0,0,0,0,0,0,0,0,0,0,0,0,0,0,110010003003008,2,206,206,2,psa_29,2D2
1000000US110010004002012,"Block 2012, Block Group 2, Census Tract 4, District of Columbia, District of Columbia",22,8,0,0,14,0,0,0,22,20,6,0,0,14,0,0,0,2,2,0,0,0,0,0,0,110010004002012,2,204,204,2,psa_44,2D2
1000000US110010004002013,"Block 2013, Block Group 2, Census Tract 4, District of Columbia, District of Columbia",2,0,2,0,0,0,0,0,2,2,0,2,0,0,0,0,0,0,0,0,0,0,0,0,0,110010004002013,2,204,204,2,psa_44,2D2
1000000US110010004002021,"Block 2021, Block Group 2, Census Tract 4, District of Columbia, District of Columbia",5,5,0,0,0,0,0,0,5,4,4,0,0,0,0,0,0,1,1,0,0,0,0,0,0,110010004002021,2,204,204,2,psa_44,2D2
1000000US110010007011004,"Block 1004, Block Group 1, Census Tract 7.01, District of Columbia, District of Columbia",496,323,64,2,56,0,26,25,496,403,269,54,1,56,0,4,19,93,54,10,1,0,0,22,6,110010007011004,2,204,204,2,psa_44,2D2
1000000US110010007011005,"Block 1005, Block Group 1, Census Tract 7.01, District of Columbia, District of Columbia",227,204,9,0,7,0,4,3,227,212,193,9,0,7,0,0,3,15,11,0,0,0,0,4,0,110010007011005,2,204,204,2,psa_44,2D2
1000000US110010007011007,"Block 1007, Block Group 1, Census Tract 7.01, District of Columbia, District of Columbia",195,168,6,1,16,0,3,1,195,184,159,6,0,16,0,2,1,11,9,0,1,0,0,1,0,110010007011007,2,204,204,2,psa_44,2D2
1000000US110010007012000,"Block 2000, Block Group 2, Census Tract 7.01, District of Columbia, District of Columbia",408,307,39,0,35,0,18,9,408,365,285,35,0,35,0,6,4,43,22,4,0,0,0,12,5,110010007012000,2,205,205,2,psa_46,2D2
1000000US110010007013000,"Block 3000, Block Group 3, Census Tract 7.01, District of Columbia, District of Columbia",710,651,14,1,27,0,10,7,710,683,634,14,0,27,0,2,6,27,17,0,1,0,0,8,1,110010007013000,2,204,204,2,psa_44,2D2
1000000US110010007013001,"Block 3001, Block Group 3, Census Tract 7.01, District of Columbia, District of Columbia",139,136,0,0,0,0,0,3,139,133,130,0,0,0,0,0,3,6,6,0,0,0,0,0,0,110010007013001,2,204,204,2,psa_44,2D2
1000000US110010007021005,"Block 1005, Block Group 1, Census Tract 7.02, District of Columbia, District of Columbia",248,221,8,0,11,0,3,5,248,227,207,4,0,11,0,1,4,21,14,4,0,0,0,2,1,110010007021005,2,204,204,2,psa_44,2D2
1000000US110010008011000,"Block 1000, Block Group 1, Census Tract 8.01, District of Columbia, District of Columbia",2303,1897,133,3,147,0,55,68,2303,2014,1672,127,2,145,0,10,58,289,225,6,1,2,0,45,10,110010008011000,2,205,205,2,psa_46,2D2
1000000US110010008011001,"Block 1001, Block Group 1, Census Tract 8.01, District of Columbia, District of Columbia",287,242,24,0,16,0,0,5,287,272,228,24,0,16,0,0,4,15,14,0,0,0,0,0,1,110010008011001,2,205,205,2,psa_46,2D2
1000000US110010008012008,"Block 2008, Block Group 2, Census Tract 8.01, District of Columbia, District of Columbia",360,288,25,1,29,0,6,11,360,333,268,25,0,29,0,3,8,27,20,0,1,0,0,3,3,110010008012008,2,205,205,2,psa_46,2D2
1000000US110010008012009,"Block 2009, Block Group 2, Census Tract 8.01, District of Columbia, District of Columbia",38,26,3,0,0,0,0,9,38,29,23,3,0,0,0,0,3,9,3,0,0,0,0,0,6,110010008012009,2,205,205,2,psa_46,2D2
1000000US110010008012012,"Block 2012, Block Group 2, Census Tract 8.01, District of Columbia, District of Columbia",44,34,4,1,5,0,0,0,44,39,29,4,1,5,0,0,0,5,5,0,0,0,0,0,0,110010008012012,2,205,205,2,psa_46,2D2
1000000US110010008013000,"Block 3000, Block Group 3, Census Tract 8.01, District of Columbia, District of Columbia",168,146,5,0,13,0,2,2,168,155,135,5,0,13,0,1,1,13,11,0,0,0,0,1,1,110010008013000,2,205,205,2,psa_46,2D2
1000000US110010008013001,"Block 3001, Block Group 3, Census Tract 8.01, District of Columbia, District of Columbia",370,339,4,0,18,0,1,8,370,341,316,3,0,18,0,0,4,29,23,1,0,0,0,1,4,110010008013001,2,205,205,2,psa_46,2D2
1000000US110010008013022,"Block 3022, Block Group 3, Census Tract 8.01, District of Columbia, District of Columbia",343,282,18,0,22,0,11,10,343,311,262,17,0,22,0,3,7,32,20,1,0,0,0,8,3,110010008013022,2,204,204,2,psa_44,2D2
1000000US110010008013033,"Block 3033, Block Group 3, Census Tract 8.01, District of Columbia, District of Columbia",128,121,0,0,2,0,1,4,128,122,116,0,0,2,0,0,4,6,5,0,0,0,0,1,0,110010008013033,2,205,205,2,psa_46,2D2
1000000US110010008013034,"Block 3034, Block Group 3, Census Tract 8.01, District of Columbia, District of Columbia",4,4,0,0,0,0,0,0,4,4,4,0,0,0,0,0,0,0,0,0,0,0,0,0,0,110010008013034,2,205,205,2,psa_46,2D2
1000000US110010008022008,"Block 2008, Block Group 2, Census Tract 8.02, District of Columbia, District of Columbia",206,182,0,0,13,0,0,11,206,192,168,0,0,13,0,0,11,14,14,0,0,0,0,0,0,110010008022008,2,205,205,2,psa_46,2D2
1000000US110010008022011,"Block 2011, Block Group 2, Census Tract 8.02, District of Columbia, District of Columbia",0,0,0,0,0,0,0,0,0,0,0,0,0,0,0,0,0,0,0,0,0,0,0,0,0,110010008022011,2,205,205,2,psa_46,2D2
1000000US110010008022013,"Block 2013, Block Group 2, Census Tract 8.02, District of Columbia, District of Columbia",94,76,1,0,8,0,4,5,94,80,67,1,0,8,0,1,3,14,9,0,0,0,0,3,2,110010008022013,2,205,205,2,psa_46,2D2
1000000US110010008022018,"Block 2018, Block Group 2, Census Tract 8.02, District of Columbia, District of Columbia",17,17,0,0,0,0,0,0,17,16,16,0,0,0,0,0,0,1,1,0,0,0,0,0,0,110010008022018,2,205,205,2,psa_46,2D2
1000000US110010009012019,"Block 2019, Block Group 2, Census Tract 9.01, District of Columbia, District of Columbia",51,42,3,0,2,0,3,1,51,42,37,3,0,2,0,0,0,9,5,0,0,0,0,3,1,110010009012019,2,205,205,2,psa_46,2D2
1000000US110010009012025,"Block 2025, Block Group 2, Census Tract 9.01, District of Columbia, District of Columbia",131,127,1,0,1,0,2,0,131,128,125,1,0,1,0,1,0,3,2,0,0,0,0,1,0,110010009012025,2,205,205,2,psa_46,2D2
1000000US110010009013026,"Block 3026, Block Group 3, Census Tract 9.01, District of Columbia, District of Columbia",66,49,2,0,12,0,0,3,66,62,45,2,0,12,0,0,3,4,4,0,0,0,0,0,0,110010009013026,2,205,205,2,psa_46,2D2
1000000US110010009013028,"Block 3028, Block Group 3, Census Tract 9.01, District of Columbia, District of Columbia",15,11,0,0,4,0,0,0,15,15,11,0,0,4,0,0,0,0,0,0,0,0,0,0,0,110010009013028,2,205,205,2,psa_46,2D2
1000000US110010009013029,"Block 3029, Block Group 3, Census Tract 9.01, District of Columbia, District of Columbia",62,58,3,0,0,0,0,1,62,53,49,3,0,0,0,0,1,9,9,0,0,0,0,0,0,110010009013029,2,205,205,2,psa_46,2D2
1000000US110010010012008,"Block 2008, Block Group 2, Census Tract 10.01, District of Columbia, District of Columbia",39,29,1,0,9,0,0,0,39,34,25,0,0,9,0,0,0,5,4,1,0,0,0,0,0,110010010012008,2,202,202,2,psa_52,2D1
1000000US110010010012009,"Block 2009, Block Group 2, Census Tract 10.01, District of Columbia, District of Columbia",17,15,0,0,2,0,0,0,17,17,15,0,0,2,0,0,0,0,0,0,0,0,0,0,0,110010010012009,2,202,202,2,psa_52,2D1
1000000US110010010012015,"Block 2015, Block Group 2, Census Tract 10.01, District of Columbia, District of Columbia",87,77,3,0,5,0,0,2,87,87,77,3,0,5,0,0,2,0,0,0,0,0,0,0,0,110010010012015,2,202,202,2,psa_52,2D1
1000000US110010011001012,"Block 1012, Block Group 1, Census Tract 11, District of Columbia, District of Columbia",102,99,0,0,3,0,0,0,102,100,97,0,0,3,0,0,0,2,2,0,0,0,0,0,0,110010011001012,2,201,201,2,psa_55,2D1
1000000US110010011001015,"Block 1015, Block Group 1, Census Tract 11, District of Columbia, District of Columbia",10,10,0,0,0,0,0,0,10,10,10,0,0,0,0,0,0,0,0,0,0,0,0,0,0,110010011001015,2,202,202,2,psa_52,2D1
1000000US110010011001019,"Block 1019, Block Group 1, Census Tract 11, District of Columbia, District of Columbia",89,86,0,0,0,0,3,0,89,82,79,0,0,0,0,3,0,7,7,0,0,0,0,0,0,110010011001019,2,201,201,2,psa_55,2D1
1000000US110010011001022,"Block 1022, Block Group 1, Census Tract 11, District of Columbia, District of Columbia",32,27,0,0,5,0,0,0,32,31,26,0,0,5,0,0,0,1,1,0,0,0,0,0,0,110010011001022,2,201,201,2,psa_55,2D1
1000000US110010011004003,"Block 4003, Block Group 4, Census Tract 11, District of Columbia, District of Columbia",43,36,0,1,5,0,0,1,43,42,35,0,1,5,0,0,1,1,1,0,0,0,0,0,0,110010011004003,2,202,202,2,psa_52,2D1
1000000US110010011004007,"Block 4007, Block Group 4, Census Tract 11, District of Columbia, District of Columbia",3,3,0,0,0,0,0,0,3,3,3,0,0,0,0,0,0,0,0,0,0,0,0,0,0,110010011004007,2,202,202,2,psa_52,2D1
1000000US110010013011007,"Block 1007, Block Group 1, Census Tract 13.01, District of Columbia, District of Columbia",155,126,14,0,5,0,2,8,155,150,123,14,0,5,0,0,8,5,3,0,0,0,0,2,0,110010013011007,2,203,203,2,psa_50,2D1
1000000US110010013012009,"Block 2009, Block Group 2, Census Tract 13.01, District of Columbia, District of Columbia",2,2,0,0,0,0,0,0,2,2,2,0,0,0,0,0,0,0,0,0,0,0,0,0,0,110010013012009,2,203,203,2,psa_50,2D1
1000000US110010013022001,"Block 2001, Block Group 2, Census Tract 13.02, District of Columbia, District of Columbia",2280,1905,94,6,190,1,24,60,2280,2124,1788,89,2,187,1,3,54,156,117,5,4,3,0,21,6,110010013022001,2,203,203,2,psa_50,2D1
1000000US110010013022003,"Block 2003, Block Group 2, Census Tract 13.02, District of Columbia, District of Columbia",349,303,18,0,15,0,6,7,349,327,285,18,0,15,0,4,5,22,18,0,0,0,0,2,2,110010013022003,2,203,203,2,psa_50,2D1
1000000US110010013022005,"Block 2005, Block Group 2, Census Tract 13.02, District of Columbia, District of Columbia",25,25,0,0,0,0,0,0,25,25,25,0,0,0,0,0,0,0,0,0,0,0,0,0,0,110010013022005,2,203,203,2,psa_50,2D1
1000000US110010015003009,"Block 3009, Block Group 3, Census Tract 15, District of Columbia, District of Columbia",104,96,7,0,0,0,0,1,104,104,96,7,0,0,0,0,1,0,0,0,0,0,0,0,0,110010015003009,2,201,201,2,psa_55,2D1
1000000US110010015003010,"Block 3010, Block Group 3, Census Tract 15, District of Columbia, District of Columbia",245,232,10,2,0,0,0,1,245,243,230,10,2,0,0,0,1,2,2,0,0,0,0,0,0,110010015003010,2,201,201,2,psa_55,2D1
1000000US110010015003011,"Block 3011, Block Group 3, Census Tract 15, District of Columbia, District of Columbia",27,22,5,0,0,0,0,0,27,27,22,5,0,0,0,0,0,0,0,0,0,0,0,0,0,110010015003011,2,201,201,2,psa_55,2D1
1000000US110010015004014,"Block 4014, Block Group 4, Census Tract 15, District of Columbia, District of Columbia",4,0,4,0,0,0,0,0,4,4,0,4,0,0,0,0,0,0,0,0,0,0,0,0,0,110010015004014,2,201,201,2,psa_55,2D1
1000000US110010015005001,"Block 5001, Block Group 5, Census Tract 15, District of Columbia, District of Columbia",46,46,0,0,0,0,0,0,46,42,42,0,0,0,0,0,0,4,4,0,0,0,0,0,0,110010015005001,2,201,201,2,psa_55,2D1
1000000US110010016004000,"Block 4000, Block Group 4, Census Tract 16, District of Columbia, District of Columbia",66,3,60,0,0,0,1,2,66,64,3,60,0,0,0,0,1,2,0,0,0,0,0,1,1,110010016004000,4,401,401,4,psa_56,4D1
1000000US110010016004002,"Block 4002, Block Group 4, Census Tract 16, District of Columbia, District of Columbia",1,0,0,0,1,0,0,0,1,1,0,0,0,1,0,0,0,0,0,0,0,0,0,0,0,110010016004002,4,401,401,4,psa_56,4D1
1000000US110010016004004,"Block 4004, Block Group 4, Census Tract 16, District of Columbia, District of Columbia",30,4,25,0,1,0,0,0,30,30,4,25,0,1,0,0,0,0,0,0,0,0,0,0,0,110010016004004,4,401,401,4,psa_56,4D1
1000000US110010016004010,"Block 4010, Block Group 4, Census Tract 16, District of Columbia, District of Columbia",32,6,24,1,0,0,0,1,32,32,6,24,1,0,0,0,1,0,0,0,0,0,0,0,0,110010016004010,4,401,401,4,psa_56,4D1
1000000US110010016004015,"Block 4015, Block Group 4, Census Tract 16, District of Columbia, District of Columbia",39,11,28,0,0,0,0,0,39,39,11,28,0,0,0,0,0,0,0,0,0,0,0,0,0,110010016004015,4,401,401,4,psa_56,4D1
1000000US110010016004019,"Block 4019, Block Group 4, Census Tract 16, District of Columbia, District of Columbia",28,9,16,1,1,0,0,1,28,28,9,16,1,1,0,0,1,0,0,0,0,0,0,0,0,110010016004019,4,401,401,4,psa_56,4D1
1000000US110010016004022,"Block 4022, Block Group 4, Census Tract 16, District of Columbia, District of Columbia",80,28,49,3,0,0,0,0,80,74,27,47,0,0,0,0,0,6,1,2,3,0,0,0,0,110010016004022,4,401,401,4,psa_56,4D1
1000000US110010018043005,"Block 3005, Block Group 3, Census Tract 18.04, District of Columbia, District of Columbia",565,50,342,3,2,0,146,22,565,355,14,331,0,2,0,0,8,210,36,11,3,0,0,146,14,110010018043005,4,402,402,4,psa_53,4D1
1000000US110010018043006,"Block 3006, Block Group 3, Census Tract 18.04, District of Columbia, District of Columbia",5,4,0,0,0,0,0,1,5,0,0,0,0,0,0,0,0,5,4,0,0,0,0,0,1,110010018043006,4,402,402,4,psa_53,4D1
1000000US110010018043007,"Block 3007, Block Group 3, Census Tract 18.04, District of Columbia, District of Columbia",0,0,0,0,0,0,0,0,0,0,0,0,0,0,0,0,0,0,0,0,0,0,0,0,0,110010018043007,4,402,402,4,psa_53,4D1
1000000US110010019022011,"Block 2011, Block Group 2, Census Tract 19.02, District of Columbia, District of Columbia",64,8,54,0,2,0,0,0,64,64,8,54,0,2,0,0,0,0,0,0,0,0,0,0,0,110010019022011,4,406,406,4,psa_54,4D2
1000000US110010019022012,"Block 2012, Block Group 2, Census Tract 19.02, District of Columbia, District of Columbia",2,0,2,0,0,0,0,0,2,2,0,2,0,0,0,0,0,0,0,0,0,0,0,0,0,110010019022012,4,406,406,4,psa_54,4D2
1000000US110010020011002,"Block 1002, Block Group 1, Census Tract 20.01, District of Columbia, District of Columbia",57,13,40,0,0,0,4,0,57,39,2,37,0,0,0,0,0,18,11,3,0,0,0,4,0,110010020011002,4,403,403,4,psa_51,4D1
1000000US110010020012000,"Block 2000, Block Group 2, Census Tract 20.01, District of Columbia, District of Columbia",4,4,0,0,0,0,0,0,4,1,1,0,0,0,0,0,0,3,3,0,0,0,0,0,0,110010020012000,4,403,403,4,psa_51,4D1
1000000US110010020012004,"Block 2004, Block Group 2, Census Tract 20.01, District of Columbia, District of Columbia",90,17,51,0,0,0,20,2,90,66,17,48,0,0,0,0,1,24,0,3,0,0,0,20,1,110010020012004,4,403,403,4,psa_51,4D1
1000000US110010020021015,"Block 1015, Block Group 1, Census Tract 20.02, District of Columbia, District of Columbia",32,11,15,1,2,0,3,0,32,29,11,15,1,2,0,0,0,3,0,0,0,0,0,3,0,110010020021015,4,404,404,4,psa_48,4D3
1000000US110010020021016,"Block 1016, Block Group 1, Census Tract 20.02, District of Columbia, District of Columbia",93,22,63,0,0,0,4,4,93,86,18,60,0,0,0,4,4,7,4,3,0,0,0,0,0,110010020021016,4,404,404,4,psa_48,4D3
1000000US110010021014003,"Block 4003, Block Group 4, Census Tract 21.01, District of Columbia, District of Columbia",121,17,74,6,0,0,20,4,121,77,2,74,0,0,0,0,1,44,15,0,6,0,0,20,3,110010021014003,4,403,403,4,psa_51,4D1
1000000US110010021014008,"Block 4008, Block Group 4, Census Tract 21.01, District of Columbia, District of Columbia",14,0,6,0,0,0,8,0,14,6,0,6,0,0,0,0,0,8,0,0,0,0,0,8,0,110010021014008,4,403,403,4,psa_51,4D1
1000000US110010021022007,"Block 2007, Block Group 2, Census Tract 21.02, District of Columbia, District of Columbia",6,0,6,0,0,0,0,0,6,6,0,6,0,0,0,0,0,0,0,0,0,0,0,0,0,110010021022007,4,403,403,4,psa_51,4D1
1000000US110010021023004,"Block 3004, Block Group 3, Census Tract 21.02, District of Columbia, District of Columbia",160,7,142,3,0,0,3,5,160,155,7,142,3,0,0,0,3,5,0,0,0,0,0,3,2,110010021023004,4,403,403,4,psa_51,4D1
1000000US110010021024000,"Block 4000, Block Group 4, Census Tract 21.02, District of Columbia, District of Columbia",67,2,61,0,0,0,4,0,67,62,1,61,0,0,0,0,0,5,1,0,0,0,0,4,0,110010021024000,4,406,406,4,psa_54,4D2
1000000US110010021024006,"Block 4006, Block Group 4, Census Tract 21.02, District of Columbia, District of Columbia",3,0,2,0,0,0,0,1,3,3,0,2,0,0,0,0,1,0,0,0,0,0,0,0,0,110010021024006,4,403,403,4,psa_51,4D1
1000000US110010021024007,"Block 4007, Block Group 4, Census Tract 21.02, District of Columbia, District of Columbia",164,15,148,1,0,0,0,0,164,162,13,148,1,0,0,0,0,2,2,0,0,0,0,0,0,110010021024007,4,403,403,4,psa_51,4D1
1000000US110010021025004,"Block 5004, Block Group 5, Census Tract 21.02, District of Columbia, District of Columbia",31,26,5,0,0,0,0,0,31,30,25,5,0,0,0,0,0,1,1,0,0,0,0,0,0,110010021025004,4,403,403,4,psa_51,4D1
1000000US110010021026008,"Block 6008, Block Group 6, Census Tract 21.02, District of Columbia, District of Columbia",10,3,7,0,0,0,0,0,10,10,3,7,0,0,0,0,0,0,0,0,0,0,0,0,0,110010021026008,4,403,403,4,psa_51,4D1
1000000US110010022011008,"Block 1008, Block Group 1, Census Tract 22.01, District of Columbia, District of Columbia",135,17,84,0,1,0,32,1,135,90,6,82,0,1,0,1,0,45,11,2,0,0,0,31,1,110010022011008,4,407,407,4,psa_47,4D2
1000000US110010022011009,"Block 1009, Block Group 1, Census Tract 22.01, District of Columbia, District of Columbia",63,22,39,0,0,0,2,0,63,49,14,35,0,0,0,0,0,14,8,4,0,0,0,2,0,110010022011009,4,407,407,4,psa_47,4D2
1000000US110010022021001,"Block 1001, Block Group 1, Census Tract 22.02, District of Columbia, District of Columbia",485,66,278,11,10,0,106,14,485,335,31,278,3,10,0,1,12,150,35,0,8,0,0,105,2,110010022021001,4,407,407,4,psa_47,4D2
1000000US110010022021005,"Block 1005, Block Group 1, Census Tract 22.02, District of Columbia, District of Columbia",3,2,1,0,0,0,0,0,3,3,2,1,0,0,0,0,0,0,0,0,0,0,0,0,0,110010022021005,4,407,407,4,psa_47,4D2
1000000US110010022023003,"Block 3003, Block Group 3, Census Tract 22.02, District of Columbia, District of Columbia",12,0,6,0,0,0,0,6,12,12,0,6,0,0,0,0,6,0,0,0,0,0,0,0,0,110010022023003,4,407,407,4,psa_47,4D2
1000000US110010022023004,"Block 3004, Block Group 3, Census Tract 22.02, District of Columbia, District of Columbia",168,17,120,0,0,0,26,5,168,129,5,120,0,0,0,0,4,39,12,0,0,0,0,26,1,110010022023004,4,407,407,4,psa_47,4D2
1000000US110010023011005,"Block 1005, Block Group 1, Census Tract 23.01, District of Columbia, District of Columbia",76,9,63,2,2,0,0,0,76,74,9,61,2,2,0,0,0,2,0,2,0,0,0,0,0,110010023011005,4,407,407,4,psa_47,4D2
1000000US110010023011006,"Block 1006, Block Group 1, Census Tract 23.01, District of Columbia, District of Columbia",111,17,77,0,0,0,17,0,111,90,13,77,0,0,0,0,0,21,4,0,0,0,0,17,0,110010023011006,4,407,407,4,psa_47,4D2
1000000US110010023011007,"Block 1007, Block Group 1, Census Tract 23.01, District of Columbia, District of Columbia",32,5,26,1,0,0,0,0,32,32,5,26,1,0,0,0,0,0,0,0,0,0,0,0,0,110010023011007,4,407,407,4,psa_47,4D2
1000000US110010023011017,"Block 1017, Block Group 1, Census Tract 23.01, District of Columbia, District of Columbia",144,36,93,2,0,0,8,5,144,129,29,92,2,0,0,2,4,15,7,1,0,0,0,6,1,110010023011017,4,407,407,4,psa_47,4D2
1000000US110010023011018,"Block 1018, Block Group 1, Census Tract 23.01, District of Columbia, District of Columbia",3,0,2,0,0,0,0,1,3,2,0,2,0,0,0,0,0,1,0,0,0,0,0,0,1,110010023011018,4,407,407,4,psa_47,4D2
1000000US110010023012000,"Block 2000, Block Group 2, Census Tract 23.01, District of Columbia, District of Columbia",146,26,99,1,0,0,18,2,146,119,19,98,0,0,0,1,1,27,7,1,1,0,0,17,1,110010023012000,4,407,407,4,psa_47,4D2
1000000US110010023012003,"Block 2003, Block Group 2, Census Tract 23.01, District of Columbia, District of Columbia",151,13,123,2,1,0,8,4,151,132,6,123,0,1,0,1,1,19,7,0,2,0,0,7,3,110010023012003,4,407,407,4,psa_47,4D2
1000000US110010023021013,"Block 1013, Block Group 1, Census Tract 23.02, District of Columbia, District of Columbia",7,6,1,0,0,0,0,0,7,7,6,1,0,0,0,0,0,0,0,0,0,0,0,0,0,110010023021013,4,405,405,4,psa_49,4D2
1000000US110010023021025,"Block 1025, Block Group 1, Census Tract 23.02, District of Columbia, District of Columbia",14,1,12,0,1,0,0,0,14,14,1,12,0,1,0,0,0,0,0,0,0,0,0,0,0,110010023021025,4,405,405,4,psa_49,4D2
1000000US110010024001001,"Block 1001, Block Group 1, Census Tract 24, District of Columbia, District of Columbia",85,24,61,0,0,0,0,0,85,73,14,59,0,0,0,0,0,12,10,2,0,0,0,0,0,110010024001001,4,407,407,4,psa_47,4D2
1000000US110010024001002,"Block 1002, Block Group 1, Census Tract 24, District of Columbia, District of Columbia",4,0,3,0,0,0,0,1,4,4,0,3,0,0,0,0,1,0,0,0,0,0,0,0,0,110010024001002,4,407,407,4,psa_47,4D2
1000000US110010024002001,"Block 2001, Block Group 2, Census Tract 24, District of Columbia, District of Columbia",72,8,43,1,1,0,19,0,72,47,2,43,1,1,0,0,0,25,6,0,0,0,0,19,0,110010024002001,4,407,407,4,psa_47,4D2
1000000US110010024002002,"Block 2002, Block Group 2, Census Tract 24, District of Columbia, District of Columbia",19,7,10,1,0,0,0,1,19,10,3,7,0,0,0,0,0,9,4,3,1,0,0,0,1,110010024002002,4,407,407,4,psa_47,4D2
1000000US110010024003000,"Block 3000, Block Group 3, Census Tract 24, District of Columbia, District of Columbia",92,23,54,0,0,0,13,2,92,70,17,52,0,0,0,0,1,22,6,2,0,0,0,13,1,110010024003000,4,407,407,4,psa_47,4D2
1000000US110010024004004,"Block 4004, Block Group 4, Census Tract 24, District of Columbia, District of Columbia",45,8,33,0,0,0,0,4,45,39,4,32,0,0,0,0,3,6,4,1,0,0,0,0,1,110010024004004,4,407,407,4,psa_47,4D2
1000000US110010024004005,"Block 4005, Block Group 4, Census Tract 24, District of Columbia, District of Columbia",103,16,48,0,2,0,35,2,103,57,7,47,0,2,0,0,1,46,9,1,0,0,0,35,1,110010024004005,4,407,407,4,psa_47,4D2
1000000US110010025022003,"Block 2003, Block Group 2, Census Tract 25.02, District of Columbia, District of Columbia",1,0,1,0,0,0,0,0,1,1,0,1,0,0,0,0,0,0,0,0,0,0,0,0,0,110010025022003,4,404,404,4,psa_48,4D3
1000000US110010025022004,"Block 2004, Block Group 2, Census Tract 25.02, District of Columbia, District of Columbia",149,32,73,0,0,0,42,2,149,106,32,72,0,0,0,0,2,43,0,1,0,0,0,42,0,110010025022004,4,404,404,4,psa_48,4D3
1000000US110010026001004,"Block 1004, Block Group 1, Census Tract 26, District of Columbia, District of Columbia",371,153,143,0,19,0,28,28,371,312,130,138,0,19,0,2,23,59,23,5,0,0,0,26,5,110010026001004,4,404,404,4,psa_48,4D3
1000000US110010026001012,"Block 1012, Block Group 1, Census Tract 26, District of Columbia, District of Columbia",45,28,15,0,2,0,0,0,45,44,27,15,0,2,0,0,0,1,1,0,0,0,0,0,0,110010026001012,4,404,404,4,psa_48,4D3
1000000US110010026001017,"Block 1017, Block Group 1, Census Tract 26, District of Columbia, District of Columbia",2,0,2,0,0,0,0,0,2,2,0,2,0,0,0,0,0,0,0,0,0,0,0,0,0,110010026001017,4,404,404,4,psa_48,4D3
1000000US110010026002020,"Block 2020, Block Group 2, Census Tract 26, District of Columbia, District of Columbia",73,31,39,0,3,0,0,0,73,73,31,39,0,3,0,0,0,0,0,0,0,0,0,0,0,110010026002020,4,404,404,4,psa_48,4D3
1000000US110010026002021,"Block 2021, Block Group 2, Census Tract 26, District of Columbia, District of Columbia",48,12,27,0,2,0,0,7,48,46,10,27,0,2,0,0,7,2,2,0,0,0,0,0,0,110010026002021,4,404,404,4,psa_48,4D3
1000000US110010027012004,"Block 2004, Block Group 2, Census Tract 27.01, District of Columbia, District of Columbia",385,159,191,0,15,1,6,13,385,367,148,191,0,15,1,0,12,18,11,0,0,0,0,6,1,110010027012004,3,302,302,3,psa_42,3D1
1000000US110010027013001,"Block 3001, Block Group 3, Census Tract 27.01, District of Columbia, District of Columbia",248,191,26,1,11,0,7,12,248,218,179,23,0,11,0,0,5,30,12,3,1,0,0,7,7,110010027013001,3,302,302,3,psa_42,3D1
1000000US110010027022004,"Block 2004, Block Group 2, Census Tract 27.02, District of Columbia, District of Columbia",188,150,27,0,8,0,0,3,188,180,142,27,0,8,0,0,3,8,8,0,0,0,0,0,0,110010027022004,3,302,302,3,psa_42,3D1
1000000US110010027022006,"Block 2006, Block Group 2, Census Tract 27.02, District of Columbia, District of Columbia",294,163,37,0,9,0,64,21,294,190,140,35,0,9,0,2,4,104,23,2,0,0,0,62,17,110010027022006,3,302,302,3,psa_42,3D1
1000000US110010027023001,"Block 3001, Block Group 3, Census Tract 27.02, District of Columbia, District of Columbia",186,129,34,0,8,0,4,11,186,156,108,33,0,8,0,0,7,30,21,1,0,0,0,4,4,110010027023001,3,302,302,3,psa_42,3D1
1000000US110010027023007,"Block 3007, Block Group 3, Census Tract 27.02, District of Columbia, District of Columbia",228,178,30,0,3,0,12,5,228,209,168,30,0,3,0,4,4,19,10,0,0,0,0,8,1,110010027023007,3,302,302,3,psa_42,3D1
1000000US110010029001000,"Block 1000, Block Group 1, Census Tract 29, District of Columbia, District of Columbia",71,40,17,0,3,0,5,6,71,50,26,17,0,3,0,0,4,21,14,0,0,0,0,5,2,110010029001000,4,408,408,4,psa_39,4D3
1000000US110010029001001,"Block 1001, Block Group 1, Census Tract 29, District of Columbia, District of Columbia",334,89,188,0,11,0,41,5,334,276,74,186,0,11,0,0,5,58,15,2,0,0,0,41,0,110010029001001,4,408,408,4,psa_39,4D3
1000000US110010029001004,"Block 1004, Block Group 1, Census Tract 29, District of Columbia, District of Columbia",363,110,153,4,9,0,69,18,363,250,84,153,0,9,0,1,3,113,26,0,4,0,0,68,15,110010029001004,4,408,408,4,psa_39,4D3
1000000US110010031001005,"Block 1005, Block Group 1, Census Tract 31, District of Columbia, District of Columbia",6,5,0,0,0,0,0,1,6,5,5,0,0,0,0,0,0,1,0,0,0,0,0,0,1,110010031001005,3,302,302,3,psa_42,3D1
1000000US110010031001006,"Block 1006, Block Group 1, Census Tract 31, District of Columbia, District of Columbia",315,102,70,0,13,0,120,10,315,125,41,68,0,13,0,0,3,190,61,2,0,0,0,120,7,110010031001006,3,302,302,3,psa_42,3D1
1000000US110010031001015,"Block 1015, Block Group 1, Census Tract 31, District of Columbia, District of Columbia",111,38,30,0,2,0,38,3,111,47,16,29,0,2,0,0,0,64,22,1,0,0,0,38,3,110010031001015,3,302,302,3,psa_42,3D1
1000000US110010032003004,"Block 3004, Block Group 3, Census Tract 32, District of Columbia, District of Columbia",172,39,94,0,0,0,29,10,172,114,22,91,0,0,0,1,0,58,17,3,0,0,0,28,10,110010032003004,4,409,409,4,psa_41,4D3
1000000US110010032004000,"Block 4000, Block Group 4, Census Tract 32, District of Columbia, District of Columbia",162,30,115,2,1,0,14,0,162,124,12,108,2,1,0,1,0,38,18,7,0,0,0,13,0,110010032004000,4,409,409,4,psa_41,4D3
1000000US110010033021006,"Block 1006, Block Group 1, Census Tract 33.02, District of Columbia, District of Columbia",136,50,78,1,1,0,0,6,136,133,48,78,1,1,0,0,5,3,2,0,0,0,0,0,1,110010033021006,3,308,308,3,psa_27,3D2
1000000US110010033022002,"Block 2002, Block Group 2, Census Tract 33.02, District of Columbia, District of Columbia",120,41,60,0,5,0,4,10,120,105,31,60,0,5,0,1,8,15,10,0,0,0,0,3,2,110010033022002,3,308,308,3,psa_27,3D2
1000000US110010033022003,"Block 2003, Block Group 2, Census Tract 33.02, District of Columbia, District of Columbia",15,0,14,0,0,0,0,1,15,15,0,14,0,0,0,0,1,0,0,0,0,0,0,0,0,110010033022003,3,308,308,3,psa_27,3D2
1000000US110010034002028,"Block 2028, Block Group 2, Census Tract 34, District of Columbia, District of Columbia",119,33,71,0,9,0,1,5,119,115,32,71,0,9,0,1,2,4,1,0,0,0,0,0,3,110010034002028,3,308,308,3,psa_27,3D2
1000000US110010037002001,"Block 2001, Block Group 2, Census Tract 37, District of Columbia, District of Columbia",199,22,7,0,0,1,157,12,199,14,6,7,0,0,1,0,0,185,16,0,0,0,0,157,12,110010037002001,3,304,304,3,psa_36,3D1
1000000US110010037002002,"Block 2002, Block Group 2, Census Tract 37, District of Columbia, District of Columbia",876,204,514,4,37,5,69,43,876,721,151,506,3,37,2,1,21,155,53,8,1,0,3,68,22,110010037002002,3,304,304,3,psa_36,3D1
1000000US110010037003002,"Block 3002, Block Group 3, Census Tract 37, District of Columbia, District of Columbia",518,237,134,8,31,0,86,22,518,321,163,112,2,31,0,0,13,197,74,22,6,0,0,86,9,110010037003002,3,304,304,3,psa_36,3D1
1000000US110010037003003,"Block 3003, Block Group 3, Census Tract 37, District of Columbia, District of Columbia",378,209,108,3,19,1,27,11,378,304,169,106,3,19,1,1,5,74,40,2,0,0,0,26,6,110010037003003,3,304,304,3,psa_36,3D1
1000000US110010038002002,"Block 2002, Block Group 2, Census Tract 38, District of Columbia, District of Columbia",633,512,38,0,36,0,24,23,633,573,477,38,0,36,0,1,21,60,35,0,0,0,0,23,2,110010038002002,3,303,303,3,psa_37,3D3
1000000US110010038002003,"Block 2003, Block Group 2, Census Tract 38, District of Columbia, District of Columbia",1,1,0,0,0,0,0,0,1,1,1,0,0,0,0,0,0,0,0,0,0,0,0,0,0,110010038002003,3,303,303,3,psa_37,3D3
1000000US110010038003002,"Block 3002, Block Group 3, Census Tract 38, District of Columbia, District of Columbia",96,28,57,1,0,0,6,4,96,85,25,56,1,0,0,0,3,11,3,1,0,0,0,6,1,110010038003002,3,303,303,3,psa_37,3D3
1000000US110010038003003,"Block 3003, Block Group 3, Census Tract 38, District of Columbia, District of Columbia",266,89,121,0,6,0,42,8,266,171,43,115,0,6,0,2,5,95,46,6,0,0,0,40,3,110010038003003,3,303,303,3,psa_37,3D3
1000000US110010039001000,"Block 1000, Block Group 1, Census Tract 39, District of Columbia, District of Columbia",9,7,0,0,0,0,1,1,9,8,7,0,0,0,0,0,1,1,0,0,0,0,0,1,0,110010039001000,3,302,302,3,psa_42,3D1
1000000US110010039001001,"Block 1001, Block Group 1, Census Tract 39, District of Columbia, District of Columbia",643,439,98,2,50,1,30,23,643,569,401,96,2,50,1,4,15,74,38,2,0,0,0,26,8,110010039001001,3,303,303,3,psa_37,3D3
1000000US110010040011003,"Block 1003, Block Group 1, Census Tract 40.01, District of Columbia, District of Columbia",331,276,19,2,18,1,6,9,331,311,264,19,2,18,1,0,7,20,12,0,0,0,0,6,2,110010040011003,3,303,303,3,psa_37,3D3
1000000US110010040011004,"Block 1004, Block Group 1, Census Tract 40.01, District of Columbia, District of Columbia",64,53,7,0,2,0,0,2,64,59,48,7,0,2,0,0,2,5,5,0,0,0,0,0,0,110010040011004,3,303,303,3,psa_37,3D3
1000000US110010040013004,"Block 3004, Block Group 3, Census Tract 40.01, District of Columbia, District of Columbia",143,127,0,1,4,0,5,6,143,122,113,0,1,4,0,0,4,21,14,0,0,0,0,5,2,110010040013004,3,303,303,3,psa_37,3D3
1000000US110010040013005,"Block 3005, Block Group 3, Census Tract 40.01, District of Columbia, District of Columbia",23,22,0,1,0,0,0,0,23,22,21,0,1,0,0,0,0,1,1,0,0,0,0,0,0,110010040013005,3,303,303,3,psa_37,3D3
1000000US110010040013006,"Block 3006, Block Group 3, Census Tract 40.01, District of Columbia, District of Columbia",147,127,5,0,12,0,0,3,147,137,117,5,0,12,0,0,3,10,10,0,0,0,0,0,0,110010040013006,3,303,303,3,psa_37,3D3
1000000US110010040013007,"Block 3007, Block Group 3, Census Tract 40.01, District of Columbia, District of Columbia",293,250,19,0,9,0,4,11,293,256,224,19,0,9,0,0,4,37,26,0,0,0,0,4,7,110010040013007,3,303,303,3,psa_37,3D3
1000000US110010097002001,"Block 2001, Block Group 2, Census Tract 97, District of Columbia, District of Columbia",5,0,5,0,0,0,0,0,5,5,0,5,0,0,0,0,0,0,0,0,0,0,0,0,0,110010097002001,7,706,706,7,psa_2,7D3
1000000US110010097002002,"Block 2002, Block Group 2, Census Tract 97, District of Columbia, District of Columbia",253,3,245,0,1,0,1,3,253,251,2,245,0,1,0,0,3,2,1,0,0,0,0,1,0,110010097002002,7,706,706,7,psa_2,7D3
1000000US110010098041001,"Block 1001, Block Group 1, Census Tract 98.04, District of Columbia, District of Columbia",1166,31,1092,4,1,0,13,25,1166,1131,11,1091,4,1,0,3,21,35,20,1,0,0,0,10,4,110010098041001,7,705,705,7,psa_3,7D2
1000000US110010098041002,"Block 1002, Block Group 1, Census Tract 98.04, District of Columbia, District of Columbia",103,0,102,1,0,0,0,0,103,102,0,101,1,0,0,0,0,1,0,1,0,0,0,0,0,110010098041002,7,705,705,7,psa_3,7D2
1000000US110010098042004,"Block 2004, Block Group 2, Census Tract 98.04, District of Columbia, District of Columbia",80,0,79,0,0,0,0,1,80,79,0,78,0,0,0,0,1,1,0,1,0,0,0,0,0,110010098042004,7,705,705,7,psa_3,7D2
1000000US110010098042005,"Block 2005, Block Group 2, Census Tract 98.04, District of Columbia, District of Columbia",374,3,371,0,0,0,0,0,374,371,1,370,0,0,0,0,0,3,2,1,0,0,0,0,0,110010098042005,7,705,705,7,psa_3,7D2
1000000US110010098072009,"Block 2009, Block Group 2, Census Tract 98.07, District of Columbia, District of Columbia",247,2,240,0,0,0,1,4,247,247,2,240,0,0,0,1,4,0,0,0,0,0,0,0,0,110010098072009,7,708,708,7,psa_1,7D3
1000000US110010098072010,"Block 2010, Block Group 2, Census Tract 98.07, District of Columbia, District of Columbia",705,7,682,0,0,0,2,14,705,694,6,675,0,0,0,0,13,11,1,7,0,0,0,2,1,110010098072010,7,708,708,7,psa_1,7D3
1000000US110010098101000,"Block 1000, Block Group 1, Census Tract 98.10, District of Columbia, District of Columbia",1256,1,1232,1,0,0,5,17,1256,1246,1,1224,1,0,0,5,15,10,0,8,0,0,0,0,2,110010098101000,7,708,708,7,psa_1,7D3
1000000US110010098101001,"Block 1001, Block Group 1, Census Tract 98.10, District of Columbia, District of Columbia",156,0,155,0,0,0,0,1,156,156,0,155,0,0,0,0,1,0,0,0,0,0,0,0,0,110010098101001,7,708,708,7,psa_1,7D3
1000000US110010098111000,"Block 1000, Block Group 1, Census Tract 98.11, District of Columbia, District of Columbia",673,4,665,0,0,0,1,3,673,668,3,662,0,0,0,0,3,5,1,3,0,0,0,1,0,110010098111000,7,708,708,7,psa_1,7D3
1000000US110010098111003,"Block 1003, Block Group 1, Census Tract 98.11, District of Columbia, District of Columbia",737,0,704,3,1,0,6,23,737,731,0,699,3,1,0,6,22,6,0,5,0,0,0,0,1,110010098111003,7,708,708,7,psa_1,7D3
1000000US110010098112000,"Block 2000, Block Group 2, Census Tract 98.11, District of Columbia, District of Columbia",1189,1,1153,2,3,0,7,23,1189,1181,1,1151,2,3,0,6,18,8,0,2,0,0,0,1,5,110010098112000,7,706,706,7,psa_2,7D3
1000000US110010099012007,"Block 2007, Block Group 2, Census Tract 99.01, District of Columbia, District of Columbia",2,0,1,0,0,0,0,1,2,2,0,1,0,0,0,0,1,0,0,0,0,0,0,0,0,110010099012007,6,605,605,6,psa_11,6D2
1000000US110010099021012,"Block 1012, Block Group 1, Census Tract 99.02, District of Columbia, District of Columbia",180,2,178,0,0,0,0,0,180,174,1,173,0,0,0,0,0,6,1,5,0,0,0,0,0,110010099021012,6,605,605,6,psa_11,6D2
1000000US110010099021014,"Block 1014, Block Group 1, Census Tract 99.02, District of Columbia, District of Columbia",183,3,176,1,0,0,0,3,183,183,3,176,1,0,0,0,3,0,0,0,0,0,0,0,0,110010099021014,6,605,605,6,psa_11,6D2
1000000US110010099053006,"Block 3006, Block Group 3, Census Tract 99.05, District of Columbia, District of Columbia",195,1,185,1,0,0,3,5,195,188,1,182,1,0,0,0,4,7,0,3,0,0,0,3,1,110010099053006,6,604,604,6,psa_14,6D3
1000000US110010101001005,"Block 1005, Block Group 1, Census Tract 101, District of Columbia, District of Columbia",541,395,92,0,37,2,7,8,541,506,374,85,0,36,2,1,8,35,21,7,0,1,0,6,0,110010101001005,2,209,209,2,psa_57,2D3
1000000US110010101001006,"Block 1006, Block Group 1, Census Tract 101, District of Columbia, District of Columbia",4,4,0,0,0,0,0,0,4,4,4,0,0,0,0,0,0,0,0,0,0,0,0,0,0,110010101001006,2,209,209,2,psa_57,2D3
1000000US110010101001016,"Block 1016, Block Group 1, Census Tract 101, District of Columbia, District of Columbia",158,91,46,1,15,0,1,4,158,146,82,46,1,15,0,0,2,12,9,0,0,0,0,1,2,110010101001016,2,207,207,2,psa_24,2D3
1000000US110010101002006,"Block 2006, Block Group 2, Census Tract 101, District of Columbia, District of Columbia",1,1,0,0,0,0,0,0,1,1,1,0,0,0,0,0,0,0,0,0,0,0,0,0,0,110010101002006,2,207,207,2,psa_24,2D3
1000000US110010104001005,"Block 1005, Block Group 1, Census Tract 104, District of Columbia, District of Columbia",45,0,44,0,0,0,0,1,45,41,0,41,0,0,0,0,0,4,0,3,0,0,0,0,1,110010104001005,7,705,705,7,psa_3,7D2
1000000US110010104001006,"Block 1006, Block Group 1, Census Tract 104, District of Columbia, District of Columbia",56,0,56,0,0,0,0,0,56,56,0,56,0,0,0,0,0,0,0,0,0,0,0,0,0,110010104001006,7,707,707,7,psa_4,7D2
1000000US110010104001010,"Block 1010, Block Group 1, Census Tract 104, District of Columbia, District of Columbia",44,0,43,0,0,0,0,1,44,44,0,43,0,0,0,0,1,0,0,0,0,0,0,0,0,110010104001010,7,705,705,7,psa_3,7D2
1000000US110010104001012,"Block 1012, Block Group 1, Census Tract 104, District of Columbia, District of Columbia",226,3,222,0,0,0,0,1,226,226,3,222,0,0,0,0,1,0,0,0,0,0,0,0,0,110010104001012,7,707,707,7,psa_4,7D2
1000000US110010104001015,"Block 1015, Block Group 1, Census Tract 104, District of Columbia, District of Columbia",64,1,61,2,0,0,0,0,64,64,1,61,2,0,0,0,0,0,0,0,0,0,0,0,0,110010104001015,7,707,707,7,psa_4,7D2
1000000US110010104001016,"Block 1016, Block Group 1, Census Tract 104, District of Columbia, District of Columbia",160,2,154,0,0,0,0,4,160,159,2,153,0,0,0,0,4,1,0,1,0,0,0,0,0,110010104001016,7,707,707,7,psa_4,7D2
1000000US110010104001021,"Block 1021, Block Group 1, Census Tract 104, District of Columbia, District of Columbia",118,0,117,0,0,0,1,0,118,117,0,117,0,0,0,0,0,1,0,0,0,0,0,1,0,110010104001021,7,707,707,7,psa_4,7D2
1000000US110010104002013,"Block 2013, Block Group 2, Census Tract 104, District of Columbia, District of Columbia",10,0,10,0,0,0,0,0,10,10,0,10,0,0,0,0,0,0,0,0,0,0,0,0,0,110010104002013,7,707,707,7,psa_4,7D2
1000000US110010104002017,"Block 2017, Block Group 2, Census Tract 104, District of Columbia, District of Columbia",606,4,578,1,1,0,3,19,606,599,4,578,1,1,0,0,15,7,0,0,0,0,0,3,4,110010104002017,7,707,707,7,psa_4,7D2
1000000US110010106001000,"Block 1000, Block Group 1, Census Tract 106, District of Columbia, District of Columbia",11,2,1,0,1,0,7,0,11,4,2,1,0,1,0,0,0,7,0,0,0,0,0,7,0,110010106001000,5,501,501,5,psa_35,5D1
1000000US110010106002035,"Block 2035, Block Group 2, Census Tract 106, District of Columbia, District of Columbia",2,2,0,0,0,0,0,0,2,1,1,0,0,0,0,0,0,1,1,0,0,0,0,0,0,110010106002035,1,102,102,1,psa_18,1D1
1000000US110010106002042,"Block 2042, Block Group 2, Census Tract 106, District of Columbia, District of Columbia",20,14,4,0,2,0,0,0,20,20,14,4,0,2,0,0,0,0,0,0,0,0,0,0,0,110010106002042,5,501,501,5,psa_35,5D1
1000000US110010106003000,"Block 3000, Block Group 3, Census Tract 106, District of Columbia, District of Columbia",103,30,67,0,0,0,2,4,103,96,27,66,0,0,0,0,3,7,3,1,0,0,0,2,1,110010106003000,5,501,501,5,psa_35,5D1
1000000US110010106003001,"Block 3001, Block Group 3, Census Tract 106, District of Columbia, District of Columbia",2,0,2,0,0,0,0,0,2,2,0,2,0,0,0,0,0,0,0,0,0,0,0,0,0,110010106003001,5,501,501,5,psa_35,5D1
1000000US110010107002008,"Block 2008, Block Group 2, Census Tract 107, District of Columbia, District of Columbia",666,524,20,1,85,0,14,22,666,619,494,19,0,84,0,3,19,47,30,1,1,1,0,11,3,110010107002008,2,208,208,2,psa_33,2D3
1000000US110010107002019,"Block 2019, Block Group 2, Census Tract 107, District of Columbia, District of Columbia",7,6,1,0,0,0,0,0,7,7,6,1,0,0,0,0,0,0,0,0,0,0,0,0,0,110010107002019,2,208,208,2,psa_33,2D3
1000000US110010108003005,"Block 3005, Block Group 3, Census Tract 108.00, District of Columbia, District of Columbia",30,26,2,0,1,0,1,0,30,29,26,2,0,1,0,0,0,1,0,0,0,0,0,1,0,110010108003005,2,207,207,2,psa_24,2D3
1000000US110010108003006,"Block 3006, Block Group 3, Census Tract 108.00, District of Columbia, District of Columbia",144,116,7,0,17,0,2,2,144,134,109,7,0,16,0,0,2,10,7,0,0,1,0,2,0,110010108003006,2,207,207,2,psa_24,2D3
1000000US110010109001000,"Block 1000, Block Group 1, Census Tract 109, District of Columbia, District of Columbia",882,0,868,3,1,0,5,5,882,876,0,866,3,1,0,1,5,6,0,2,0,0,0,4,0,110010109001000,7,708,708,7,psa_1,7D3
1000000US110010109001001,"Block 1001, Block Group 1, Census Tract 109, District of Columbia, District of Columbia",277,4,258,0,0,0,0,15,277,269,4,250,0,0,0,0,15,8,0,8,0,0,0,0,0,110010109001001,7,708,708,7,psa_1,7D3
1000000US110010109002000,"Block 2000, Block Group 2, Census Tract 109, District of Columbia, District of Columbia",266,3,259,0,0,0,0,4,266,265,3,258,0,0,0,0,4,1,0,1,0,0,0,0,0,110010109002000,7,708,708,7,psa_1,7D3
1000000US110010109002008,"Block 2008, Block Group 2, Census Tract 109, District of Columbia, District of Columbia",1077,47,985,3,10,0,6,26,1077,1054,39,981,3,10,0,0,21,23,8,4,0,0,0,6,5,110010109002008,7,708,708,7,psa_1,7D3
1000000US110010110004002,"Block 4002, Block Group 4, Census Tract 110, District of Columbia, District of Columbia",947,322,518,11,35,0,17,44,947,896,301,512,6,35,0,5,37,51,21,6,5,0,0,12,7,110010110004002,1,105,105,1,psa_22,1D3
1000000US110010111001004,"Block 1004, Block Group 1, Census Tract 111, District of Columbia, District of Columbia",23,0,22,1,0,0,0,0,23,23,0,22,1,0,0,0,0,0,0,0,0,0,0,0,0,110010111001004,5,503,503,5,psa_45,5D2
1000000US110010111001005,"Block 1005, Block Group 1, Census Tract 111, District of Columbia, District of Columbia",61,0,61,0,0,0,0,0,61,61,0,61,0,0,0,0,0,0,0,0,0,0,0,0,0,110010111001005,5,503,503,5,psa_45,5D2
1000000US110010111001006,"Block 1006, Block Group 1, Census Tract 111, District of Columbia, District of Columbia",31,5,26,0,0,0,0,0,31,29,4,25,0,0,0,0,0,2,1,1,0,0,0,0,0,110010111001006,5,503,503,5,psa_45,5D2
1000000US110010111001010,"Block 1010, Block Group 1, Census Tract 111, District of Columbia, District of Columbia",86,8,69,2,0,0,6,1,86,80,8,69,2,0,0,0,1,6,0,0,0,0,0,6,0,110010111001010,5,503,503,5,psa_45,5D2
1000000US110010111001013,"Block 1013, Block Group 1, Census Tract 111, District of Columbia, District of Columbia",33,1,22,0,0,0,10,0,33,23,1,22,0,0,0,0,0,10,0,0,0,0,0,10,0,110010111001013,5,503,503,5,psa_45,5D2
1000000US110010111001014,"Block 1014, Block Group 1, Census Tract 111, District of Columbia, District of Columbia",10,0,10,0,0,0,0,0,10,10,0,10,0,0,0,0,0,0,0,0,0,0,0,0,0,110010111001014,5,503,503,5,psa_45,5D2
1000000US110010111001016,"Block 1016, Block Group 1, Census Tract 111, District of Columbia, District of Columbia",55,9,46,0,0,0,0,0,55,46,0,46,0,0,0,0,0,9,9,0,0,0,0,0,0,110010111001016,5,503,503,5,psa_45,5D2
1000000US110010111001021,"Block 1021, Block Group 1, Census Tract 111, District of Columbia, District of Columbia",20,8,12,0,0,0,0,0,20,12,0,12,0,0,0,0,0,8,8,0,0,0,0,0,0,110010111001021,5,503,503,5,psa_45,5D2
1000000US110010111001022,"Block 1022, Block Group 1, Census Tract 111, District of Columbia, District of Columbia",0,0,0,0,0,0,0,0,0,0,0,0,0,0,0,0,0,0,0,0,0,0,0,0,0,110010111001022,5,503,503,5,psa_45,5D2
1000000US110010111002007,"Block 2007, Block Group 2, Census Tract 111, District of Columbia, District of Columbia",90,10,80,0,0,0,0,0,90,90,10,80,0,0,0,0,0,0,0,0,0,0,0,0,0,110010111002007,5,503,503,5,psa_45,5D2
1000000US110010111002009,"Block 2009, Block Group 2, Census Tract 111, District of Columbia, District of Columbia",1,0,0,0,1,0,0,0,1,1,0,0,0,1,0,0,0,0,0,0,0,0,0,0,0,110010111002009,5,503,503,5,psa_45,5D2
1000000US110010111003004,"Block 3004, Block Group 3, Census Tract 111, District of Columbia, District of Columbia",40,2,35,0,0,0,0,3,40,40,2,35,0,0,0,0,3,0,0,0,0,0,0,0,0,110010111003004,5,503,503,5,psa_45,5D2
1000000US110010111003007,"Block 3007, Block Group 3, Census Tract 111, District of Columbia, District of Columbia",502,13,469,0,2,0,10,8,502,493,11,468,0,2,0,4,8,9,2,1,0,0,0,6,0,110010111003007,5,505,505,5,psa_34,5D2
1000000US110010111003009,"Block 3009, Block Group 3, Census Tract 111, District of Columbia, District of Columbia",3,2,1,0,0,0,0,0,3,3,2,1,0,0,0,0,0,0,0,0,0,0,0,0,0,110010111003009,5,505,505,5,psa_34,5D2
1000000US110010111003011,"Block 3011, Block Group 3, Census Tract 111, District of Columbia, District of Columbia",38,0,38,0,0,0,0,0,38,38,0,38,0,0,0,0,0,0,0,0,0,0,0,0,0,110010111003011,5,505,505,5,psa_34,5D2
1000000US110010111003032,"Block 3032, Block Group 3, Census Tract 111, District of Columbia, District of Columbia",37,0,37,0,0,0,0,0,37,37,0,37,0,0,0,0,0,0,0,0,0,0,0,0,0,110010111003032,5,503,503,5,psa_45,5D2
1000000US110010111003037,"Block 3037, Block Group 3, Census Tract 111, District of Columbia, District of Columbia",98,3,90,4,0,0,1,0,98,92,3,88,0,0,0,1,0,6,0,2,4,0,0,0,0,110010111003037,5,503,503,5,psa_45,5D2
1000000US110010023011003,"Block 1003, Block Group 1, Census Tract 23.01, District of Columbia, District of Columbia",81,8,73,0,0,0,0,0,81,81,8,73,0,0,0,0,0,0,0,0,0,0,0,0,0,110010023011003,4,407,407,4,psa_47,4D2
1000000US110010098042001,"Block 2001, Block Group 2, Census Tract 98.04, District of Columbia, District of Columbia",35,0,35,0,0,0,0,0,35,35,0,35,0,0,0,0,0,0,0,0,0,0,0,0,0,110010098042001,7,705,705,7,psa_3,7D2
1000000US110010062021022,"Block 1022, Block Group 1, Census Tract 62.02, District of Columbia, District of Columbia",3,0,3,0,0,0,0,0,3,3,0,3,0,0,0,0,0,0,0,0,0,0,0,0,0,110010062021022,1,102,102,1,psa_18,1D1
1000000US110010062021220,"Block 1220, Block Group 1, Census Tract 62.02, District of Columbia, District of Columbia",0,0,0,0,0,0,0,0,0,0,0,0,0,0,0,0,0,0,0,0,0,0,0,0,0,110010062021220,1,103,103,1,psa_12,1D1
1000000US110010007014006,"Block 4006, Block Group 4, Census Tract 7.01, District of Columbia, District of Columbia",66,64,0,0,2,0,0,0,66,66,64,0,0,2,0,0,0,0,0,0,0,0,0,0,0,110010007014006,2,204,204,2,psa_44,2D2
1000000US110010011004021,"Block 4021, Block Group 4, Census Tract 11, District of Columbia, District of Columbia",22,22,0,0,0,0,0,0,22,18,18,0,0,0,0,0,0,4,4,0,0,0,0,0,0,110010011004021,2,202,202,2,psa_52,2D1
1000000US110010084022008,"Block 2008, Block Group 2, Census Tract 84.02, District of Columbia, District of Columbia",55,25,29,0,1,0,0,0,55,54,24,29,0,1,0,0,0,1,1,0,0,0,0,0,0,110010084022008,1,104,104,1,psa_21,1D2
1000000US110010091021014,"Block 1014, Block Group 1, Census Tract 91.02, District of Columbia, District of Columbia",108,3,99,0,0,0,4,2,108,104,3,99,0,0,0,0,2,4,0,0,0,0,0,4,0,110010091021014,5,505,505,5,psa_34,5D2
1000000US110010073011135,"Block 1135, Block Group 1, Census Tract 73.01, District of Columbia, District of Columbia",44,12,20,0,0,0,10,2,44,32,10,20,0,0,0,0,2,12,2,0,0,0,0,10,0,110010073011135,7,707,707,7,psa_4,7D2
1000000US110010062021113,"Block 1113, Block Group 1, Census Tract 62.02, District of Columbia, District of Columbia",0,0,0,0,0,0,0,0,0,0,0,0,0,0,0,0,0,0,0,0,0,0,0,0,0,110010062021113,1,102,102,1,psa_18,1D1
1000000US110010103003010,"Block 3010, Block Group 3, Census Tract 103, District of Columbia, District of Columbia",111,11,74,0,0,0,26,0,111,85,11,74,0,0,0,0,0,26,0,0,0,0,0,26,0,110010103003010,4,401,401,4,psa_56,4D1
1000000US110010009012008,"Block 2008, Block Group 2, Census Tract 9.01, District of Columbia, District of Columbia",0,0,0,0,0,0,0,0,0,0,0,0,0,0,0,0,0,0,0,0,0,0,0,0,0,110010009012008,2,205,205,2,psa_46,2D2
1000000US110010016001018,"Block 1018, Block Group 1, Census Tract 16, District of Columbia, District of Columbia",27,11,14,0,0,0,0,2,27,27,11,14,0,0,0,0,2,0,0,0,0,0,0,0,0,110010016001018,4,401,401,4,psa_56,4D1
1000000US110010088042016,"Block 2016, Block Group 2, Census Tract 88.04, District of Columbia, District of Columbia",46,0,46,0,0,0,0,0,46,46,0,46,0,0,0,0,0,0,0,0,0,0,0,0,0,110010088042016,5,506,506,5,psa_26,5D3
1000000US110010065001007,"Block 1007, Block Group 1, Census Tract 65, District of Columbia, District of Columbia",121,102,3,1,7,0,0,8,121,115,99,3,0,7,0,0,6,6,3,0,1,0,0,0,2,110010065001007,1,106,106,1,psa_13,1D3
1000000US110010108003001,"Block 3001, Block Group 3, Census Tract 108.00, District of Columbia, District of Columbia",200,173,9,0,9,0,0,9,200,200,173,9,0,9,0,0,9,0,0,0,0,0,0,0,0,110010108003001,2,207,207,2,psa_24,2D3
1000000US110010071001019,"Block 1019, Block Group 1, Census Tract 71, District of Columbia, District of Columbia",0,0,0,0,0,0,0,0,0,0,0,0,0,0,0,0,0,0,0,0,0,0,0,0,0,110010071001019,1,106,106,1,psa_13,1D3
1000000US110010062021233,"Block 1233, Block Group 1, Census Tract 62.02, District of Columbia, District of Columbia",0,0,0,0,0,0,0,0,0,0,0,0,0,0,0,0,0,0,0,0,0,0,0,0,0,110010062021233,2,207,207,2,psa_24,2D3
1000000US110010102002012,"Block 2012, Block Group 2, Census Tract 102, District of Columbia, District of Columbia",0,0,0,0,0,0,0,0,0,0,0,0,0,0,0,0,0,0,0,0,0,0,0,0,0,110010102002012,1,103,103,1,psa_12,1D1
1000000US110010059001005,"Block 1005, Block Group 1, Census Tract 59, District of Columbia, District of Columbia",0,0,0,0,0,0,0,0,0,0,0,0,0,0,0,0,0,0,0,0,0,0,0,0,0,110010059001005,1,101,101,1,psa_20,1D1
1000000US110010001004019,"Block 4019, Block Group 4, Census Tract 1, District of Columbia, District of Columbia",0,0,0,0,0,0,0,0,0,0,0,0,0,0,0,0,0,0,0,0,0,0,0,0,0,110010001004019,2,206,206,2,psa_29,2D2
1000000US110010016001016,"Block 1016, Block Group 1, Census Tract 16, District of Columbia, District of Columbia",57,18,36,0,3,0,0,0,57,57,18,36,0,3,0,0,0,0,0,0,0,0,0,0,0,110010016001016,4,401,401,4,psa_56,4D1
1000000US110010016004028,"Block 4028, Block Group 4, Census Tract 16, District of Columbia, District of Columbia",35,25,10,0,0,0,0,0,35,35,25,10,0,0,0,0,0,0,0,0,0,0,0,0,0,110010016004028,4,401,401,4,psa_56,4D1
1000000US110010027023002,"Block 3002, Block Group 3, Census Tract 27.02, District of Columbia, District of Columbia",126,98,20,0,3,0,2,3,126,117,93,18,0,3,0,0,3,9,5,2,0,0,0,2,0,110010027023002,3,302,302,3,psa_42,3D1
1000000US110010102002019,"Block 2019, Block Group 2, Census Tract 102, District of Columbia, District of Columbia",0,0,0,0,0,0,0,0,0,0,0,0,0,0,0,0,0,0,0,0,0,0,0,0,0,110010102002019,1,103,103,1,psa_12,1D1
1000000US110010062021203,"Block 1203, Block Group 1, Census Tract 62.02, District of Columbia, District of Columbia",0,0,0,0,0,0,0,0,0,0,0,0,0,0,0,0,0,0,0,0,0,0,0,0,0,110010062021203,1,103,103,1,psa_12,1D1
1000000US110010062021231,"Block 1231, Block Group 1, Census Tract 62.02, District of Columbia, District of Columbia",0,0,0,0,0,0,0,0,0,0,0,0,0,0,0,0,0,0,0,0,0,0,0,0,0,110010062021231,2,207,207,2,psa_24,2D3
1000000US110010095013002,"Block 3002, Block Group 3, Census Tract 95.01, District of Columbia, District of Columbia",81,3,62,2,0,0,9,5,81,70,2,61,2,0,0,0,5,11,1,1,0,0,0,9,0,110010095013002,4,405,405,4,psa_49,4D2
1000000US110010088031021,"Block 1021, Block Group 1, Census Tract 88.03, District of Columbia, District of Columbia",0,0,0,0,0,0,0,0,0,0,0,0,0,0,0,0,0,0,0,0,0,0,0,0,0,110010088031021,5,501,501,5,psa_35,5D1
1000000US110010064002005,"Block 2005, Block Group 2, Census Tract 64, District of Columbia, District of Columbia",0,0,0,0,0,0,0,0,0,0,0,0,0,0,0,0,0,0,0,0,0,0,0,0,0,110010064002005,1,105,105,1,psa_22,1D3
1000000US110010078061005,"Block 1005, Block Group 1, Census Tract 78.06, District of Columbia, District of Columbia",48,0,47,0,0,0,0,1,48,48,0,47,0,0,0,0,1,0,0,0,0,0,0,0,0,110010078061005,6,602,602,6,psa_25,6D1
1000000US110010108002008,"Block 2008, Block Group 2, Census Tract 108.00, District of Columbia, District of Columbia",246,211,11,0,17,0,0,7,246,244,209,11,0,17,0,0,7,2,2,0,0,0,0,0,0,110010108002008,2,207,207,2,psa_24,2D3
1000000US110010073011126,"Block 1126, Block Group 1, Census Tract 73.01, District of Columbia, District of Columbia",0,0,0,0,0,0,0,0,0,0,0,0,0,0,0,0,0,0,0,0,0,0,0,0,0,110010073011126,7,703,703,7,psa_8,7D1
1000000US110010034002000,"Block 2000, Block Group 2, Census Tract 34, District of Columbia, District of Columbia",1191,6,1125,2,4,0,7,47,1191,1146,6,1086,2,4,0,4,44,45,0,39,0,0,0,3,3,110010034002000,3,306,306,3,psa_38,3D2
1000000US110010004001005,"Block 1005, Block Group 1, Census Tract 4, District of Columbia, District of Columbia",0,0,0,0,0,0,0,0,0,0,0,0,0,0,0,0,0,0,0,0,0,0,0,0,0,110010004001005,2,204,204,2,psa_44,2D2
1000000US110010005011013,"Block 1013, Block Group 1, Census Tract 5.01, District of Columbia, District of Columbia",0,0,0,0,0,0,0,0,0,0,0,0,0,0,0,0,0,0,0,0,0,0,0,0,0,110010005011013,2,204,204,2,psa_44,2D2
1000000US110010025012011,"Block 2011, Block Group 2, Census Tract 25.01, District of Columbia, District of Columbia",82,37,38,0,1,0,6,0,82,74,33,38,0,1,0,2,0,8,4,0,0,0,0,4,0,110010025012011,4,404,404,4,psa_48,4D3
1000000US110010079031014,"Block 1014, Block Group 1, Census Tract 79.03, District of Columbia, District of Columbia",56,6,50,0,0,0,0,0,56,56,6,50,0,0,0,0,0,0,0,0,0,0,0,0,0,110010079031014,5,507,507,5,psa_23,5D3
1000000US110010049021001,"Block 1001, Block Group 1, Census Tract 49.02, District of Columbia, District of Columbia",43,29,4,0,7,0,0,3,43,41,28,3,0,7,0,0,3,2,1,1,0,0,0,0,0,110010049021001,3,307,307,3,psa_28,3D3
1000000US110010095052012,"Block 2012, Block Group 2, Census Tract 95.05, District of Columbia, District of Columbia",66,3,63,0,0,0,0,0,66,63,3,60,0,0,0,0,0,3,0,3,0,0,0,0,0,110010095052012,4,406,406,4,psa_54,4D2
1000000US110010106002051,"Block 2051, Block Group 2, Census Tract 106, District of Columbia, District of Columbia",661,494,99,0,28,0,8,32,661,624,470,96,0,27,0,4,27,37,24,3,0,1,0,4,5,110010106002051,1,104,104,1,psa_21,1D2
1000000US110010017021028,"Block 1028, Block Group 1, Census Tract 17.02, District of Columbia, District of Columbia",48,20,27,0,1,0,0,0,48,48,20,27,0,1,0,0,0,0,0,0,0,0,0,0,0,110010017021028,4,401,401,4,psa_56,4D1
1000000US110010096031001,"Block 1001, Block Group 1, Census Tract 96.03, District of Columbia, District of Columbia",254,10,224,0,0,0,0,20,254,243,7,223,0,0,0,0,13,11,3,1,0,0,0,0,7,110010096031001,6,603,603,6,psa_15,6D3
1000000US110010105002025,"Block 2025, Block Group 2, Census Tract 105, District of Columbia, District of Columbia",0,0,0,0,0,0,0,0,0,0,0,0,0,0,0,0,0,0,0,0,0,0,0,0,0,110010105002025,1,103,103,1,psa_12,1D1
1000000US110010074011000,"Block 1000, Block Group 1, Census Tract 74.01, District of Columbia, District of Columbia",0,0,0,0,0,0,0,0,0,0,0,0,0,0,0,0,0,0,0,0,0,0,0,0,0,110010074011000,1,106,106,1,psa_13,1D3
1000000US110010095041005,"Block 1005, Block Group 1, Census Tract 95.04, District of Columbia, District of Columbia",253,74,166,0,3,0,4,6,253,248,72,166,0,3,0,1,6,5,2,0,0,0,0,3,0,110010095041005,4,405,405,4,psa_49,4D2
1000000US110010042022001,"Block 2001, Block Group 2, Census Tract 42.02, District of Columbia, District of Columbia",142,124,5,0,7,0,2,4,142,134,118,5,0,7,0,0,4,8,6,0,0,0,0,2,0,110010042022001,2,208,208,2,psa_33,2D3
1000000US110010078062022,"Block 2022, Block Group 2, Census Tract 78.06, District of Columbia, District of Columbia",0,0,0,0,0,0,0,0,0,0,0,0,0,0,0,0,0,0,0,0,0,0,0,0,0,110010078062022,6,602,602,6,psa_25,6D1
1000000US110010001004045,"Block 4045, Block Group 4, Census Tract 1, District of Columbia, District of Columbia",0,0,0,0,0,0,0,0,0,0,0,0,0,0,0,0,0,0,0,0,0,0,0,0,0,110010001004045,2,206,206,2,psa_29,2D2
1000000US110010026002022,"Block 2022, Block Group 2, Census Tract 26, District of Columbia, District of Columbia",40,4,26,0,2,0,0,8,40,34,3,23,0,2,0,0,6,6,1,3,0,0,0,0,2,110010026002022,4,404,404,4,psa_48,4D3
1000000US110010105002028,"Block 2028, Block Group 2, Census Tract 105, District of Columbia, District of Columbia",1005,575,273,7,97,1,16,36,1005,930,530,264,5,96,1,2,32,75,45,9,2,1,0,14,4,110010105002028,1,103,103,1,psa_12,1D1
1000000US110010008014006,"Block 4006, Block Group 4, Census Tract 8.01, District of Columbia, District of Columbia",0,0,0,0,0,0,0,0,0,0,0,0,0,0,0,0,0,0,0,0,0,0,0,0,0,110010008014006,2,205,205,2,psa_46,2D2
1000000US110010014011012,"Block 1012, Block Group 1, Census Tract 14.01, District of Columbia, District of Columbia",54,49,0,0,2,0,0,3,54,53,48,0,0,2,0,0,3,1,1,0,0,0,0,0,0,110010014011012,2,201,201,2,psa_55,2D1
1000000US110010056002004,"Block 2004, Block Group 2, Census Tract 56, District of Columbia, District of Columbia",0,0,0,0,0,0,0,0,0,0,0,0,0,0,0,0,0,0,0,0,0,0,0,0,0,110010056002004,2,207,207,2,psa_24,2D3
1000000US110010005022002,"Block 2002, Block Group 2, Census Tract 5.02, District of Columbia, District of Columbia",138,123,0,0,7,0,0,8,138,135,120,0,0,7,0,0,8,3,3,0,0,0,0,0,0,110010005022002,2,204,204,2,psa_44,2D2
1000000US110010073011104,"Block 1104, Block Group 1, Census Tract 73.01, District of Columbia, District of Columbia",0,0,0,0,0,0,0,0,0,0,0,0,0,0,0,0,0,0,0,0,0,0,0,0,0,110010073011104,7,708,708,7,psa_1,7D3
1000000US110010096041001,"Block 1001, Block Group 1, Census Tract 96.04, District of Columbia, District of Columbia",183,2,179,0,0,0,0,2,183,180,2,178,0,0,0,0,0,3,0,1,0,0,0,0,2,110010096041001,6,603,603,6,psa_15,6D3
1000000US110010038002006,"Block 2006, Block Group 2, Census Tract 38, District of Columbia, District of Columbia",0,0,0,0,0,0,0,0,0,0,0,0,0,0,0,0,0,0,0,0,0,0,0,0,0,110010038002006,3,303,303,3,psa_37,3D3
1000000US110010088023003,"Block 3003, Block Group 3, Census Tract 88.02, District of Columbia, District of Columbia",89,2,82,2,1,0,2,0,89,86,2,81,2,1,0,0,0,3,0,1,0,0,0,2,0,110010088023003,5,506,506,5,psa_26,5D3
1000000US110010088021004,"Block 1004, Block Group 1, Census Tract 88.02, District of Columbia, District of Columbia",117,4,109,3,0,0,0,1,117,109,2,106,0,0,0,0,1,8,2,3,3,0,0,0,0,110010088021004,5,506,506,5,psa_26,5D3
1000000US110010008013008,"Block 3008, Block Group 3, Census Tract 8.01, District of Columbia, District of Columbia",85,82,1,0,2,0,0,0,85,79,76,1,0,2,0,0,0,6,6,0,0,0,0,0,0,110010008013008,2,205,205,2,psa_46,2D2
1000000US110010009013015,"Block 3015, Block Group 3, Census Tract 9.01, District of Columbia, District of Columbia",46,37,3,0,5,0,0,1,46,46,37,3,0,5,0,0,1,0,0,0,0,0,0,0,0,110010009013015,2,205,205,2,psa_46,2D2
1000000US110010032002003,"Block 2003, Block Group 2, Census Tract 32, District of Columbia, District of Columbia",378,100,165,1,5,0,103,4,378,208,35,163,0,5,0,4,1,170,65,2,1,0,0,99,3,110010032002003,4,409,409,4,psa_41,4D3
1000000US110010108002018,"Block 2018, Block Group 2, Census Tract 108.00, District of Columbia, District of Columbia",0,0,0,0,0,0,0,0,0,0,0,0,0,0,0,0,0,0,0,0,0,0,0,0,0,110010108002018,2,207,207,2,psa_24,2D3
1000000US110010008021004,"Block 1004, Block Group 1, Census Tract 8.02, District of Columbia, District of Columbia",75,68,3,0,0,0,0,4,75,74,68,2,0,0,0,0,4,1,0,1,0,0,0,0,0,110010008021004,2,205,205,2,psa_46,2D2
1000000US110010099041002,"Block 1002, Block Group 1, Census Tract 99.04, District of Columbia, District of Columbia",119,6,113,0,0,0,0,0,119,112,0,112,0,0,0,0,0,7,6,1,0,0,0,0,0,110010099041002,6,604,604,6,psa_14,6D3
1000000US110010078072005,"Block 2005, Block Group 2, Census Tract 78.07, District of Columbia, District of Columbia",58,0,58,0,0,0,0,0,58,58,0,58,0,0,0,0,0,0,0,0,0,0,0,0,0,110010078072005,6,608,608,6,psa_19,6D1
1000000US110010094003010,"Block 3010, Block Group 3, Census Tract 94, District of Columbia, District of Columbia",53,1,48,0,0,0,0,4,53,50,1,47,0,0,0,0,2,3,0,1,0,0,0,0,2,110010094003010,5,503,503,5,psa_45,5D2
1000000US110010015002005,"Block 2005, Block Group 2, Census Tract 15, District of Columbia, District of Columbia",41,40,0,0,1,0,0,0,41,41,40,0,0,1,0,0,0,0,0,0,0,0,0,0,0,110010015002005,2,201,201,2,psa_55,2D1
1000000US110010087011005,"Block 1005, Block Group 1, Census Tract 87.01, District of Columbia, District of Columbia",13,1,12,0,0,0,0,0,13,13,1,12,0,0,0,0,0,0,0,0,0,0,0,0,0,110010087011005,5,502,502,5,psa_40,5D1
1000000US110010021021012,"Block 1012, Block Group 1, Census Tract 21.02, District of Columbia, District of Columbia",78,4,63,0,5,0,3,3,78,69,4,59,0,5,0,0,1,9,0,4,0,0,0,3,2,110010021021012,4,403,403,4,psa_51,4D1
1000000US110010027021006,"Block 1006, Block Group 1, Census Tract 27.02, District of Columbia, District of Columbia",118,83,4,3,6,0,13,9,118,86,73,4,3,6,0,0,0,32,10,0,0,0,0,13,9,110010027021006,3,302,302,3,psa_42,3D1
1000000US110010095042014,"Block 2014, Block Group 2, Census Tract 95.04, District of Columbia, District of Columbia",11,4,7,0,0,0,0,0,11,11,4,7,0,0,0,0,0,0,0,0,0,0,0,0,0,110010095042014,4,405,405,4,psa_49,4D2
1000000US110010095053019,"Block 3019, Block Group 3, Census Tract 95.05, District of Columbia, District of Columbia",32,4,28,0,0,0,0,0,32,32,4,28,0,0,0,0,0,0,0,0,0,0,0,0,0,110010095053019,4,406,406,4,psa_54,4D2
1000000US110010039002001,"Block 2001, Block Group 2, Census Tract 39, District of Columbia, District of Columbia",246,180,24,2,17,0,11,12,246,214,162,23,1,17,0,1,10,32,18,1,1,0,0,10,2,110010039002001,3,303,303,3,psa_37,3D3
1000000US110010002011002,"Block 1002, Block Group 1, Census Tract 2.01, District of Columbia, District of Columbia",0,0,0,0,0,0,0,0,0,0,0,0,0,0,0,0,0,0,0,0,0,0,0,0,0,110010002011002,2,205,205,2,psa_46,2D2
1000000US110010032003002,"Block 3002, Block Group 3, Census Tract 32, District of Columbia, District of Columbia",169,58,79,0,1,0,24,7,169,118,30,79,0,1,0,1,7,51,28,0,0,0,0,23,0,110010032003002,4,409,409,4,psa_41,4D3
1000000US110010035002008,"Block 2008, Block Group 2, Census Tract 35, District of Columbia, District of Columbia",4,0,4,0,0,0,0,0,4,4,0,4,0,0,0,0,0,0,0,0,0,0,0,0,0,110010035002008,3,305,305,3,psa_32,3D2
1000000US110010076012007,"Block 2007, Block Group 2, Census Tract 76.01, District of Columbia, District of Columbia",82,0,82,0,0,0,0,0,82,81,0,81,0,0,0,0,0,1,0,1,0,0,0,0,0,110010076012007,6,607,607,6,psa_10,6D2
1000000US110010078041012,"Block 1012, Block Group 1, Census Tract 78.04, District of Columbia, District of Columbia",0,0,0,0,0,0,0,0,0,0,0,0,0,0,0,0,0,0,0,0,0,0,0,0,0,110010078041012,6,602,602,6,psa_25,6D1
1000000US110010056002018,"Block 2018, Block Group 2, Census Tract 56, District of Columbia, District of Columbia",562,438,78,1,24,0,2,19,562,542,420,77,1,24,0,1,19,20,18,1,0,0,0,1,0,110010056002018,2,207,207,2,psa_24,2D3
1000000US110010109002032,"Block 2032, Block Group 2, Census Tract 109, District of Columbia, District of Columbia",0,0,0,0,0,0,0,0,0,0,0,0,0,0,0,0,0,0,0,0,0,0,0,0,0,110010109002032,7,708,708,7,psa_1,7D3
1000000US110010078032005,"Block 2005, Block Group 2, Census Tract 78.03, District of Columbia, District of Columbia",33,0,33,0,0,0,0,0,33,33,0,33,0,0,0,0,0,0,0,0,0,0,0,0,0,110010078032005,6,602,602,6,psa_25,6D1
1000000US110010015002011,"Block 2011, Block Group 2, Census Tract 15, District of Columbia, District of Columbia",91,84,2,0,0,0,2,3,91,91,84,2,0,0,0,2,3,0,0,0,0,0,0,0,0,110010015002011,2,201,201,2,psa_55,2D1
1000000US110010022011010,"Block 1010, Block Group 1, Census Tract 22.01, District of Columbia, District of Columbia",3,3,0,0,0,0,0,0,3,0,0,0,0,0,0,0,0,3,3,0,0,0,0,0,0,110010022011010,4,407,407,4,psa_47,4D2
1000000US110010064002026,"Block 2026, Block Group 2, Census Tract 64, District of Columbia, District of Columbia",0,0,0,0,0,0,0,0,0,0,0,0,0,0,0,0,0,0,0,0,0,0,0,0,0,110010064002026,1,105,105,1,psa_22,1D3
1000000US110010076042021,"Block 2021, Block Group 2, Census Tract 76.04, District of Columbia, District of Columbia",25,0,25,0,0,0,0,0,25,24,0,24,0,0,0,0,0,1,0,1,0,0,0,0,0,110010076042021,6,606,606,6,psa_7,6D2
1000000US110010089031017,"Block 1017, Block Group 1, Census Tract 89.03, District of Columbia, District of Columbia",0,0,0,0,0,0,0,0,0,0,0,0,0,0,0,0,0,0,0,0,0,0,0,0,0,110010089031017,5,507,507,5,psa_23,5D3
1000000US110010073011013,"Block 1013, Block Group 1, Census Tract 73.01, District of Columbia, District of Columbia",0,0,0,0,0,0,0,0,0,0,0,0,0,0,0,0,0,0,0,0,0,0,0,0,0,110010073011013,7,703,703,7,psa_8,7D1
1000000US110010078082010,"Block 2010, Block Group 2, Census Tract 78.08, District of Columbia, District of Columbia",78,5,72,1,0,0,0,0,78,76,4,72,0,0,0,0,0,2,1,0,1,0,0,0,0,110010078082010,6,608,608,6,psa_19,6D1
1000000US110010095041008,"Block 1008, Block Group 1, Census Tract 95.04, District of Columbia, District of Columbia",58,13,32,0,4,0,0,9,58,58,13,32,0,4,0,0,9,0,0,0,0,0,0,0,0,110010095041008,5,504,504,5,psa_43,5D2
1000000US110010104002012,"Block 2012, Block Group 2, Census Tract 104, District of Columbia, District of Columbia",0,0,0,0,0,0,0,0,0,0,0,0,0,0,0,0,0,0,0,0,0,0,0,0,0,110010104002012,7,703,703,7,psa_8,7D1
1000000US110010009011002,"Block 1002, Block Group 1, Census Tract 9.01, District of Columbia, District of Columbia",35,33,0,0,0,0,0,2,35,33,32,0,0,0,0,0,1,2,1,0,0,0,0,0,1,110010009011002,2,205,205,2,psa_46,2D2
1000000US110010096021025,"Block 1025, Block Group 1, Census Tract 96.02, District of Columbia, District of Columbia",0,0,0,0,0,0,0,0,0,0,0,0,0,0,0,0,0,0,0,0,0,0,0,0,0,110010096021025,6,601,601,6,psa_30,6D1
1000000US110010099061002,"Block 1002, Block Group 1, Census Tract 99.06, District of Columbia, District of Columbia",103,0,99,0,0,0,0,4,103,103,0,99,0,0,0,0,4,0,0,0,0,0,0,0,0,110010099061002,6,604,604,6,psa_14,6D3
1000000US110010056003004,"Block 3004, Block Group 3, Census Tract 56, District of Columbia, District of Columbia",0,0,0,0,0,0,0,0,0,0,0,0,0,0,0,0,0,0,0,0,0,0,0,0,0,110010056003004,2,207,207,2,psa_24,2D3
1000000US110010025024001,"Block 4001, Block Group 4, Census Tract 25.02, District of Columbia, District of Columbia",129,47,57,1,5,0,10,9,129,107,43,54,1,5,0,0,4,22,4,3,0,0,0,10,5,110010025024001,4,404,404,4,psa_48,4D3
1000000US110010059001021,"Block 1021, Block Group 1, Census Tract 59, District of Columbia, District of Columbia",0,0,0,0,0,0,0,0,0,0,0,0,0,0,0,0,0,0,0,0,0,0,0,0,0,110010059001021,1,102,102,1,psa_18,1D1
1000000US110010075031010,"Block 1010, Block Group 1, Census Tract 75.03, District of Columbia, District of Columbia",67,6,59,0,0,0,1,1,67,66,6,59,0,0,0,1,0,1,0,0,0,0,0,0,1,110010075031010,7,701,701,7,psa_9,7D1
1000000US110010076012010,"Block 2010, Block Group 2, Census Tract 76.01, District of Columbia, District of Columbia",54,1,52,0,0,0,0,1,54,53,0,52,0,0,0,0,1,1,1,0,0,0,0,0,0,110010076012010,6,607,607,6,psa_10,6D2
1000000US110010095032005,"Block 2005, Block Group 2, Census Tract 95.03, District of Columbia, District of Columbia",68,4,59,0,1,0,0,4,68,66,2,59,0,1,0,0,4,2,2,0,0,0,0,0,0,110010095032005,4,405,405,4,psa_49,4D2
1000000US110010099011006,"Block 1006, Block Group 1, Census Tract 99.01, District of Columbia, District of Columbia",22,0,21,0,1,0,0,0,22,22,0,21,0,1,0,0,0,0,0,0,0,0,0,0,0,110010099011006,6,605,605,6,psa_11,6D2
1000000US110010062021216,"Block 1216, Block Group 1, Census Tract 62.02, District of Columbia, District of Columbia",0,0,0,0,0,0,0,0,0,0,0,0,0,0,0,0,0,0,0,0,0,0,0,0,0,110010062021216,1,103,103,1,psa_12,1D1
1000000US110010001002007,"Block 2007, Block Group 2, Census Tract 1, District of Columbia, District of Columbia",46,44,0,1,1,0,0,0,46,45,43,0,1,1,0,0,0,1,1,0,0,0,0,0,0,110010001002007,2,206,206,2,psa_29,2D2
1000000US110010087011002,"Block 1002, Block Group 1, Census Tract 87.01, District of Columbia, District of Columbia",80,20,60,0,0,0,0,0,80,79,20,59,0,0,0,0,0,1,0,1,0,0,0,0,0,110010087011002,5,502,502,5,psa_40,5D1
1000000US110010046001000,"Block 1000, Block Group 1, Census Tract 46, District of Columbia, District of Columbia",204,51,138,0,4,0,4,7,204,194,50,136,0,4,0,0,4,10,1,2,0,0,0,4,3,110010046001000,3,308,308,3,psa_27,3D2
1000000US110010062021225,"Block 1225, Block Group 1, Census Tract 62.02, District of Columbia, District of Columbia",0,0,0,0,0,0,0,0,0,0,0,0,0,0,0,0,0,0,0,0,0,0,0,0,0,110010062021225,1,103,103,1,psa_12,1D1
1000000US110010074011006,"Block 1006, Block Group 1, Census Tract 74.01, District of Columbia, District of Columbia",0,0,0,0,0,0,0,0,0,0,0,0,0,0,0,0,0,0,0,0,0,0,0,0,0,110010074011006,7,701,701,7,psa_9,7D1
1000000US110010074072004,"Block 2004, Block Group 2, Census Tract 74.07, District of Columbia, District of Columbia",17,0,14,0,0,0,3,0,17,17,0,14,0,0,0,3,0,0,0,0,0,0,0,0,0,110010074072004,7,703,703,7,psa_8,7D1
1000000US110010026002027,"Block 2027, Block Group 2, Census Tract 26, District of Columbia, District of Columbia",44,28,15,0,1,0,0,0,44,42,26,15,0,1,0,0,0,2,2,0,0,0,0,0,0,110010026002027,4,404,404,4,psa_48,4D3
1000000US110010096011027,"Block 1027, Block Group 1, Census Tract 96.01, District of Columbia, District of Columbia",52,5,35,0,0,0,12,0,52,38,3,35,0,0,0,0,0,14,2,0,0,0,0,12,0,110010096011027,6,601,601,6,psa_30,6D1
1000000US110010034002003,"Block 2003, Block Group 2, Census Tract 34, District of Columbia, District of Columbia",0,0,0,0,0,0,0,0,0,0,0,0,0,0,0,0,0,0,0,0,0,0,0,0,0,110010034002003,3,306,306,3,psa_38,3D2
1000000US110010068041006,"Block 1006, Block Group 1, Census Tract 68.04, District of Columbia, District of Columbia",0,0,0,0,0,0,0,0,0,0,0,0,0,0,0,0,0,0,0,0,0,0,0,0,0,110010068041006,1,108,108,1,psa_17,1D2
1000000US110010076014007,"Block 4007, Block Group 4, Census Tract 76.01, District of Columbia, District of Columbia",68,2,66,0,0,0,0,0,68,68,2,66,0,0,0,0,0,0,0,0,0,0,0,0,0,110010076014007,6,607,607,6,psa_10,6D2
1000000US110010012003003,"Block 3003, Block Group 3, Census Tract 12, District of Columbia, District of Columbia",62,54,0,0,6,0,2,0,62,60,54,0,0,6,0,0,0,2,0,0,0,0,0,2,0,110010012003003,2,202,202,2,psa_52,2D1
1000000US110010012004020,"Block 4020, Block Group 4, Census Tract 12, District of Columbia, District of Columbia",95,86,0,0,3,0,5,1,95,88,84,0,0,3,0,0,1,7,2,0,0,0,0,5,0,110010012004020,2,202,202,2,psa_52,2D1
1000000US110010037001001,"Block 1001, Block Group 1, Census Tract 37, District of Columbia, District of Columbia",92,62,14,0,0,0,13,3,92,57,42,14,0,0,0,0,1,35,20,0,0,0,0,13,2,110010037001001,3,304,304,3,psa_36,3D1
1000000US110010084101012,"Block 1012, Block Group 1, Census Tract 84.10, District of Columbia, District of Columbia",112,27,81,0,1,0,0,3,112,110,25,81,0,1,0,0,3,2,2,0,0,0,0,0,0,110010084101012,1,104,104,1,psa_21,1D2
1000000US110010099061008,"Block 1008, Block Group 1, Census Tract 99.06, District of Columbia, District of Columbia",165,2,159,0,0,0,0,4,165,161,2,157,0,0,0,0,2,4,0,2,0,0,0,0,2,110010099061008,6,604,604,6,psa_14,6D3
1000000US110010096021023,"Block 1023, Block Group 1, Census Tract 96.02, District of Columbia, District of Columbia",0,0,0,0,0,0,0,0,0,0,0,0,0,0,0,0,0,0,0,0,0,0,0,0,0,110010096021023,6,601,601,6,psa_30,6D1
1000000US110010098041004,"Block 1004, Block Group 1, Census Tract 98.04, District of Columbia, District of Columbia",157,0,157,0,0,0,0,0,157,155,0,155,0,0,0,0,0,2,0,2,0,0,0,0,0,110010098041004,7,705,705,7,psa_3,7D2
1000000US110010099011009,"Block 1009, Block Group 1, Census Tract 99.01, District of Columbia, District of Columbia",99,1,84,3,1,0,0,10,99,99,1,84,3,1,0,0,10,0,0,0,0,0,0,0,0,110010099011009,6,605,605,6,psa_11,6D2
1000000US110010062021206,"Block 1206, Block Group 1, Census Tract 62.02, District of Columbia, District of Columbia",0,0,0,0,0,0,0,0,0,0,0,0,0,0,0,0,0,0,0,0,0,0,0,0,0,110010062021206,1,103,103,1,psa_12,1D1
1000000US110010015001001,"Block 1001, Block Group 1, Census Tract 15, District of Columbia, District of Columbia",0,0,0,0,0,0,0,0,0,0,0,0,0,0,0,0,0,0,0,0,0,0,0,0,0,110010015001001,2,201,201,2,psa_55,2D1
1000000US110010019012007,"Block 2007, Block Group 2, Census Tract 19.01, District of Columbia, District of Columbia",98,9,89,0,0,0,0,0,98,97,8,89,0,0,0,0,0,1,1,0,0,0,0,0,0,110010019012007,4,402,402,4,psa_53,4D1
1000000US110010025022002,"Block 2002, Block Group 2, Census Tract 25.02, District of Columbia, District of Columbia",64,17,40,0,2,0,0,5,64,59,14,39,0,2,0,0,4,5,3,1,0,0,0,0,1,110010025022002,4,404,404,4,psa_48,4D3
1000000US110010046002010,"Block 2010, Block Group 2, Census Tract 46, District of Columbia, District of Columbia",4,0,4,0,0,0,0,0,4,4,0,4,0,0,0,0,0,0,0,0,0,0,0,0,0,110010046002010,3,308,308,3,psa_27,3D2
1000000US110010076042005,"Block 2005, Block Group 2, Census Tract 76.04, District of Columbia, District of Columbia",27,0,27,0,0,0,0,0,27,27,0,27,0,0,0,0,0,0,0,0,0,0,0,0,0,110010076042005,6,607,607,6,psa_10,6D2
1000000US110010104001025,"Block 1025, Block Group 1, Census Tract 104, District of Columbia, District of Columbia",32,0,32,0,0,0,0,0,32,32,0,32,0,0,0,0,0,0,0,0,0,0,0,0,0,110010104001025,7,707,707,7,psa_4,7D2
1000000US110010107002014,"Block 2014, Block Group 2, Census Tract 107, District of Columbia, District of Columbia",0,0,0,0,0,0,0,0,0,0,0,0,0,0,0,0,0,0,0,0,0,0,0,0,0,110010107002014,2,208,208,2,psa_33,2D3
1000000US110010008021008,"Block 1008, Block Group 1, Census Tract 8.02, District of Columbia, District of Columbia",49,47,0,0,1,0,0,1,49,40,38,0,0,1,0,0,1,9,9,0,0,0,0,0,0,110010008021008,2,205,205,2,psa_46,2D2
1000000US110010046002000,"Block 2000, Block Group 2, Census Tract 46, District of Columbia, District of Columbia",391,14,363,1,5,0,1,7,391,381,8,363,1,5,0,0,4,10,6,0,0,0,0,1,3,110010046002000,3,308,308,3,psa_27,3D2
1000000US110010087012002,"Block 2002, Block Group 2, Census Tract 87.01, District of Columbia, District of Columbia",155,10,145,0,0,0,0,0,155,154,10,144,0,0,0,0,0,1,0,1,0,0,0,0,0,110010087012002,5,502,502,5,psa_40,5D1
1000000US110010102002041,"Block 2041, Block Group 2, Census Tract 102, District of Columbia, District of Columbia",0,0,0,0,0,0,0,0,0,0,0,0,0,0,0,0,0,0,0,0,0,0,0,0,0,110010102002041,1,105,105,1,psa_22,1D3
1000000US110010008013009,"Block 3009, Block Group 3, Census Tract 8.01, District of Columbia, District of Columbia",81,66,1,0,2,0,4,8,81,73,61,1,0,2,0,1,8,8,5,0,0,0,0,3,0,110010008013009,2,205,205,2,psa_46,2D2
1000000US110010072001014,"Block 1014, Block Group 1, Census Tract 72, District of Columbia, District of Columbia",0,0,0,0,0,0,0,0,0,0,0,0,0,0,0,0,0,0,0,0,0,0,0,0,0,110010072001014,1,106,106,1,psa_13,1D3
1000000US110010034002022,"Block 2022, Block Group 2, Census Tract 34, District of Columbia, District of Columbia",132,61,40,0,7,0,1,23,132,127,57,40,0,7,0,1,22,5,4,0,0,0,0,0,1,110010034002022,3,306,306,3,psa_38,3D2
1000000US110010003001011,"Block 1011, Block Group 1, Census Tract 3, District of Columbia, District of Columbia",0,0,0,0,0,0,0,0,0,0,0,0,0,0,0,0,0,0,0,0,0,0,0,0,0,110010003001011,2,206,206,2,psa_29,2D2
1000000US110010094004000,"Block 4000, Block Group 4, Census Tract 94, District of Columbia, District of Columbia",11,0,8,1,0,0,2,0,11,9,0,8,1,0,0,0,0,2,0,0,0,0,0,2,0,110010094004000,5,503,503,5,psa_45,5D2
1000000US110010101001024,"Block 1024, Block Group 1, Census Tract 101, District of Columbia, District of Columbia",0,0,0,0,0,0,0,0,0,0,0,0,0,0,0,0,0,0,0,0,0,0,0,0,0,110010101001024,2,209,209,2,psa_57,2D3
1000000US110010040013002,"Block 3002, Block Group 3, Census Tract 40.01, District of Columbia, District of Columbia",0,0,0,0,0,0,0,0,0,0,0,0,0,0,0,0,0,0,0,0,0,0,0,0,0,110010040013002,3,303,303,3,psa_37,3D3
1000000US110010064002002,"Block 2002, Block Group 2, Census Tract 64, District of Columbia, District of Columbia",202,0,198,1,3,0,0,0,202,202,0,198,1,3,0,0,0,0,0,0,0,0,0,0,0,110010064002002,1,105,105,1,psa_22,1D3
1000000US110010044002001,"Block 2001, Block Group 2, Census Tract 44, District of Columbia, District of Columbia",67,32,14,0,0,0,20,1,67,42,27,13,0,0,0,1,1,25,5,1,0,0,0,19,0,110010044002001,3,305,305,3,psa_32,3D2
1000000US110010015002001,"Block 2001, Block Group 2, Census Tract 15, District of Columbia, District of Columbia",2,2,0,0,0,0,0,0,2,2,2,0,0,0,0,0,0,0,0,0,0,0,0,0,0,110010015002001,2,201,201,2,psa_55,2D1
1000000US110010041003003,"Block 3003, Block Group 3, Census Tract 41, District of Columbia, District of Columbia",155,129,13,0,11,0,0,2,155,148,123,13,0,11,0,0,1,7,6,0,0,0,0,0,1,110010041003003,2,208,208,2,psa_33,2D3
1000000US110010048011004,"Block 1004, Block Group 1, Census Tract 48.01, District of Columbia, District of Columbia",0,0,0,0,0,0,0,0,0,0,0,0,0,0,0,0,0,0,0,0,0,0,0,0,0,110010048011004,3,306,306,3,psa_38,3D2
1000000US110010062021100,"Block 1100, Block Group 1, Census Tract 62.02, District of Columbia, District of Columbia",0,0,0,0,0,0,0,0,0,0,0,0,0,0,0,0,0,0,0,0,0,0,0,0,0,110010062021100,2,207,207,2,psa_24,2D3
1000000US110010002024015,"Block 4015, Block Group 4, Census Tract 2.02, District of Columbia, District of Columbia",0,0,0,0,0,0,0,0,0,0,0,0,0,0,0,0,0,0,0,0,0,0,0,0,0,110010002024015,2,206,206,2,psa_29,2D2
1000000US110010041002002,"Block 2002, Block Group 2, Census Tract 41, District of Columbia, District of Columbia",30,27,0,0,3,0,0,0,30,29,26,0,0,3,0,0,0,1,1,0,0,0,0,0,0,110010041002002,2,208,208,2,psa_33,2D3
1000000US110010080022007,"Block 2007, Block Group 2, Census Tract 80.02, District of Columbia, District of Columbia",132,92,32,0,1,0,2,5,132,131,91,32,0,1,0,2,5,1,1,0,0,0,0,0,0,110010080022007,1,108,108,1,psa_17,1D2
1000000US110010006001005,"Block 1005, Block Group 1, Census Tract 6, District of Columbia, District of Columbia",63,57,3,0,1,0,1,1,63,62,57,3,0,1,0,0,1,1,0,0,0,0,0,1,0,110010006001005,2,203,203,2,psa_50,2D1
1000000US110010003002005,"Block 2005, Block Group 2, Census Tract 3, District of Columbia, District of Columbia",132,113,6,0,5,0,3,5,132,123,107,6,0,5,0,0,5,9,6,0,0,0,0,3,0,110010003002005,2,204,204,2,psa_44,2D2
1000000US110010076014002,"Block 4002, Block Group 4, Census Tract 76.01, District of Columbia, District of Columbia",221,1,220,0,0,0,0,0,221,221,1,220,0,0,0,0,0,0,0,0,0,0,0,0,0,110010076014002,6,607,607,6,psa_10,6D2
1000000US110010077072008,"Block 2008, Block Group 2, Census Tract 77.07, District of Columbia, District of Columbia",57,0,57,0,0,0,0,0,57,57,0,57,0,0,0,0,0,0,0,0,0,0,0,0,0,110010077072008,6,605,605,6,psa_11,6D2
1000000US110010062021191,"Block 1191, Block Group 1, Census Tract 62.02, District of Columbia, District of Columbia",0,0,0,0,0,0,0,0,0,0,0,0,0,0,0,0,0,0,0,0,0,0,0,0,0,110010062021191,1,103,103,1,psa_12,1D1
1000000US110010069001008,"Block 1008, Block Group 1, Census Tract 69, District of Columbia, District of Columbia",11,11,0,0,0,0,0,0,11,11,11,0,0,0,0,0,0,0,0,0,0,0,0,0,0,110010069001008,1,107,107,1,psa_16,1D2
1000000US110010010016011,"Block 6011, Block Group 6, Census Tract 10.01, District of Columbia, District of Columbia",57,51,1,0,1,0,0,4,57,56,51,1,0,1,0,0,3,1,0,0,0,0,0,0,1,110010010016011,2,202,202,2,psa_52,2D1
1000000US110010016004026,"Block 4026, Block Group 4, Census Tract 16, District of Columbia, District of Columbia",33,13,17,0,3,0,0,0,33,33,13,17,0,3,0,0,0,0,0,0,0,0,0,0,0,110010016004026,4,401,401,4,psa_56,4D1
1000000US110010075031016,"Block 1016, Block Group 1, Census Tract 75.03, District of Columbia, District of Columbia",50,1,43,0,0,0,5,1,50,45,1,43,0,0,0,0,1,5,0,0,0,0,0,5,0,110010075031016,7,701,701,7,psa_9,7D1
1000000US110010080022000,"Block 2000, Block Group 2, Census Tract 80.02, District of Columbia, District of Columbia",0,0,0,0,0,0,0,0,0,0,0,0,0,0,0,0,0,0,0,0,0,0,0,0,0,110010080022000,1,108,108,1,psa_17,1D2
1000000US110010050023005,"Block 3005, Block Group 3, Census Tract 50.02, District of Columbia, District of Columbia",212,104,50,3,10,0,41,4,212,150,90,47,0,10,0,1,2,62,14,3,3,0,0,40,2,110010050023005,3,307,307,3,psa_28,3D3
1000000US110010088031025,"Block 1025, Block Group 1, Census Tract 88.03, District of Columbia, District of Columbia",0,0,0,0,0,0,0,0,0,0,0,0,0,0,0,0,0,0,0,0,0,0,0,0,0,110010088031025,5,501,501,5,psa_35,5D1
1000000US110010094003006,"Block 3006, Block Group 3, Census Tract 94, District of Columbia, District of Columbia",27,2,22,0,1,0,0,2,27,27,2,22,0,1,0,0,2,0,0,0,0,0,0,0,0,110010094003006,5,503,503,5,psa_45,5D2
1000000US110010108002020,"Block 2020, Block Group 2, Census Tract 108.00, District of Columbia, District of Columbia",0,0,0,0,0,0,0,0,0,0,0,0,0,0,0,0,0,0,0,0,0,0,0,0,0,110010108002020,2,207,207,2,psa_24,2D3
1000000US110010022021008,"Block 1008, Block Group 1, Census Tract 22.02, District of Columbia, District of Columbia",143,24,104,2,0,0,5,8,143,133,19,103,2,0,0,2,7,10,5,1,0,0,0,3,1,110010022021008,4,407,407,4,psa_47,4D2
1000000US110010095053013,"Block 3013, Block Group 3, Census Tract 95.05, District of Columbia, District of Columbia",0,0,0,0,0,0,0,0,0,0,0,0,0,0,0,0,0,0,0,0,0,0,0,0,0,110010095053013,4,406,406,4,psa_54,4D2
1000000US110010098032000,"Block 2000, Block Group 2, Census Tract 98.03, District of Columbia, District of Columbia",0,0,0,0,0,0,0,0,0,0,0,0,0,0,0,0,0,0,0,0,0,0,0,0,0,110010098032000,7,707,707,7,psa_4,7D2
1000000US110010020021019,"Block 1019, Block Group 1, Census Tract 20.02, District of Columbia, District of Columbia",102,6,73,0,4,2,15,2,102,81,4,70,0,4,2,0,1,21,2,3,0,0,0,15,1,110010020021019,4,404,404,4,psa_48,4D3
1000000US110010044001001,"Block 1001, Block Group 1, Census Tract 44, District of Columbia, District of Columbia",0,0,0,0,0,0,0,0,0,0,0,0,0,0,0,0,0,0,0,0,0,0,0,0,0,110010044001001,3,305,305,3,psa_32,3D2
1000000US110010035001002,"Block 1002, Block Group 1, Census Tract 35, District of Columbia, District of Columbia",248,24,161,2,5,0,45,11,248,193,19,161,1,5,0,0,7,55,5,0,1,0,0,45,4,110010035001002,3,304,304,3,psa_36,3D1
1000000US110010099072001,"Block 2001, Block Group 2, Census Tract 99.07, District of Columbia, District of Columbia",54,3,51,0,0,0,0,0,54,54,3,51,0,0,0,0,0,0,0,0,0,0,0,0,0,110010099072001,6,605,605,6,psa_11,6D2
1000000US110010016002001,"Block 2001, Block Group 2, Census Tract 16, District of Columbia, District of Columbia",42,17,23,0,0,0,0,2,42,42,17,23,0,0,0,0,2,0,0,0,0,0,0,0,0,110010016002001,4,401,401,4,psa_56,4D1
1000000US110010084101017,"Block 1017, Block Group 1, Census Tract 84.10, District of Columbia, District of Columbia",55,15,37,0,3,0,0,0,55,51,15,35,0,1,0,0,0,4,0,2,0,2,0,0,0,110010084101017,1,104,104,1,psa_21,1D2
1000000US110010062021164,"Block 1164, Block Group 1, Census Tract 62.02, District of Columbia, District of Columbia",0,0,0,0,0,0,0,0,0,0,0,0,0,0,0,0,0,0,0,0,0,0,0,0,0,110010062021164,1,106,106,1,psa_13,1D3
1000000US110010099032005,"Block 2005, Block Group 2, Census Tract 99.03, District of Columbia, District of Columbia",107,0,105,0,0,0,0,2,107,107,0,105,0,0,0,0,2,0,0,0,0,0,0,0,0,110010099032005,6,604,604,6,psa_14,6D3
1000000US110010098021001,"Block 1001, Block Group 1, Census Tract 98.02, District of Columbia, District of Columbia",461,0,461,0,0,0,0,0,461,455,0,455,0,0,0,0,0,6,0,6,0,0,0,0,0,110010098021001,7,706,706,7,psa_2,7D3
1000000US110010003001005,"Block 1005, Block Group 1, Census Tract 3, District of Columbia, District of Columbia",96,82,4,0,7,0,0,3,96,91,77,4,0,7,0,0,3,5,5,0,0,0,0,0,0,110010003001005,2,206,206,2,psa_29,2D2
1000000US110010058002012,"Block 2012, Block Group 2, Census Tract 58, District of Columbia, District of Columbia",0,0,0,0,0,0,0,0,0,0,0,0,0,0,0,0,0,0,0,0,0,0,0,0,0,110010058002012,1,102,102,1,psa_18,1D1
1000000US110010072002039,"Block 2039, Block Group 2, Census Tract 72, District of Columbia, District of Columbia",0,0,0,0,0,0,0,0,0,0,0,0,0,0,0,0,0,0,0,0,0,0,0,0,0,110010072002039,1,106,106,1,psa_13,1D3
1000000US110010020011007,"Block 1007, Block Group 1, Census Tract 20.01, District of Columbia, District of Columbia",192,32,110,0,0,0,36,14,192,121,11,103,0,0,0,0,7,71,21,7,0,0,0,36,7,110010020011007,4,403,403,4,psa_51,4D1
1000000US110010049011004,"Block 1004, Block Group 1, Census Tract 49.01, District of Columbia, District of Columbia",154,81,52,0,7,1,6,7,154,146,75,52,0,7,1,6,5,8,6,0,0,0,0,0,2,110010049011004,3,307,307,3,psa_28,3D3
1000000US110010095092001,"Block 2001, Block Group 2, Census Tract 95.09, District of Columbia, District of Columbia",68,0,63,0,4,0,0,1,68,67,0,62,0,4,0,0,1,1,0,1,0,0,0,0,0,110010095092001,4,405,405,4,psa_49,4D2
1000000US110010070001002,"Block 1002, Block Group 1, Census Tract 70, District of Columbia, District of Columbia",72,68,0,0,2,0,2,0,72,72,68,0,0,2,0,2,0,0,0,0,0,0,0,0,0,110010070001002,1,106,106,1,psa_13,1D3
1000000US110010014022003,"Block 2003, Block Group 2, Census Tract 14.02, District of Columbia, District of Columbia",75,74,0,0,0,0,0,1,75,72,72,0,0,0,0,0,0,3,2,0,0,0,0,0,1,110010014022003,2,201,201,2,psa_55,2D1
1000000US110010099011013,"Block 1013, Block Group 1, Census Tract 99.01, District of Columbia, District of Columbia",21,0,21,0,0,0,0,0,21,21,0,21,0,0,0,0,0,0,0,0,0,0,0,0,0,110010099011013,6,605,605,6,psa_11,6D2
1000000US110010059001017,"Block 1017, Block Group 1, Census Tract 59, District of Columbia, District of Columbia",94,3,85,0,3,0,1,2,94,91,3,84,0,1,0,1,2,3,0,1,0,2,0,0,0,110010059001017,1,102,102,1,psa_18,1D1
1000000US110010016004038,"Block 4038, Block Group 4, Census Tract 16, District of Columbia, District of Columbia",0,0,0,0,0,0,0,0,0,0,0,0,0,0,0,0,0,0,0,0,0,0,0,0,0,110010016004038,4,401,401,4,psa_56,4D1
1000000US110010024004007,"Block 4007, Block Group 4, Census Tract 24, District of Columbia, District of Columbia",186,39,130,0,2,0,9,6,186,164,34,123,0,2,0,0,5,22,5,7,0,0,0,9,1,110010024004007,4,407,407,4,psa_47,4D2
1000000US110010071001018,"Block 1018, Block Group 1, Census Tract 71, District of Columbia, District of Columbia",0,0,0,0,0,0,0,0,0,0,0,0,0,0,0,0,0,0,0,0,0,0,0,0,0,110010071001018,1,106,106,1,psa_13,1D3
1000000US110010021021015,"Block 1015, Block Group 1, Census Tract 21.02, District of Columbia, District of Columbia",36,2,33,1,0,0,0,0,36,35,2,33,0,0,0,0,0,1,0,0,1,0,0,0,0,110010021021015,4,402,402,4,psa_53,4D1
1000000US110010017021009,"Block 1009, Block Group 1, Census Tract 17.02, District of Columbia, District of Columbia",0,0,0,0,0,0,0,0,0,0,0,0,0,0,0,0,0,0,0,0,0,0,0,0,0,110010017021009,4,401,401,4,psa_56,4D1
1000000US110010065002000,"Block 2000, Block Group 2, Census Tract 65, District of Columbia, District of Columbia",74,64,0,0,4,0,0,6,74,72,62,0,0,4,0,0,6,2,2,0,0,0,0,0,0,110010065002000,1,107,107,1,psa_16,1D2
1000000US110010058001013,"Block 1013, Block Group 1, Census Tract 58, District of Columbia, District of Columbia",0,0,0,0,0,0,0,0,0,0,0,0,0,0,0,0,0,0,0,0,0,0,0,0,0,110010058001013,2,209,209,2,psa_57,2D3
1000000US110010070001016,"Block 1016, Block Group 1, Census Tract 70, District of Columbia, District of Columbia",0,0,0,0,0,0,0,0,0,0,0,0,0,0,0,0,0,0,0,0,0,0,0,0,0,110010070001016,1,106,106,1,psa_13,1D3
1000000US110010012004004,"Block 4004, Block Group 4, Census Tract 12, District of Columbia, District of Columbia",47,42,0,0,2,0,1,2,47,46,41,0,0,2,0,1,2,1,1,0,0,0,0,0,0,110010012004004,2,202,202,2,psa_52,2D1
1000000US110010062021090,"Block 1090, Block Group 1, Census Tract 62.02, District of Columbia, District of Columbia",0,0,0,0,0,0,0,0,0,0,0,0,0,0,0,0,0,0,0,0,0,0,0,0,0,110010062021090,2,207,207,2,psa_24,2D3
1000000US110010010012024,"Block 2024, Block Group 2, Census Tract 10.01, District of Columbia, District of Columbia",72,64,0,0,3,0,0,5,72,70,62,0,0,3,0,0,5,2,2,0,0,0,0,0,0,110010010012024,2,202,202,2,psa_52,2D1
1000000US110010048021004,"Block 1004, Block Group 1, Census Tract 48.02, District of Columbia, District of Columbia",0,0,0,0,0,0,0,0,0,0,0,0,0,0,0,0,0,0,0,0,0,0,0,0,0,110010048021004,3,308,308,3,psa_27,3D2
1000000US110010021013005,"Block 3005, Block Group 3, Census Tract 21.01, District of Columbia, District of Columbia",193,37,126,0,0,0,27,3,193,134,9,122,0,0,0,3,0,59,28,4,0,0,0,24,3,110010021013005,4,403,403,4,psa_51,4D1
1000000US110010021014002,"Block 4002, Block Group 4, Census Tract 21.01, District of Columbia, District of Columbia",106,12,75,0,2,0,17,0,106,84,7,75,0,2,0,0,0,22,5,0,0,0,0,17,0,110010021014002,4,403,403,4,psa_51,4D1
1000000US110010005021007,"Block 1007, Block Group 1, Census Tract 5.02, District of Columbia, District of Columbia",69,69,0,0,0,0,0,0,69,67,67,0,0,0,0,0,0,2,2,0,0,0,0,0,0,110010005021007,2,204,204,2,psa_44,2D2
1000000US110010078043014,"Block 3014, Block Group 3, Census Tract 78.04, District of Columbia, District of Columbia",113,0,111,0,0,0,0,2,113,113,0,111,0,0,0,0,2,0,0,0,0,0,0,0,0,110010078043014,6,608,608,6,psa_19,6D1
1000000US110010017022007,"Block 2007, Block Group 2, Census Tract 17.02, District of Columbia, District of Columbia",66,22,43,0,0,0,1,0,66,66,22,43,0,0,0,1,0,0,0,0,0,0,0,0,0,110010017022007,4,401,401,4,psa_56,4D1
1000000US110010055001016,"Block 1016, Block Group 1, Census Tract 55, District of Columbia, District of Columbia",377,274,26,10,37,0,11,19,377,336,248,24,7,37,0,4,16,41,26,2,3,0,0,7,3,110010055001016,2,208,208,2,psa_33,2D3
1000000US110010073011018,"Block 1018, Block Group 1, Census Tract 73.01, District of Columbia, District of Columbia",110,62,22,0,3,0,8,15,110,89,54,17,0,3,0,0,15,21,8,5,0,0,0,8,0,110010073011018,7,707,707,7,psa_4,7D2
1000000US110010069001009,"Block 1009, Block Group 1, Census Tract 69, District of Columbia, District of Columbia",80,73,5,0,2,0,0,0,80,78,71,5,0,2,0,0,0,2,2,0,0,0,0,0,0,110010069001009,1,107,107,1,psa_16,1D2
1000000US110010074011031,"Block 1031, Block Group 1, Census Tract 74.01, District of Columbia, District of Columbia",0,0,0,0,0,0,0,0,0,0,0,0,0,0,0,0,0,0,0,0,0,0,0,0,0,110010074011031,7,703,703,7,psa_8,7D1
1000000US110010098033002,"Block 3002, Block Group 3, Census Tract 98.03, District of Columbia, District of Columbia",229,4,224,0,0,0,0,1,229,225,4,220,0,0,0,0,1,4,0,4,0,0,0,0,0,110010098033002,7,707,707,7,psa_4,7D2
1000000US110010064002019,"Block 2019, Block Group 2, Census Tract 64, District of Columbia, District of Columbia",0,0,0,0,0,0,0,0,0,0,0,0,0,0,0,0,0,0,0,0,0,0,0,0,0,110010064002019,1,105,105,1,psa_22,1D3
1000000US110010096041003,"Block 1003, Block Group 1, Census Tract 96.04, District of Columbia, District of Columbia",133,4,122,0,0,0,1,6,133,129,2,122,0,0,0,0,5,4,2,0,0,0,0,1,1,110010096041003,6,603,603,6,psa_15,6D3
1000000US110010022021004,"Block 1004, Block Group 1, Census Tract 22.02, District of Columbia, District of Columbia",121,8,88,4,0,0,20,1,121,94,6,86,1,0,0,0,1,27,2,2,3,0,0,20,0,110010022021004,4,407,407,4,psa_47,4D2
1000000US110010099012016,"Block 2016, Block Group 2, Census Tract 99.01, District of Columbia, District of Columbia",46,2,43,0,0,0,1,0,46,45,2,43,0,0,0,0,0,1,0,0,0,0,0,1,0,110010099012016,6,605,605,6,psa_11,6D2
1000000US110010077081002,"Block 1002, Block Group 1, Census Tract 77.08, District of Columbia, District of Columbia",227,0,217,0,0,0,0,10,227,226,0,217,0,0,0,0,9,1,0,0,0,0,0,0,1,110010077081002,6,603,603,6,psa_15,6D3
1000000US110010096011002,"Block 1002, Block Group 1, Census Tract 96.01, District of Columbia, District of Columbia",0,0,0,0,0,0,0,0,0,0,0,0,0,0,0,0,0,0,0,0,0,0,0,0,0,110010096011002,6,601,601,6,psa_30,6D1
1000000US110010009013018,"Block 3018, Block Group 3, Census Tract 9.01, District of Columbia, District of Columbia",59,42,0,0,6,0,1,10,59,55,38,0,0,6,0,1,10,4,4,0,0,0,0,0,0,110010009013018,2,205,205,2,psa_46,2D2
1000000US110010062021068,"Block 1068, Block Group 1, Census Tract 62.02, District of Columbia, District of Columbia",0,0,0,0,0,0,0,0,0,0,0,0,0,0,0,0,0,0,0,0,0,0,0,0,0,110010062021068,2,207,207,2,psa_24,2D3
1000000US110010089042007,"Block 2007, Block Group 2, Census Tract 89.04, District of Columbia, District of Columbia",193,3,190,0,0,0,0,0,193,192,3,189,0,0,0,0,0,1,0,1,0,0,0,0,0,110010089042007,5,507,507,5,psa_23,5D3
1000000US110010009022023,"Block 2023, Block Group 2, Census Tract 9.02, District of Columbia, District of Columbia",183,164,3,0,6,0,4,6,183,177,162,3,0,6,0,1,5,6,2,0,0,0,0,3,1,110010009022023,2,205,205,2,psa_46,2D2
1000000US110010098072003,"Block 2003, Block Group 2, Census Tract 98.07, District of Columbia, District of Columbia",0,0,0,0,0,0,0,0,0,0,0,0,0,0,0,0,0,0,0,0,0,0,0,0,0,110010098072003,7,708,708,7,psa_1,7D3
1000000US110010050021000,"Block 1000, Block Group 1, Census Tract 50.02, District of Columbia, District of Columbia",504,176,45,19,16,0,229,19,504,149,80,43,8,16,0,0,2,355,96,2,11,0,0,229,17,110010050021000,3,307,307,3,psa_28,3D3
1000000US110010015001007,"Block 1007, Block Group 1, Census Tract 15, District of Columbia, District of Columbia",83,49,30,0,4,0,0,0,83,79,45,30,0,4,0,0,0,4,4,0,0,0,0,0,0,110010015001007,2,201,201,2,psa_55,2D1
1000000US110010019012003,"Block 2003, Block Group 2, Census Tract 19.01, District of Columbia, District of Columbia",71,18,52,0,0,0,0,1,71,54,2,51,0,0,0,0,1,17,16,1,0,0,0,0,0,110010019012003,4,402,402,4,psa_53,4D1
1000000US110010062021209,"Block 1209, Block Group 1, Census Tract 62.02, District of Columbia, District of Columbia",0,0,0,0,0,0,0,0,0,0,0,0,0,0,0,0,0,0,0,0,0,0,0,0,0,110010062021209,1,103,103,1,psa_12,1D1
1000000US110010071002007,"Block 2007, Block Group 2, Census Tract 71, District of Columbia, District of Columbia",163,86,59,0,7,0,3,8,163,160,85,59,0,7,0,2,7,3,1,0,0,0,0,1,1,110010071002007,1,106,106,1,psa_13,1D3
1000000US110010073011015,"Block 1015, Block Group 1, Census Tract 73.01, District of Columbia, District of Columbia",57,25,21,0,3,0,6,2,57,42,18,21,0,3,0,0,0,15,7,0,0,0,0,6,2,110010073011015,7,707,707,7,psa_4,7D2
1000000US110010074042005,"Block 2005, Block Group 2, Census Tract 74.04, District of Columbia, District of Columbia",112,0,110,0,0,0,0,2,112,111,0,109,0,0,0,0,2,1,0,1,0,0,0,0,0,110010074042005,7,704,704,7,psa_5,7D2
1000000US110010098072006,"Block 2006, Block Group 2, Census Tract 98.07, District of Columbia, District of Columbia",0,0,0,0,0,0,0,0,0,0,0,0,0,0,0,0,0,0,0,0,0,0,0,0,0,110010098072006,7,708,708,7,psa_1,7D3
1000000US110010099022000,"Block 2000, Block Group 2, Census Tract 99.02, District of Columbia, District of Columbia",349,0,328,1,0,0,2,18,349,343,0,327,1,0,0,0,15,6,0,1,0,0,0,2,3,110010099022000,6,605,605,6,psa_11,6D2
1000000US110010021023002,"Block 3002, Block Group 3, Census Tract 21.02, District of Columbia, District of Columbia",27,0,21,0,0,0,0,6,27,25,0,21,0,0,0,0,4,2,0,0,0,0,0,0,2,110010021023002,4,403,403,4,psa_51,4D1
1000000US110010034002001,"Block 2001, Block Group 2, Census Tract 34, District of Columbia, District of Columbia",0,0,0,0,0,0,0,0,0,0,0,0,0,0,0,0,0,0,0,0,0,0,0,0,0,110010034002001,3,306,306,3,psa_38,3D2
1000000US110010071002001,"Block 2001, Block Group 2, Census Tract 71, District of Columbia, District of Columbia",46,23,16,2,5,0,0,0,46,45,22,16,2,5,0,0,0,1,1,0,0,0,0,0,0,110010071002001,1,106,106,1,psa_13,1D3
1000000US110010021011012,"Block 1012, Block Group 1, Census Tract 21.01, District of Columbia, District of Columbia",360,22,233,3,13,8,58,23,360,266,10,229,3,13,0,1,10,94,12,4,0,0,8,57,13,110010021011012,4,403,403,4,psa_51,4D1
1000000US110010014021010,"Block 1010, Block Group 1, Census Tract 14.02, District of Columbia, District of Columbia",49,44,0,0,1,0,0,4,49,49,44,0,0,1,0,0,4,0,0,0,0,0,0,0,0,110010014021010,2,201,201,2,psa_55,2D1
1000000US110010035002001,"Block 2001, Block Group 2, Census Tract 35, District of Columbia, District of Columbia",45,11,28,0,1,0,5,0,45,34,5,28,0,1,0,0,0,11,6,0,0,0,0,5,0,110010035002001,3,304,304,3,psa_36,3D1
1000000US110010069002002,"Block 2002, Block Group 2, Census Tract 69, District of Columbia, District of Columbia",16,6,6,0,4,0,0,0,16,15,5,6,0,4,0,0,0,1,1,0,0,0,0,0,0,110010069002002,1,107,107,1,psa_16,1D2
1000000US110010076034000,"Block 4000, Block Group 4, Census Tract 76.03, District of Columbia, District of Columbia",26,6,20,0,0,0,0,0,26,26,6,20,0,0,0,0,0,0,0,0,0,0,0,0,0,110010076034000,6,606,606,6,psa_7,6D2
1000000US110010008014013,"Block 4013, Block Group 4, Census Tract 8.01, District of Columbia, District of Columbia",0,0,0,0,0,0,0,0,0,0,0,0,0,0,0,0,0,0,0,0,0,0,0,0,0,110010008014013,2,205,205,2,psa_46,2D2
1000000US110010008022002,"Block 2002, Block Group 2, Census Tract 8.02, District of Columbia, District of Columbia",33,32,1,0,0,0,0,0,33,31,30,1,0,0,0,0,0,2,2,0,0,0,0,0,0,110010008022002,2,205,205,2,psa_46,2D2
1000000US110010015004007,"Block 4007, Block Group 4, Census Tract 15, District of Columbia, District of Columbia",53,43,2,0,3,0,0,5,53,48,38,2,0,3,0,0,5,5,5,0,0,0,0,0,0,110010015004007,2,201,201,2,psa_55,2D1
1000000US110010026002004,"Block 2004, Block Group 2, Census Tract 26, District of Columbia, District of Columbia",0,0,0,0,0,0,0,0,0,0,0,0,0,0,0,0,0,0,0,0,0,0,0,0,0,110010026002004,2,203,203,2,psa_50,2D1
1000000US110010018031014,"Block 1014, Block Group 1, Census Tract 18.03, District of Columbia, District of Columbia",0,0,0,0,0,0,0,0,0,0,0,0,0,0,0,0,0,0,0,0,0,0,0,0,0,110010018031014,4,402,402,4,psa_53,4D1
1000000US110010018032005,"Block 2005, Block Group 2, Census Tract 18.03, District of Columbia, District of Columbia",696,38,452,1,26,1,144,34,696,502,11,451,0,26,1,2,11,194,27,1,1,0,0,142,23,110010018032005,4,402,402,4,psa_53,4D1
1000000US110010018042001,"Block 2001, Block Group 2, Census Tract 18.04, District of Columbia, District of Columbia",97,4,84,0,0,0,7,2,97,91,4,84,0,0,0,1,2,6,0,0,0,0,0,6,0,110010018042001,4,401,401,4,psa_56,4D1
1000000US110010020012007,"Block 2007, Block Group 2, Census Tract 20.01, District of Columbia, District of Columbia",2,2,0,0,0,0,0,0,2,2,2,0,0,0,0,0,0,0,0,0,0,0,0,0,0,110010020012007,4,403,403,4,psa_51,4D1
1000000US110010078082007,"Block 2007, Block Group 2, Census Tract 78.08, District of Columbia, District of Columbia",122,0,122,0,0,0,0,0,122,117,0,117,0,0,0,0,0,5,0,5,0,0,0,0,0,110010078082007,6,608,608,6,psa_19,6D1
1000000US110010101001000,"Block 1000, Block Group 1, Census Tract 101, District of Columbia, District of Columbia",0,0,0,0,0,0,0,0,0,0,0,0,0,0,0,0,0,0,0,0,0,0,0,0,0,110010101001000,2,209,209,2,psa_57,2D3
1000000US110010002023008,"Block 3008, Block Group 3, Census Tract 2.02, District of Columbia, District of Columbia",7,6,0,0,1,0,0,0,7,6,5,0,0,1,0,0,0,1,1,0,0,0,0,0,0,110010002023008,2,206,206,2,psa_29,2D2
1000000US110010050022004,"Block 2004, Block Group 2, Census Tract 50.02, District of Columbia, District of Columbia",0,0,0,0,0,0,0,0,0,0,0,0,0,0,0,0,0,0,0,0,0,0,0,0,0,110010050022004,3,307,307,3,psa_28,3D3
1000000US110010072001016,"Block 1016, Block Group 1, Census Tract 72, District of Columbia, District of Columbia",60,30,27,0,0,0,0,3,60,57,27,27,0,0,0,0,3,3,3,0,0,0,0,0,0,110010072001016,1,106,106,1,psa_13,1D3
1000000US110010091022020,"Block 2020, Block Group 2, Census Tract 91.02, District of Columbia, District of Columbia",0,0,0,0,0,0,0,0,0,0,0,0,0,0,0,0,0,0,0,0,0,0,0,0,0,110010091022020,5,505,505,5,psa_34,5D2
1000000US110010021024001,"Block 4001, Block Group 4, Census Tract 21.02, District of Columbia, District of Columbia",96,1,77,0,0,0,8,10,96,83,1,76,0,0,0,0,6,13,0,1,0,0,0,8,4,110010021024001,4,406,406,4,psa_54,4D2
1000000US110010076011008,"Block 1008, Block Group 1, Census Tract 76.01, District of Columbia, District of Columbia",0,0,0,0,0,0,0,0,0,0,0,0,0,0,0,0,0,0,0,0,0,0,0,0,0,110010076011008,6,607,607,6,psa_10,6D2
1000000US110010079031002,"Block 1002, Block Group 1, Census Tract 79.03, District of Columbia, District of Columbia",170,10,143,4,1,0,10,2,170,156,5,143,4,1,0,2,1,14,5,0,0,0,0,8,1,110010079031002,5,507,507,5,psa_23,5D3
1000000US110010023012007,"Block 2007, Block Group 2, Census Tract 23.01, District of Columbia, District of Columbia",162,16,126,5,1,2,4,8,162,148,14,125,0,1,0,0,8,14,2,1,5,0,2,4,0,110010023012007,4,407,407,4,psa_47,4D2
1000000US110010013012000,"Block 2000, Block Group 2, Census Tract 13.01, District of Columbia, District of Columbia",207,161,27,2,5,0,2,10,207,182,140,27,1,5,0,0,9,25,21,0,1,0,0,2,1,110010013012000,2,203,203,2,psa_50,2D1
1000000US110010017021004,"Block 1004, Block Group 1, Census Tract 17.02, District of Columbia, District of Columbia",17,16,0,0,1,0,0,0,17,17,16,0,0,1,0,0,0,0,0,0,0,0,0,0,0,110010017021004,4,401,401,4,psa_56,4D1
1000000US110010099012013,"Block 2013, Block Group 2, Census Tract 99.01, District of Columbia, District of Columbia",35,0,35,0,0,0,0,0,35,35,0,35,0,0,0,0,0,0,0,0,0,0,0,0,0,110010099012013,6,605,605,6,psa_11,6D2
1000000US110010102002025,"Block 2025, Block Group 2, Census Tract 102, District of Columbia, District of Columbia",0,0,0,0,0,0,0,0,0,0,0,0,0,0,0,0,0,0,0,0,0,0,0,0,0,110010102002025,1,103,103,1,psa_12,1D1
1000000US110010001004034,"Block 4034, Block Group 4, Census Tract 1, District of Columbia, District of Columbia",0,0,0,0,0,0,0,0,0,0,0,0,0,0,0,0,0,0,0,0,0,0,0,0,0,110010001004034,2,206,206,2,psa_29,2D2
1000000US110010008013017,"Block 3017, Block Group 3, Census Tract 8.01, District of Columbia, District of Columbia",23,20,0,0,1,0,0,2,23,23,20,0,0,1,0,0,2,0,0,0,0,0,0,0,0,110010008013017,2,205,205,2,psa_46,2D2
1000000US110010062021049,"Block 1049, Block Group 1, Census Tract 62.02, District of Columbia, District of Columbia",0,0,0,0,0,0,0,0,0,0,0,0,0,0,0,0,0,0,0,0,0,0,0,0,0,110010062021049,2,207,207,2,psa_24,2D3
1000000US110010073011040,"Block 1040, Block Group 1, Census Tract 73.01, District of Columbia, District of Columbia",0,0,0,0,0,0,0,0,0,0,0,0,0,0,0,0,0,0,0,0,0,0,0,0,0,110010073011040,7,707,707,7,psa_4,7D2
1000000US110010091022003,"Block 2003, Block Group 2, Census Tract 91.02, District of Columbia, District of Columbia",60,2,57,0,0,0,0,1,60,60,2,57,0,0,0,0,1,0,0,0,0,0,0,0,0,110010091022003,5,505,505,5,psa_34,5D2
1000000US110010106002039,"Block 2039, Block Group 2, Census Tract 106, District of Columbia, District of Columbia",0,0,0,0,0,0,0,0,0,0,0,0,0,0,0,0,0,0,0,0,0,0,0,0,0,110010106002039,1,102,102,1,psa_18,1D1
1000000US110010062021132,"Block 1132, Block Group 1, Census Tract 62.02, District of Columbia, District of Columbia",2,2,0,0,0,0,0,0,2,2,2,0,0,0,0,0,0,0,0,0,0,0,0,0,0,110010062021132,1,102,102,1,psa_18,1D1
1000000US110010099071003,"Block 1003, Block Group 1, Census Tract 99.07, District of Columbia, District of Columbia",52,0,51,1,0,0,0,0,52,49,0,49,0,0,0,0,0,3,0,2,1,0,0,0,0,110010099071003,6,605,605,6,psa_11,6D2
1000000US110010006004011,"Block 4011, Block Group 4, Census Tract 6, District of Columbia, District of Columbia",88,83,1,0,1,0,1,2,88,85,81,1,0,1,0,0,2,3,2,0,0,0,0,1,0,110010006004011,2,203,203,2,psa_50,2D1
1000000US110010108002010,"Block 2010, Block Group 2, Census Tract 108.00, District of Columbia, District of Columbia",1597,1354,42,0,111,0,17,73,1597,1454,1228,42,0,111,0,0,73,143,126,0,0,0,0,17,0,110010108002010,2,207,207,2,psa_24,2D3
1000000US110010021026009,"Block 6009, Block Group 6, Census Tract 21.02, District of Columbia, District of Columbia",173,24,102,0,1,0,42,4,173,127,20,102,0,1,0,0,4,46,4,0,0,0,0,42,0,110010021026009,4,403,403,4,psa_51,4D1
1000000US110010076041006,"Block 1006, Block Group 1, Census Tract 76.04, District of Columbia, District of Columbia",45,1,44,0,0,0,0,0,45,45,1,44,0,0,0,0,0,0,0,0,0,0,0,0,0,110010076041006,6,607,607,6,psa_10,6D2
1000000US110010033012005,"Block 2005, Block Group 2, Census Tract 33.01, District of Columbia, District of Columbia",13,5,7,0,0,0,0,1,13,13,5,7,0,0,0,0,1,0,0,0,0,0,0,0,0,110010033012005,3,306,306,3,psa_38,3D2
1000000US110010001004015,"Block 4015, Block Group 4, Census Tract 1, District of Columbia, District of Columbia",6,4,0,1,0,0,0,1,6,2,2,0,0,0,0,0,0,4,2,0,1,0,0,0,1,110010001004015,2,206,206,2,psa_29,2D2
1000000US110010015002000,"Block 2000, Block Group 2, Census Tract 15, District of Columbia, District of Columbia",48,44,4,0,0,0,0,0,48,45,41,4,0,0,0,0,0,3,3,0,0,0,0,0,0,110010015002000,2,201,201,2,psa_55,2D1
1000000US110010017022010,"Block 2010, Block Group 2, Census Tract 17.02, District of Columbia, District of Columbia",0,0,0,0,0,0,0,0,0,0,0,0,0,0,0,0,0,0,0,0,0,0,0,0,0,110010017022010,4,401,401,4,psa_56,4D1
1000000US110010018032002,"Block 2002, Block Group 2, Census Tract 18.03, District of Columbia, District of Columbia",146,18,90,0,13,0,25,0,146,114,11,90,0,13,0,0,0,32,7,0,0,0,0,25,0,110010018032002,4,402,402,4,psa_53,4D1
1000000US110010064002010,"Block 2010, Block Group 2, Census Tract 64, District of Columbia, District of Columbia",0,0,0,0,0,0,0,0,0,0,0,0,0,0,0,0,0,0,0,0,0,0,0,0,0,110010064002010,1,105,105,1,psa_22,1D3
1000000US110010076013006,"Block 3006, Block Group 3, Census Tract 76.01, District of Columbia, District of Columbia",89,2,82,0,0,0,0,5,89,89,2,82,0,0,0,0,5,0,0,0,0,0,0,0,0,110010076013006,6,607,607,6,psa_10,6D2
1000000US110010050011010,"Block 1010, Block Group 1, Census Tract 50.01, District of Columbia, District of Columbia",78,70,2,0,4,0,0,2,78,69,63,2,0,4,0,0,0,9,7,0,0,0,0,0,2,110010050011010,3,307,307,3,psa_28,3D3
1000000US110010077072024,"Block 2024, Block Group 2, Census Tract 77.07, District of Columbia, District of Columbia",15,1,13,0,0,0,1,0,15,14,1,13,0,0,0,0,0,1,0,0,0,0,0,1,0,110010077072024,6,605,605,6,psa_11,6D2
1000000US110010077082000,"Block 2000, Block Group 2, Census Tract 77.08, District of Columbia, District of Columbia",0,0,0,0,0,0,0,0,0,0,0,0,0,0,0,0,0,0,0,0,0,0,0,0,0,110010077082000,6,603,603,6,psa_15,6D3
1000000US110010072002015,"Block 2015, Block Group 2, Census Tract 72, District of Columbia, District of Columbia",0,0,0,0,0,0,0,0,0,0,0,0,0,0,0,0,0,0,0,0,0,0,0,0,0,110010072002015,1,106,106,1,psa_13,1D3
1000000US110010002024009,"Block 4009, Block Group 4, Census Tract 2.02, District of Columbia, District of Columbia",0,0,0,0,0,0,0,0,0,0,0,0,0,0,0,0,0,0,0,0,0,0,0,0,0,110010002024009,2,206,206,2,psa_29,2D2
1000000US110010009011008,"Block 1008, Block Group 1, Census Tract 9.01, District of Columbia, District of Columbia",78,64,10,0,2,0,2,0,78,77,63,10,0,2,0,2,0,1,1,0,0,0,0,0,0,110010009011008,2,205,205,2,psa_46,2D2
1000000US110010088031007,"Block 1007, Block Group 1, Census Tract 88.03, District of Columbia, District of Columbia",0,0,0,0,0,0,0,0,0,0,0,0,0,0,0,0,0,0,0,0,0,0,0,0,0,110010088031007,5,506,506,5,psa_26,5D3
1000000US110010025011006,"Block 1006, Block Group 1, Census Tract 25.01, District of Columbia, District of Columbia",167,19,79,1,0,2,55,11,167,63,0,62,1,0,0,0,0,104,19,17,0,0,2,55,11,110010025011006,4,404,404,4,psa_48,4D3
1000000US110010092011001,"Block 1001, Block Group 1, Census Tract 92.01, District of Columbia, District of Columbia",0,0,0,0,0,0,0,0,0,0,0,0,0,0,0,0,0,0,0,0,0,0,0,0,0,110010092011001,5,502,502,5,psa_40,5D1
1000000US110010009021000,"Block 1000, Block Group 1, Census Tract 9.02, District of Columbia, District of Columbia",150,136,2,0,5,0,0,7,150,146,134,2,0,5,0,0,5,4,2,0,0,0,0,0,2,110010009021000,2,205,205,2,psa_46,2D2
1000000US110010076014010,"Block 4010, Block Group 4, Census Tract 76.01, District of Columbia, District of Columbia",83,0,81,0,0,0,0,2,83,81,0,79,0,0,0,0,2,2,0,2,0,0,0,0,0,110010076014010,6,607,607,6,psa_10,6D2
1000000US110010110002012,"Block 2012, Block Group 2, Census Tract 110, District of Columbia, District of Columbia",0,0,0,0,0,0,0,0,0,0,0,0,0,0,0,0,0,0,0,0,0,0,0,0,0,110010110002012,1,105,105,1,psa_22,1D3
1000000US110010044001013,"Block 1013, Block Group 1, Census Tract 44, District of Columbia, District of Columbia",0,0,0,0,0,0,0,0,0,0,0,0,0,0,0,0,0,0,0,0,0,0,0,0,0,110010044001013,3,305,305,3,psa_32,3D2
1000000US110010077082003,"Block 2003, Block Group 2, Census Tract 77.08, District of Columbia, District of Columbia",0,0,0,0,0,0,0,0,0,0,0,0,0,0,0,0,0,0,0,0,0,0,0,0,0,110010077082003,6,603,603,6,psa_15,6D3
1000000US110010089031009,"Block 1009, Block Group 1, Census Tract 89.03, District of Columbia, District of Columbia",164,6,157,1,0,0,0,0,164,159,1,157,1,0,0,0,0,5,5,0,0,0,0,0,0,110010089031009,5,507,507,5,psa_23,5D3
1000000US110010003004003,"Block 4003, Block Group 4, Census Tract 3, District of Columbia, District of Columbia",105,102,0,0,2,0,0,1,105,103,100,0,0,2,0,0,1,2,2,0,0,0,0,0,0,110010003004003,2,204,204,2,psa_44,2D2
1000000US110010110003005,"Block 3005, Block Group 3, Census Tract 110, District of Columbia, District of Columbia",0,0,0,0,0,0,0,0,0,0,0,0,0,0,0,0,0,0,0,0,0,0,0,0,0,110010110003005,1,103,103,1,psa_12,1D1
1000000US110010052014002,"Block 4002, Block Group 4, Census Tract 52.01, District of Columbia, District of Columbia",415,95,291,3,0,1,16,9,415,388,87,291,0,0,1,1,8,27,8,0,3,0,0,15,1,110010052014002,3,301,301,3,psa_31,3D3
1000000US110010074072002,"Block 2002, Block Group 2, Census Tract 74.07, District of Columbia, District of Columbia",102,3,96,0,3,0,0,0,102,102,3,96,0,3,0,0,0,0,0,0,0,0,0,0,0,110010074072002,7,703,703,7,psa_8,7D1
1000000US110010076052003,"Block 2003, Block Group 2, Census Tract 76.05, District of Columbia, District of Columbia",416,9,403,1,0,0,3,0,416,411,4,403,1,0,0,3,0,5,5,0,0,0,0,0,0,110010076052003,6,606,606,6,psa_7,6D2
1000000US110010071001006,"Block 1006, Block Group 1, Census Tract 71, District of Columbia, District of Columbia",86,0,86,0,0,0,0,0,86,86,0,86,0,0,0,0,0,0,0,0,0,0,0,0,0,110010071001006,1,106,106,1,psa_13,1D3
1000000US110010077032001,"Block 2001, Block Group 2, Census Tract 77.03, District of Columbia, District of Columbia",95,0,95,0,0,0,0,0,95,95,0,95,0,0,0,0,0,0,0,0,0,0,0,0,0,110010077032001,6,603,603,6,psa_15,6D3
1000000US110010003003011,"Block 3011, Block Group 3, Census Tract 3, District of Columbia, District of Columbia",130,117,6,0,5,0,0,2,130,120,107,6,0,5,0,0,2,10,10,0,0,0,0,0,0,110010003003011,2,206,206,2,psa_29,2D2
1000000US110010008013023,"Block 3023, Block Group 3, Census Tract 8.01, District of Columbia, District of Columbia",30,30,0,0,0,0,0,0,30,30,30,0,0,0,0,0,0,0,0,0,0,0,0,0,0,110010008013023,2,205,205,2,psa_46,2D2
1000000US110010041002006,"Block 2006, Block Group 2, Census Tract 41, District of Columbia, District of Columbia",0,0,0,0,0,0,0,0,0,0,0,0,0,0,0,0,0,0,0,0,0,0,0,0,0,110010041002006,2,208,208,2,psa_33,2D3
1000000US110010099032001,"Block 2001, Block Group 2, Census Tract 99.03, District of Columbia, District of Columbia",199,0,190,0,0,0,0,9,199,194,0,186,0,0,0,0,8,5,0,4,0,0,0,0,1,110010099032001,6,604,604,6,psa_14,6D3
1000000US110010014022006,"Block 2006, Block Group 2, Census Tract 14.02, District of Columbia, District of Columbia",30,28,1,0,0,0,0,1,30,28,26,1,0,0,0,0,1,2,2,0,0,0,0,0,0,110010014022006,2,201,201,2,psa_55,2D1
1000000US110010062021020,"Block 1020, Block Group 1, Census Tract 62.02, District of Columbia, District of Columbia",0,0,0,0,0,0,0,0,0,0,0,0,0,0,0,0,0,0,0,0,0,0,0,0,0,110010062021020,1,102,102,1,psa_18,1D1
1000000US110010033011000,"Block 1000, Block Group 1, Census Tract 33.01, District of Columbia, District of Columbia",0,0,0,0,0,0,0,0,0,0,0,0,0,0,0,0,0,0,0,0,0,0,0,0,0,110010033011000,3,306,306,3,psa_38,3D2
1000000US110010082001003,"Block 1003, Block Group 1, Census Tract 82, District of Columbia, District of Columbia",197,171,13,0,2,0,3,8,197,191,170,12,0,2,0,0,7,6,1,1,0,0,0,3,1,110010082001003,1,108,108,1,psa_17,1D2
1000000US110010108002012,"Block 2012, Block Group 2, Census Tract 108.00, District of Columbia, District of Columbia",0,0,0,0,0,0,0,0,0,0,0,0,0,0,0,0,0,0,0,0,0,0,0,0,0,110010108002012,2,207,207,2,psa_24,2D3
1000000US110010007013003,"Block 3003, Block Group 3, Census Tract 7.01, District of Columbia, District of Columbia",74,64,0,0,7,0,0,3,74,67,58,0,0,6,0,0,3,7,6,0,0,1,0,0,0,110010007013003,2,204,204,2,psa_44,2D2
1000000US110010062021031,"Block 1031, Block Group 1, Census Tract 62.02, District of Columbia, District of Columbia",5,0,5,0,0,0,0,0,5,5,0,5,0,0,0,0,0,0,0,0,0,0,0,0,0,110010062021031,2,207,207,2,psa_24,2D3
1000000US110010020021026,"Block 1026, Block Group 1, Census Tract 20.02, District of Columbia, District of Columbia",120,16,74,0,0,0,23,7,120,88,10,73,0,0,0,0,5,32,6,1,0,0,0,23,2,110010020021026,4,404,404,4,psa_48,4D3
1000000US110010009011003,"Block 1003, Block Group 1, Census Tract 9.01, District of Columbia, District of Columbia",94,87,2,0,0,0,0,5,94,88,82,2,0,0,0,0,4,6,5,0,0,0,0,0,1,110010009011003,2,205,205,2,psa_46,2D2
1000000US110010016004029,"Block 4029, Block Group 4, Census Tract 16, District of Columbia, District of Columbia",67,17,45,0,1,0,0,4,67,67,17,45,0,1,0,0,4,0,0,0,0,0,0,0,0,110010016004029,4,401,401,4,psa_56,4D1
1000000US110010098071008,"Block 1008, Block Group 1, Census Tract 98.07, District of Columbia, District of Columbia",0,0,0,0,0,0,0,0,0,0,0,0,0,0,0,0,0,0,0,0,0,0,0,0,0,110010098071008,7,707,707,7,psa_4,7D2
1000000US110010027022008,"Block 2008, Block Group 2, Census Tract 27.02, District of Columbia, District of Columbia",166,102,10,0,12,0,31,11,166,96,74,9,0,12,0,0,1,70,28,1,0,0,0,31,10,110010027022008,3,302,302,3,psa_42,3D1
1000000US110010041003010,"Block 3010, Block Group 3, Census Tract 41, District of Columbia, District of Columbia",0,0,0,0,0,0,0,0,0,0,0,0,0,0,0,0,0,0,0,0,0,0,0,0,0,110010041003010,2,206,206,2,psa_29,2D2
1000000US110010042022007,"Block 2007, Block Group 2, Census Tract 42.02, District of Columbia, District of Columbia",244,181,20,2,25,0,7,9,244,215,163,20,0,24,0,1,7,29,18,0,2,1,0,6,2,110010042022007,2,208,208,2,psa_33,2D3
1000000US110010062021199,"Block 1199, Block Group 1, Census Tract 62.02, District of Columbia, District of Columbia",0,0,0,0,0,0,0,0,0,0,0,0,0,0,0,0,0,0,0,0,0,0,0,0,0,110010062021199,1,103,103,1,psa_12,1D1
1000000US110010016002011,"Block 2011, Block Group 2, Census Tract 16, District of Columbia, District of Columbia",59,11,36,0,1,1,1,9,59,56,11,36,0,1,0,0,8,3,0,0,0,0,1,1,1,110010016002011,4,401,401,4,psa_56,4D1
1000000US110010019013004,"Block 3004, Block Group 3, Census Tract 19.01, District of Columbia, District of Columbia",27,3,23,0,0,0,0,1,27,27,3,23,0,0,0,0,1,0,0,0,0,0,0,0,0,110010019013004,4,402,402,4,psa_53,4D1
1000000US110010018031011,"Block 1011, Block Group 1, Census Tract 18.03, District of Columbia, District of Columbia",51,10,38,0,0,0,3,0,51,45,10,35,0,0,0,0,0,6,0,3,0,0,0,3,0,110010018031011,4,402,402,4,psa_53,4D1
1000000US110010098032006,"Block 2006, Block Group 2, Census Tract 98.03, District of Columbia, District of Columbia",82,0,81,0,0,0,1,0,82,81,0,81,0,0,0,0,0,1,0,0,0,0,0,1,0,110010098032006,7,707,707,7,psa_4,7D2
1000000US110010058002010,"Block 2010, Block Group 2, Census Tract 58, District of Columbia, District of Columbia",566,427,34,2,71,0,2,30,566,528,396,33,2,71,0,0,26,38,31,1,0,0,0,2,4,110010058002010,1,102,102,1,psa_18,1D1
1000000US110010003004006,"Block 4006, Block Group 4, Census Tract 3, District of Columbia, District of Columbia",141,128,0,0,7,0,0,6,141,139,126,0,0,7,0,0,6,2,2,0,0,0,0,0,0,110010003004006,2,204,204,2,psa_44,2D2
1000000US110010056002013,"Block 2013, Block Group 2, Census Tract 56, District of Columbia, District of Columbia",0,0,0,0,0,0,0,0,0,0,0,0,0,0,0,0,0,0,0,0,0,0,0,0,0,110010056002013,2,207,207,2,psa_24,2D3
1000000US110010062021036,"Block 1036, Block Group 1, Census Tract 62.02, District of Columbia, District of Columbia",0,0,0,0,0,0,0,0,0,0,0,0,0,0,0,0,0,0,0,0,0,0,0,0,0,110010062021036,2,207,207,2,psa_24,2D3
1000000US110010096031005,"Block 1005, Block Group 1, Census Tract 96.03, District of Columbia, District of Columbia",0,0,0,0,0,0,0,0,0,0,0,0,0,0,0,0,0,0,0,0,0,0,0,0,0,110010096031005,6,603,603,6,psa_15,6D3
1000000US110010010013016,"Block 3016, Block Group 3, Census Tract 10.01, District of Columbia, District of Columbia",53,49,2,0,1,0,1,0,53,40,37,2,0,1,0,0,0,13,12,0,0,0,0,1,0,110010010013016,2,202,202,2,psa_52,2D1
1000000US110010062021121,"Block 1121, Block Group 1, Census Tract 62.02, District of Columbia, District of Columbia",0,0,0,0,0,0,0,0,0,0,0,0,0,0,0,0,0,0,0,0,0,0,0,0,0,110010062021121,1,102,102,1,psa_18,1D1
1000000US110010062021032,"Block 1032, Block Group 1, Census Tract 62.02, District of Columbia, District of Columbia",0,0,0,0,0,0,0,0,0,0,0,0,0,0,0,0,0,0,0,0,0,0,0,0,0,110010062021032,2,207,207,2,psa_24,2D3
1000000US110010072001027,"Block 1027, Block Group 1, Census Tract 72, District of Columbia, District of Columbia",39,32,0,0,4,0,0,3,39,37,30,0,0,4,0,0,3,2,2,0,0,0,0,0,0,110010072001027,1,106,106,1,psa_13,1D3
1000000US110010083012012,"Block 2012, Block Group 2, Census Tract 83.01, District of Columbia, District of Columbia",0,0,0,0,0,0,0,0,0,0,0,0,0,0,0,0,0,0,0,0,0,0,0,0,0,110010083012012,1,108,108,1,psa_17,1D2
1000000US110010082002004,"Block 2004, Block Group 2, Census Tract 82, District of Columbia, District of Columbia",299,243,19,2,31,1,3,0,299,290,237,19,2,31,1,0,0,9,6,0,0,0,0,3,0,110010082002004,1,108,108,1,psa_17,1D2
1000000US110010033013004,"Block 3004, Block Group 3, Census Tract 33.01, District of Columbia, District of Columbia",135,25,103,0,0,3,0,4,135,134,24,103,0,0,3,0,4,1,1,0,0,0,0,0,0,110010033013004,3,306,306,3,psa_38,3D2
1000000US110010078062015,"Block 2015, Block Group 2, Census Tract 78.06, District of Columbia, District of Columbia",100,0,94,1,0,0,0,5,100,100,0,94,1,0,0,0,5,0,0,0,0,0,0,0,0,110010078062015,6,602,602,6,psa_25,6D1
1000000US110010007023002,"Block 3002, Block Group 3, Census Tract 7.02, District of Columbia, District of Columbia",272,250,9,1,4,0,2,6,272,254,237,8,0,4,0,1,4,18,13,1,1,0,0,1,2,110010007023002,2,204,204,2,psa_44,2D2
1000000US110010041003008,"Block 3008, Block Group 3, Census Tract 41, District of Columbia, District of Columbia",0,0,0,0,0,0,0,0,0,0,0,0,0,0,0,0,0,0,0,0,0,0,0,0,0,110010041003008,2,208,208,2,psa_33,2D3
1000000US110010005022003,"Block 2003, Block Group 2, Census Tract 5.02, District of Columbia, District of Columbia",58,55,0,0,3,0,0,0,58,58,55,0,0,3,0,0,0,0,0,0,0,0,0,0,0,110010005022003,2,204,204,2,psa_44,2D2
1000000US110010050012007,"Block 2007, Block Group 2, Census Tract 50.01, District of Columbia, District of Columbia",0,0,0,0,0,0,0,0,0,0,0,0,0,0,0,0,0,0,0,0,0,0,0,0,0,110010050012007,3,307,307,3,psa_28,3D3
1000000US110010022012000,"Block 2000, Block Group 2, Census Tract 22.01, District of Columbia, District of Columbia",139,18,116,4,1,0,0,0,139,119,9,109,0,1,0,0,0,20,9,7,4,0,0,0,0,110010022012000,4,407,407,4,psa_47,4D2
1000000US110010077091026,"Block 1026, Block Group 1, Census Tract 77.09, District of Columbia, District of Columbia",0,0,0,0,0,0,0,0,0,0,0,0,0,0,0,0,0,0,0,0,0,0,0,0,0,110010077091026,6,605,605,6,psa_11,6D2
1000000US110010017022017,"Block 2017, Block Group 2, Census Tract 17.02, District of Columbia, District of Columbia",0,0,0,0,0,0,0,0,0,0,0,0,0,0,0,0,0,0,0,0,0,0,0,0,0,110010017022017,4,406,406,4,psa_54,4D2
1000000US110010056004003,"Block 4003, Block Group 4, Census Tract 56, District of Columbia, District of Columbia",67,64,0,0,3,0,0,0,67,62,59,0,0,3,0,0,0,5,5,0,0,0,0,0,0,110010056004003,2,207,207,2,psa_24,2D3
1000000US110010001004022,"Block 4022, Block Group 4, Census Tract 1, District of Columbia, District of Columbia",6,6,0,0,0,0,0,0,6,6,6,0,0,0,0,0,0,0,0,0,0,0,0,0,0,110010001004022,2,206,206,2,psa_29,2D2
1000000US110010008022001,"Block 2001, Block Group 2, Census Tract 8.02, District of Columbia, District of Columbia",28,26,0,0,2,0,0,0,28,28,26,0,0,2,0,0,0,0,0,0,0,0,0,0,0,110010008022001,2,205,205,2,psa_46,2D2
1000000US110010046002017,"Block 2017, Block Group 2, Census Tract 46, District of Columbia, District of Columbia",3,0,3,0,0,0,0,0,3,3,0,3,0,0,0,0,0,0,0,0,0,0,0,0,0,110010046002017,3,308,308,3,psa_27,3D2
1000000US110010048011011,"Block 1011, Block Group 1, Census Tract 48.01, District of Columbia, District of Columbia",177,62,90,0,14,0,3,8,177,162,52,88,0,14,0,0,8,15,10,2,0,0,0,3,0,110010048011011,3,308,308,3,psa_27,3D2
1000000US110010068041015,"Block 1015, Block Group 1, Census Tract 68.04, District of Columbia, District of Columbia",0,0,0,0,0,0,0,0,0,0,0,0,0,0,0,0,0,0,0,0,0,0,0,0,0,110010068041015,1,107,107,1,psa_16,1D2
1000000US110010095033001,"Block 3001, Block Group 3, Census Tract 95.03, District of Columbia, District of Columbia",53,10,34,0,5,0,0,4,53,51,9,33,0,5,0,0,4,2,1,1,0,0,0,0,0,110010095033001,4,405,405,4,psa_49,4D2
1000000US110010002024005,"Block 4005, Block Group 4, Census Tract 2.02, District of Columbia, District of Columbia",101,86,5,0,7,0,0,3,101,94,80,5,0,7,0,0,2,7,6,0,0,0,0,0,1,110010002024005,2,206,206,2,psa_29,2D2
1000000US110010027012001,"Block 2001, Block Group 2, Census Tract 27.01, District of Columbia, District of Columbia",71,56,13,0,0,0,0,2,71,61,47,12,0,0,0,0,2,10,9,1,0,0,0,0,0,110010027012001,3,302,302,3,psa_42,3D1
1000000US110010084021003,"Block 1003, Block Group 1, Census Tract 84.02, District of Columbia, District of Columbia",71,37,32,0,1,0,1,0,71,62,30,31,0,1,0,0,0,9,7,1,0,0,0,1,0,110010084021003,1,104,104,1,psa_21,1D2
1000000US110010095052022,"Block 2022, Block Group 2, Census Tract 95.05, District of Columbia, District of Columbia",0,0,0,0,0,0,0,0,0,0,0,0,0,0,0,0,0,0,0,0,0,0,0,0,0,110010095052022,4,406,406,4,psa_54,4D2
1000000US110010059001013,"Block 1013, Block Group 1, Census Tract 59, District of Columbia, District of Columbia",0,0,0,0,0,0,0,0,0,0,0,0,0,0,0,0,0,0,0,0,0,0,0,0,0,110010059001013,1,101,101,1,psa_20,1D1
1000000US110010078061008,"Block 1008, Block Group 1, Census Tract 78.06, District of Columbia, District of Columbia",13,0,12,0,0,0,0,1,13,13,0,12,0,0,0,0,1,0,0,0,0,0,0,0,0,110010078061008,6,602,602,6,psa_25,6D1
1000000US110010102002045,"Block 2045, Block Group 2, Census Tract 102, District of Columbia, District of Columbia",0,0,0,0,0,0,0,0,0,0,0,0,0,0,0,0,0,0,0,0,0,0,0,0,0,110010102002045,1,103,103,1,psa_12,1D1
1000000US110010077091008,"Block 1008, Block Group 1, Census Tract 77.09, District of Columbia, District of Columbia",0,0,0,0,0,0,0,0,0,0,0,0,0,0,0,0,0,0,0,0,0,0,0,0,0,110010077091008,6,605,605,6,psa_11,6D2
1000000US110010088041006,"Block 1006, Block Group 1, Census Tract 88.04, District of Columbia, District of Columbia",24,2,20,0,2,0,0,0,24,24,2,20,0,2,0,0,0,0,0,0,0,0,0,0,0,110010088041006,5,506,506,5,psa_26,5D3
1000000US110010096011032,"Block 1032, Block Group 1, Census Tract 96.01, District of Columbia, District of Columbia",94,1,93,0,0,0,0,0,94,94,1,93,0,0,0,0,0,0,0,0,0,0,0,0,0,110010096011032,6,601,601,6,psa_30,6D1
1000000US110010002022005,"Block 2005, Block Group 2, Census Tract 2.02, District of Columbia, District of Columbia",113,107,1,0,5,0,0,0,113,109,103,1,0,5,0,0,0,4,4,0,0,0,0,0,0,110010002022005,2,206,206,2,psa_29,2D2
1000000US110010004001006,"Block 1006, Block Group 1, Census Tract 4, District of Columbia, District of Columbia",49,49,0,0,0,0,0,0,49,45,45,0,0,0,0,0,0,4,4,0,0,0,0,0,0,110010004001006,2,204,204,2,psa_44,2D2
1000000US110010001002004,"Block 2004, Block Group 2, Census Tract 1, District of Columbia, District of Columbia",63,53,3,0,5,0,0,2,63,61,51,3,0,5,0,0,2,2,2,0,0,0,0,0,0,110010001002004,2,206,206,2,psa_29,2D2
1000000US110010022022000,"Block 2000, Block Group 2, Census Tract 22.02, District of Columbia, District of Columbia",129,7,102,0,0,0,7,13,129,115,3,99,0,0,0,0,13,14,4,3,0,0,0,7,0,110010022022000,4,407,407,4,psa_47,4D2
1000000US110010027023018,"Block 3018, Block Group 3, Census Tract 27.02, District of Columbia, District of Columbia",0,0,0,0,0,0,0,0,0,0,0,0,0,0,0,0,0,0,0,0,0,0,0,0,0,110010027023018,2,204,204,2,psa_44,2D2
1000000US110010076042032,"Block 2032, Block Group 2, Census Tract 76.04, District of Columbia, District of Columbia",71,5,65,0,0,0,0,1,71,69,5,63,0,0,0,0,1,2,0,2,0,0,0,0,0,110010076042032,6,606,606,6,psa_7,6D2
1000000US110010037002000,"Block 2000, Block Group 2, Census Tract 37, District of Columbia, District of Columbia",644,203,344,0,19,0,42,36,644,541,180,327,0,18,0,2,14,103,23,17,0,1,0,40,22,110010037002000,3,304,304,3,psa_36,3D1
1000000US110010068022009,"Block 2009, Block Group 2, Census Tract 68.02, District of Columbia, District of Columbia",29,19,10,0,0,0,0,0,29,29,19,10,0,0,0,0,0,0,0,0,0,0,0,0,0,110010068022009,1,107,107,1,psa_16,1D2
1000000US110010055002010,"Block 2010, Block Group 2, Census Tract 55, District of Columbia, District of Columbia",398,336,10,0,33,0,7,12,398,372,315,8,0,33,0,5,11,26,21,2,0,0,0,2,1,110010055002010,2,207,207,2,psa_24,2D3
1000000US110010021021003,"Block 1003, Block Group 1, Census Tract 21.02, District of Columbia, District of Columbia",106,5,99,0,1,0,0,1,106,105,5,98,0,1,0,0,1,1,0,1,0,0,0,0,0,110010021021003,4,406,406,4,psa_54,4D2
1000000US110010073041002,"Block 1002, Block Group 1, Census Tract 73.04, District of Columbia, District of Columbia",42,0,42,0,0,0,0,0,42,42,0,42,0,0,0,0,0,0,0,0,0,0,0,0,0,110010073041002,7,704,704,7,psa_5,7D2
1000000US110010042021004,"Block 1004, Block Group 1, Census Tract 42.02, District of Columbia, District of Columbia",2,0,0,0,0,0,2,0,2,0,0,0,0,0,0,0,0,2,0,0,0,0,0,2,0,110010042021004,3,301,301,3,psa_31,3D3
1000000US110010062021146,"Block 1146, Block Group 1, Census Tract 62.02, District of Columbia, District of Columbia",0,0,0,0,0,0,0,0,0,0,0,0,0,0,0,0,0,0,0,0,0,0,0,0,0,110010062021146,1,102,102,1,psa_18,1D1
1000000US110010084021001,"Block 1001, Block Group 1, Census Tract 84.02, District of Columbia, District of Columbia",66,54,12,0,0,0,0,0,66,66,54,12,0,0,0,0,0,0,0,0,0,0,0,0,0,110010084021001,1,104,104,1,psa_21,1D2
1000000US110010023012011,"Block 2011, Block Group 2, Census Tract 23.01, District of Columbia, District of Columbia",157,42,90,1,5,0,16,3,157,120,22,90,1,5,0,0,2,37,20,0,0,0,0,16,1,110010023012011,4,407,407,4,psa_47,4D2
1000000US110010078032000,"Block 2000, Block Group 2, Census Tract 78.03, District of Columbia, District of Columbia",92,2,85,0,0,0,5,0,92,87,2,85,0,0,0,0,0,5,0,0,0,0,0,5,0,110010078032000,6,602,602,6,psa_25,6D1
1000000US110010080021001,"Block 1001, Block Group 1, Census Tract 80.02, District of Columbia, District of Columbia",69,13,53,0,1,0,0,2,69,69,13,53,0,1,0,0,2,0,0,0,0,0,0,0,0,110010080021001,1,108,108,1,psa_17,1D2
1000000US110010072002031,"Block 2031, Block Group 2, Census Tract 72, District of Columbia, District of Columbia",0,0,0,0,0,0,0,0,0,0,0,0,0,0,0,0,0,0,0,0,0,0,0,0,0,110010072002031,1,106,106,1,psa_13,1D3
1000000US110010076015021,"Block 5021, Block Group 5, Census Tract 76.01, District of Columbia, District of Columbia",43,0,43,0,0,0,0,0,43,41,0,41,0,0,0,0,0,2,0,2,0,0,0,0,0,110010076015021,6,607,607,6,psa_10,6D2
1000000US110010088024002,"Block 4002, Block Group 4, Census Tract 88.02, District of Columbia, District of Columbia",157,17,131,0,4,0,3,2,157,142,8,129,0,4,0,0,1,15,9,2,0,0,0,3,1,110010088024002,5,506,506,5,psa_26,5D3
1000000US110010023021010,"Block 1010, Block Group 1, Census Tract 23.02, District of Columbia, District of Columbia",0,0,0,0,0,0,0,0,0,0,0,0,0,0,0,0,0,0,0,0,0,0,0,0,0,110010023021010,4,405,405,4,psa_49,4D2
1000000US110010029001006,"Block 1006, Block Group 1, Census Tract 29, District of Columbia, District of Columbia",70,23,44,0,0,1,0,2,70,67,22,42,0,0,1,0,2,3,1,2,0,0,0,0,0,110010029001006,3,302,302,3,psa_42,3D1
1000000US110010095041000,"Block 1000, Block Group 1, Census Tract 95.04, District of Columbia, District of Columbia",49,11,34,0,3,0,0,1,49,49,11,34,0,3,0,0,1,0,0,0,0,0,0,0,0,110010095041000,4,405,405,4,psa_49,4D2
1000000US110010078041007,"Block 1007, Block Group 1, Census Tract 78.04, District of Columbia, District of Columbia",0,0,0,0,0,0,0,0,0,0,0,0,0,0,0,0,0,0,0,0,0,0,0,0,0,110010078041007,6,602,602,6,psa_25,6D1
1000000US110010002022001,"Block 2001, Block Group 2, Census Tract 2.02, District of Columbia, District of Columbia",31,27,0,0,3,0,1,0,31,29,26,0,0,3,0,0,0,2,1,0,0,0,0,1,0,110010002022001,2,206,206,2,psa_29,2D2
1000000US110010073041011,"Block 1011, Block Group 1, Census Tract 73.04, District of Columbia, District of Columbia",0,0,0,0,0,0,0,0,0,0,0,0,0,0,0,0,0,0,0,0,0,0,0,0,0,110010073041011,7,705,705,7,psa_3,7D2
1000000US110010021011001,"Block 1001, Block Group 1, Census Tract 21.01, District of Columbia, District of Columbia",0,0,0,0,0,0,0,0,0,0,0,0,0,0,0,0,0,0,0,0,0,0,0,0,0,110010021011001,4,403,403,4,psa_51,4D1
1000000US110010044001010,"Block 1010, Block Group 1, Census Tract 44, District of Columbia, District of Columbia",90,65,11,0,5,0,4,5,90,77,57,10,0,5,0,0,5,13,8,1,0,0,0,4,0,110010044001010,3,305,305,3,psa_32,3D2
1000000US110010033013001,"Block 3001, Block Group 3, Census Tract 33.01, District of Columbia, District of Columbia",147,25,110,0,4,0,3,5,147,139,21,109,0,4,0,1,4,8,4,1,0,0,0,2,1,110010033013001,3,306,306,3,psa_38,3D2
1000000US110010073011092,"Block 1092, Block Group 1, Census Tract 73.01, District of Columbia, District of Columbia",0,0,0,0,0,0,0,0,0,0,0,0,0,0,0,0,0,0,0,0,0,0,0,0,0,110010073011092,7,708,708,7,psa_1,7D3
1000000US110010095041022,"Block 1022, Block Group 1, Census Tract 95.04, District of Columbia, District of Columbia",0,0,0,0,0,0,0,0,0,0,0,0,0,0,0,0,0,0,0,0,0,0,0,0,0,110010095041022,4,405,405,4,psa_49,4D2
1000000US110010093011001,"Block 1001, Block Group 1, Census Tract 93.01, District of Columbia, District of Columbia",44,15,29,0,0,0,0,0,44,43,14,29,0,0,0,0,0,1,1,0,0,0,0,0,0,110010093011001,5,504,504,5,psa_43,5D2
1000000US110010027012006,"Block 2006, Block Group 2, Census Tract 27.01, District of Columbia, District of Columbia",492,307,83,1,38,0,33,30,492,412,268,81,1,38,0,0,24,80,39,2,0,0,0,33,6,110010027012006,3,302,302,3,psa_42,3D1
1000000US110010055002002,"Block 2002, Block Group 2, Census Tract 55, District of Columbia, District of Columbia",193,141,10,0,30,0,3,9,193,181,131,10,0,30,0,1,9,12,10,0,0,0,0,2,0,110010055002002,2,207,207,2,psa_24,2D3
1000000US110010090001001,"Block 1001, Block Group 1, Census Tract 90, District of Columbia, District of Columbia",436,13,420,3,0,0,0,0,436,430,11,416,3,0,0,0,0,6,2,4,0,0,0,0,0,110010090001001,5,503,503,5,psa_45,5D2
1000000US110010015001025,"Block 1025, Block Group 1, Census Tract 15, District of Columbia, District of Columbia",31,27,1,0,2,0,1,0,31,30,27,1,0,2,0,0,0,1,0,0,0,0,0,1,0,110010015001025,2,201,201,2,psa_55,2D1
1000000US110010062021178,"Block 1178, Block Group 1, Census Tract 62.02, District of Columbia, District of Columbia",0,0,0,0,0,0,0,0,0,0,0,0,0,0,0,0,0,0,0,0,0,0,0,0,0,110010062021178,2,207,207,2,psa_24,2D3
1000000US110010070002007,"Block 2007, Block Group 2, Census Tract 70, District of Columbia, District of Columbia",0,0,0,0,0,0,0,0,0,0,0,0,0,0,0,0,0,0,0,0,0,0,0,0,0,110010070002007,1,107,107,1,psa_16,1D2
1000000US110010101002007,"Block 2007, Block Group 2, Census Tract 101, District of Columbia, District of Columbia",0,0,0,0,0,0,0,0,0,0,0,0,0,0,0,0,0,0,0,0,0,0,0,0,0,110010101002007,2,207,207,2,psa_24,2D3
1000000US110010073011068,"Block 1068, Block Group 1, Census Tract 73.01, District of Columbia, District of Columbia",0,0,0,0,0,0,0,0,0,0,0,0,0,0,0,0,0,0,0,0,0,0,0,0,0,110010073011068,7,707,707,7,psa_4,7D2
1000000US110010009013005,"Block 3005, Block Group 3, Census Tract 9.01, District of Columbia, District of Columbia",56,45,1,0,3,0,2,5,56,52,41,1,0,3,0,2,5,4,4,0,0,0,0,0,0,110010009013005,2,205,205,2,psa_46,2D2
1000000US110010058001003,"Block 1003, Block Group 1, Census Tract 58, District of Columbia, District of Columbia",4,0,0,0,4,0,0,0,4,4,0,0,0,4,0,0,0,0,0,0,0,0,0,0,0,110010058001003,1,101,101,1,psa_20,1D1
1000000US110010011004008,"Block 4008, Block Group 4, Census Tract 11, District of Columbia, District of Columbia",0,0,0,0,0,0,0,0,0,0,0,0,0,0,0,0,0,0,0,0,0,0,0,0,0,110010011004008,2,202,202,2,psa_52,2D1
1000000US110010014023002,"Block 3002, Block Group 3, Census Tract 14.02, District of Columbia, District of Columbia",36,35,0,0,0,0,1,0,36,35,35,0,0,0,0,0,0,1,0,0,0,0,0,1,0,110010014023002,2,201,201,2,psa_55,2D1
1000000US110010014023006,"Block 3006, Block Group 3, Census Tract 14.02, District of Columbia, District of Columbia",70,58,2,0,8,0,0,2,70,66,54,2,0,8,0,0,2,4,4,0,0,0,0,0,0,110010014023006,2,201,201,2,psa_55,2D1
1000000US110010101002000,"Block 2000, Block Group 2, Census Tract 101, District of Columbia, District of Columbia",0,0,0,0,0,0,0,0,0,0,0,0,0,0,0,0,0,0,0,0,0,0,0,0,0,110010101002000,2,208,208,2,psa_33,2D3
1000000US110010062021210,"Block 1210, Block Group 1, Census Tract 62.02, District of Columbia, District of Columbia",0,0,0,0,0,0,0,0,0,0,0,0,0,0,0,0,0,0,0,0,0,0,0,0,0,110010062021210,1,103,103,1,psa_12,1D1
1000000US110010034002010,"Block 2010, Block Group 2, Census Tract 34, District of Columbia, District of Columbia",0,0,0,0,0,0,0,0,0,0,0,0,0,0,0,0,0,0,0,0,0,0,0,0,0,110010034002010,3,306,306,3,psa_38,3D2
1000000US110010094002009,"Block 2009, Block Group 2, Census Tract 94, District of Columbia, District of Columbia",42,8,32,0,0,0,2,0,42,42,8,32,0,0,0,2,0,0,0,0,0,0,0,0,0,110010094002009,5,503,503,5,psa_45,5D2
1000000US110010102002017,"Block 2017, Block Group 2, Census Tract 102, District of Columbia, District of Columbia",0,0,0,0,0,0,0,0,0,0,0,0,0,0,0,0,0,0,0,0,0,0,0,0,0,110010102002017,1,103,103,1,psa_12,1D1
1000000US110010076042002,"Block 2002, Block Group 2, Census Tract 76.04, District of Columbia, District of Columbia",0,0,0,0,0,0,0,0,0,0,0,0,0,0,0,0,0,0,0,0,0,0,0,0,0,110010076042002,6,607,607,6,psa_10,6D2
1000000US110010083021013,"Block 1013, Block Group 1, Census Tract 83.02, District of Columbia, District of Columbia",54,52,1,1,0,0,0,0,54,53,51,1,1,0,0,0,0,1,1,0,0,0,0,0,0,110010083021013,1,108,108,1,psa_17,1D2
1000000US110010001004032,"Block 4032, Block Group 4, Census Tract 1, District of Columbia, District of Columbia",0,0,0,0,0,0,0,0,0,0,0,0,0,0,0,0,0,0,0,0,0,0,0,0,0,110010001004032,2,206,206,2,psa_29,2D2
1000000US110010074092001,"Block 2001, Block Group 2, Census Tract 74.09, District of Columbia, District of Columbia",487,0,484,1,0,0,0,2,487,484,0,481,1,0,0,0,2,3,0,3,0,0,0,0,0,110010074092001,7,704,704,7,psa_5,7D2
1000000US110010083011000,"Block 1000, Block Group 1, Census Tract 83.01, District of Columbia, District of Columbia",123,63,43,1,5,0,6,5,123,114,60,43,1,5,0,0,5,9,3,0,0,0,0,6,0,110010083011000,1,104,104,1,psa_21,1D2
1000000US110010050012000,"Block 2000, Block Group 2, Census Tract 50.01, District of Columbia, District of Columbia",233,79,119,0,2,0,26,7,233,184,63,115,0,2,0,1,3,49,16,4,0,0,0,25,4,110010050012000,3,307,307,3,psa_28,3D3
1000000US110010073041006,"Block 1006, Block Group 1, Census Tract 73.04, District of Columbia, District of Columbia",564,1,563,0,0,0,0,0,564,557,1,556,0,0,0,0,0,7,0,7,0,0,0,0,0,110010073041006,7,705,705,7,psa_3,7D2
1000000US110010106002018,"Block 2018, Block Group 2, Census Tract 106, District of Columbia, District of Columbia",0,0,0,0,0,0,0,0,0,0,0,0,0,0,0,0,0,0,0,0,0,0,0,0,0,110010106002018,5,501,501,5,psa_35,5D1
1000000US110010106002026,"Block 2026, Block Group 2, Census Tract 106, District of Columbia, District of Columbia",0,0,0,0,0,0,0,0,0,0,0,0,0,0,0,0,0,0,0,0,0,0,0,0,0,110010106002026,5,501,501,5,psa_35,5D1
1000000US110010025023001,"Block 3001, Block Group 3, Census Tract 25.02, District of Columbia, District of Columbia",273,80,118,0,4,0,51,20,273,174,54,107,0,4,0,1,8,99,26,11,0,0,0,50,12,110010025023001,4,404,404,4,psa_48,4D3
1000000US110010079011002,"Block 1002, Block Group 1, Census Tract 79.01, District of Columbia, District of Columbia",115,5,98,0,1,0,8,3,115,103,1,98,0,1,0,0,3,12,4,0,0,0,0,8,0,110010079011002,5,507,507,5,psa_23,5D3
1000000US110010073011122,"Block 1122, Block Group 1, Census Tract 73.01, District of Columbia, District of Columbia",0,0,0,0,0,0,0,0,0,0,0,0,0,0,0,0,0,0,0,0,0,0,0,0,0,110010073011122,7,708,708,7,psa_1,7D3
1000000US110010077082018,"Block 2018, Block Group 2, Census Tract 77.08, District of Columbia, District of Columbia",0,0,0,0,0,0,0,0,0,0,0,0,0,0,0,0,0,0,0,0,0,0,0,0,0,110010077082018,6,603,603,6,psa_15,6D3
1000000US110010091021013,"Block 1013, Block Group 1, Census Tract 91.02, District of Columbia, District of Columbia",50,2,39,0,0,0,7,2,50,43,2,39,0,0,0,0,2,7,0,0,0,0,0,7,0,110010091021013,5,505,505,5,psa_34,5D2
1000000US110010006004015,"Block 4015, Block Group 4, Census Tract 6, District of Columbia, District of Columbia",65,60,0,0,2,0,0,3,65,64,59,0,0,2,0,0,3,1,1,0,0,0,0,0,0,110010006004015,2,203,203,2,psa_50,2D1
1000000US110010077091002,"Block 1002, Block Group 1, Census Tract 77.09, District of Columbia, District of Columbia",0,0,0,0,0,0,0,0,0,0,0,0,0,0,0,0,0,0,0,0,0,0,0,0,0,110010077091002,6,605,605,6,psa_11,6D2
1000000US110010093013000,"Block 3000, Block Group 3, Census Tract 93.01, District of Columbia, District of Columbia",52,3,49,0,0,0,0,0,52,52,3,49,0,0,0,0,0,0,0,0,0,0,0,0,0,110010093013000,5,504,504,5,psa_43,5D2
1000000US110010095013001,"Block 3001, Block Group 3, Census Tract 95.01, District of Columbia, District of Columbia",70,1,67,0,0,0,0,2,70,69,1,66,0,0,0,0,2,1,0,1,0,0,0,0,0,110010095013001,4,405,405,4,psa_49,4D2
1000000US110010050011001,"Block 1001, Block Group 1, Census Tract 50.01, District of Columbia, District of Columbia",28,22,5,0,1,0,0,0,28,27,21,5,0,1,0,0,0,1,1,0,0,0,0,0,0,110010050011001,3,307,307,3,psa_28,3D3
1000000US110010062021105,"Block 1105, Block Group 1, Census Tract 62.02, District of Columbia, District of Columbia",0,0,0,0,0,0,0,0,0,0,0,0,0,0,0,0,0,0,0,0,0,0,0,0,0,110010062021105,1,102,102,1,psa_18,1D1
1000000US110010073011139,"Block 1139, Block Group 1, Census Tract 73.01, District of Columbia, District of Columbia",0,0,0,0,0,0,0,0,0,0,0,0,0,0,0,0,0,0,0,0,0,0,0,0,0,110010073011139,7,707,707,7,psa_4,7D2
1000000US110010029002010,"Block 2010, Block Group 2, Census Tract 29, District of Columbia, District of Columbia",176,107,45,2,6,0,7,9,176,152,96,43,0,6,0,0,7,24,11,2,2,0,0,7,2,110010029002010,3,302,302,3,psa_42,3D1
1000000US110010074092003,"Block 2003, Block Group 2, Census Tract 74.09, District of Columbia, District of Columbia",107,0,107,0,0,0,0,0,107,107,0,107,0,0,0,0,0,0,0,0,0,0,0,0,0,110010074092003,7,704,704,7,psa_5,7D2
1000000US110010077072014,"Block 2014, Block Group 2, Census Tract 77.07, District of Columbia, District of Columbia",73,0,67,6,0,0,0,0,73,68,0,63,5,0,0,0,0,5,0,4,1,0,0,0,0,110010077072014,6,604,604,6,psa_14,6D3
1000000US110010091021002,"Block 1002, Block Group 1, Census Tract 91.02, District of Columbia, District of Columbia",17,0,17,0,0,0,0,0,17,17,0,17,0,0,0,0,0,0,0,0,0,0,0,0,0,110010091021002,5,505,505,5,psa_34,5D2
1000000US110010106002011,"Block 2011, Block Group 2, Census Tract 106, District of Columbia, District of Columbia",10,3,7,0,0,0,0,0,10,10,3,7,0,0,0,0,0,0,0,0,0,0,0,0,0,110010106002011,5,501,501,5,psa_35,5D1
1000000US110010084101002,"Block 1002, Block Group 1, Census Tract 84.10, District of Columbia, District of Columbia",135,51,66,1,5,0,3,9,135,129,48,66,1,5,0,0,9,6,3,0,0,0,0,3,0,110010084101002,1,104,104,1,psa_21,1D2
1000000US110010003004009,"Block 4009, Block Group 4, Census Tract 3, District of Columbia, District of Columbia",137,120,2,0,11,0,0,4,137,133,116,2,0,11,0,0,4,4,4,0,0,0,0,0,0,110010003004009,2,204,204,2,psa_44,2D2
1000000US110010011002010,"Block 2010, Block Group 2, Census Tract 11, District of Columbia, District of Columbia",82,78,1,0,0,0,1,2,82,76,73,1,0,0,0,0,2,6,5,0,0,0,0,1,0,110010011002010,2,202,202,2,psa_52,2D1
1000000US110010099012001,"Block 2001, Block Group 2, Census Tract 99.01, District of Columbia, District of Columbia",0,0,0,0,0,0,0,0,0,0,0,0,0,0,0,0,0,0,0,0,0,0,0,0,0,110010099012001,6,605,605,6,psa_11,6D2
1000000US110010029002006,"Block 2006, Block Group 2, Census Tract 29, District of Columbia, District of Columbia",113,38,55,0,3,0,11,6,113,91,31,55,0,3,0,1,1,22,7,0,0,0,0,10,5,110010029002006,4,408,408,4,psa_39,4D3
1000000US110010070002006,"Block 2006, Block Group 2, Census Tract 70, District of Columbia, District of Columbia",25,18,4,0,3,0,0,0,25,25,18,4,0,3,0,0,0,0,0,0,0,0,0,0,0,110010070002006,1,106,106,1,psa_13,1D3
1000000US110010103001005,"Block 1005, Block Group 1, Census Tract 103, District of Columbia, District of Columbia",0,0,0,0,0,0,0,0,0,0,0,0,0,0,0,0,0,0,0,0,0,0,0,0,0,110010103001005,4,401,401,4,psa_56,4D1
1000000US110010002023000,"Block 3000, Block Group 3, Census Tract 2.02, District of Columbia, District of Columbia",88,75,1,0,11,0,0,1,88,81,69,1,0,10,0,0,1,7,6,0,0,1,0,0,0,110010002023000,2,206,206,2,psa_29,2D2
1000000US110010059001041,"Block 1041, Block Group 1, Census Tract 59, District of Columbia, District of Columbia",117,98,10,0,4,0,2,3,117,115,97,10,0,4,0,2,2,2,1,0,0,0,0,0,1,110010059001041,1,102,102,1,psa_18,1D1
1000000US110010001002003,"Block 2003, Block Group 2, Census Tract 1, District of Columbia, District of Columbia",56,50,2,0,4,0,0,0,56,55,49,2,0,4,0,0,0,1,1,0,0,0,0,0,0,110010001002003,2,206,206,2,psa_29,2D2
1000000US110010027021003,"Block 1003, Block Group 1, Census Tract 27.02, District of Columbia, District of Columbia",0,0,0,0,0,0,0,0,0,0,0,0,0,0,0,0,0,0,0,0,0,0,0,0,0,110010027021003,3,302,302,3,psa_42,3D1
1000000US110010023021000,"Block 1000, Block Group 1, Census Tract 23.02, District of Columbia, District of Columbia",0,0,0,0,0,0,0,0,0,0,0,0,0,0,0,0,0,0,0,0,0,0,0,0,0,110010023021000,4,405,405,4,psa_49,4D2
1000000US110010062021102,"Block 1102, Block Group 1, Census Tract 62.02, District of Columbia, District of Columbia",0,0,0,0,0,0,0,0,0,0,0,0,0,0,0,0,0,0,0,0,0,0,0,0,0,110010062021102,1,103,103,1,psa_12,1D1
1000000US110010096021022,"Block 1022, Block Group 1, Census Tract 96.02, District of Columbia, District of Columbia",0,0,0,0,0,0,0,0,0,0,0,0,0,0,0,0,0,0,0,0,0,0,0,0,0,110010096021022,6,601,601,6,psa_30,6D1
1000000US110010014012003,"Block 2003, Block Group 2, Census Tract 14.01, District of Columbia, District of Columbia",5,5,0,0,0,0,0,0,5,5,5,0,0,0,0,0,0,0,0,0,0,0,0,0,0,110010014012003,2,201,201,2,psa_55,2D1
1000000US110010019014011,"Block 4011, Block Group 4, Census Tract 19.01, District of Columbia, District of Columbia",99,16,74,0,3,0,6,0,99,87,10,74,0,3,0,0,0,12,6,0,0,0,0,6,0,110010019014011,4,402,402,4,psa_53,4D1
1000000US110010083021012,"Block 1012, Block Group 1, Census Tract 83.02, District of Columbia, District of Columbia",0,0,0,0,0,0,0,0,0,0,0,0,0,0,0,0,0,0,0,0,0,0,0,0,0,110010083021012,1,108,108,1,psa_17,1D2
1000000US110010055002006,"Block 2006, Block Group 2, Census Tract 55, District of Columbia, District of Columbia",0,0,0,0,0,0,0,0,0,0,0,0,0,0,0,0,0,0,0,0,0,0,0,0,0,110010055002006,2,207,207,2,psa_24,2D3
1000000US110010099052008,"Block 2008, Block Group 2, Census Tract 99.05, District of Columbia, District of Columbia",0,0,0,0,0,0,0,0,0,0,0,0,0,0,0,0,0,0,0,0,0,0,0,0,0,110010099052008,6,604,604,6,psa_14,6D3
1000000US110010109002007,"Block 2007, Block Group 2, Census Tract 109, District of Columbia, District of Columbia",0,0,0,0,0,0,0,0,0,0,0,0,0,0,0,0,0,0,0,0,0,0,0,0,0,110010109002007,7,708,708,7,psa_1,7D3
1000000US110010111002031,"Block 2031, Block Group 2, Census Tract 111, District of Columbia, District of Columbia",10,0,10,0,0,0,0,0,10,10,0,10,0,0,0,0,0,0,0,0,0,0,0,0,0,110010111002031,5,503,503,5,psa_45,5D2
1000000US110010016004024,"Block 4024, Block Group 4, Census Tract 16, District of Columbia, District of Columbia",58,12,44,0,0,0,0,2,58,49,11,36,0,0,0,0,2,9,1,8,0,0,0,0,0,110010016004024,4,401,401,4,psa_56,4D1
1000000US110010024002015,"Block 2015, Block Group 2, Census Tract 24, District of Columbia, District of Columbia",39,9,30,0,0,0,0,0,39,36,6,30,0,0,0,0,0,3,3,0,0,0,0,0,0,110010024002015,4,407,407,4,psa_47,4D2
1000000US110010066001003,"Block 1003, Block Group 1, Census Tract 66, District of Columbia, District of Columbia",117,117,0,0,0,0,0,0,117,116,116,0,0,0,0,0,0,1,1,0,0,0,0,0,0,110010066001003,1,107,107,1,psa_16,1D2
1000000US110010102002031,"Block 2031, Block Group 2, Census Tract 102, District of Columbia, District of Columbia",0,0,0,0,0,0,0,0,0,0,0,0,0,0,0,0,0,0,0,0,0,0,0,0,0,110010102002031,1,103,103,1,psa_12,1D1
1000000US110010019022009,"Block 2009, Block Group 2, Census Tract 19.02, District of Columbia, District of Columbia",78,18,41,0,2,0,17,0,78,53,10,41,0,2,0,0,0,25,8,0,0,0,0,17,0,110010019022009,4,406,406,4,psa_54,4D2
1000000US110010078042011,"Block 2011, Block Group 2, Census Tract 78.04, District of Columbia, District of Columbia",141,0,141,0,0,0,0,0,141,140,0,140,0,0,0,0,0,1,0,1,0,0,0,0,0,110010078042011,6,602,602,6,psa_25,6D1
1000000US110010084021000,"Block 1000, Block Group 1, Census Tract 84.02, District of Columbia, District of Columbia",6,0,6,0,0,0,0,0,6,6,0,6,0,0,0,0,0,0,0,0,0,0,0,0,0,110010084021000,1,104,104,1,psa_21,1D2
1000000US110010095042010,"Block 2010, Block Group 2, Census Tract 95.04, District of Columbia, District of Columbia",58,11,47,0,0,0,0,0,58,56,9,47,0,0,0,0,0,2,2,0,0,0,0,0,0,110010095042010,4,405,405,4,psa_49,4D2
1000000US110010008022016,"Block 2016, Block Group 2, Census Tract 8.02, District of Columbia, District of Columbia",81,74,0,1,5,0,0,1,81,72,66,0,0,5,0,0,1,9,8,0,1,0,0,0,0,110010008022016,2,205,205,2,psa_46,2D2
1000000US110010023021007,"Block 1007, Block Group 1, Census Tract 23.02, District of Columbia, District of Columbia",6,5,0,0,0,0,1,0,6,4,4,0,0,0,0,0,0,2,1,0,0,0,0,1,0,110010023021007,4,405,405,4,psa_49,4D2
1000000US110010021013001,"Block 3001, Block Group 3, Census Tract 21.01, District of Columbia, District of Columbia",203,18,149,0,0,0,25,11,203,160,13,144,0,0,0,0,3,43,5,5,0,0,0,25,8,110010021013001,4,403,403,4,psa_51,4D1
1000000US110010083021015,"Block 1015, Block Group 1, Census Tract 83.02, District of Columbia, District of Columbia",144,127,8,0,6,0,0,3,144,139,122,8,0,6,0,0,3,5,5,0,0,0,0,0,0,110010083021015,1,108,108,1,psa_17,1D2
1000000US110010073011095,"Block 1095, Block Group 1, Census Tract 73.01, District of Columbia, District of Columbia",0,0,0,0,0,0,0,0,0,0,0,0,0,0,0,0,0,0,0,0,0,0,0,0,0,110010073011095,7,707,707,7,psa_4,7D2
1000000US110010038003005,"Block 3005, Block Group 3, Census Tract 38, District of Columbia, District of Columbia",123,95,4,0,13,0,9,2,123,104,86,3,0,12,0,1,2,19,9,1,0,1,0,8,0,110010038003005,3,303,303,3,psa_37,3D3
1000000US110010078031008,"Block 1008, Block Group 1, Census Tract 78.03, District of Columbia, District of Columbia",103,2,94,0,0,0,7,0,103,96,2,94,0,0,0,0,0,7,0,0,0,0,0,7,0,110010078031008,6,602,602,6,psa_25,6D1
1000000US110010022011011,"Block 1011, Block Group 1, Census Tract 22.01, District of Columbia, District of Columbia",41,5,36,0,0,0,0,0,41,41,5,36,0,0,0,0,0,0,0,0,0,0,0,0,0,110010022011011,4,407,407,4,psa_47,4D2
1000000US110010019021008,"Block 1008, Block Group 1, Census Tract 19.02, District of Columbia, District of Columbia",0,0,0,0,0,0,0,0,0,0,0,0,0,0,0,0,0,0,0,0,0,0,0,0,0,110010019021008,4,406,406,4,psa_54,4D2
1000000US110010035002004,"Block 2004, Block Group 2, Census Tract 35, District of Columbia, District of Columbia",828,64,713,3,12,0,2,34,828,802,59,698,3,12,0,0,30,26,5,15,0,0,0,2,4,110010035002004,3,305,305,3,psa_32,3D2
1000000US110010041003020,"Block 3020, Block Group 3, Census Tract 41, District of Columbia, District of Columbia",67,57,4,0,1,0,4,1,67,52,47,4,0,1,0,0,0,15,10,0,0,0,0,4,1,110010041003020,2,208,208,2,psa_33,2D3
1000000US110010084101016,"Block 1016, Block Group 1, Census Tract 84.10, District of Columbia, District of Columbia",75,34,38,0,1,0,1,1,75,73,33,38,0,1,0,0,1,2,1,0,0,0,0,1,0,110010084101016,1,104,104,1,psa_21,1D2
1000000US110010083021005,"Block 1005, Block Group 1, Census Tract 83.02, District of Columbia, District of Columbia",162,126,19,1,6,1,2,7,162,154,118,19,1,6,1,2,7,8,8,0,0,0,0,0,0,110010083021005,1,104,104,1,psa_21,1D2
1000000US110010093013021,"Block 3021, Block Group 3, Census Tract 93.01, District of Columbia, District of Columbia",0,0,0,0,0,0,0,0,0,0,0,0,0,0,0,0,0,0,0,0,0,0,0,0,0,110010093013021,5,504,504,5,psa_43,5D2
1000000US110010106002040,"Block 2040, Block Group 2, Census Tract 106, District of Columbia, District of Columbia",0,0,0,0,0,0,0,0,0,0,0,0,0,0,0,0,0,0,0,0,0,0,0,0,0,110010106002040,1,102,102,1,psa_18,1D1
1000000US110010019011009,"Block 1009, Block Group 1, Census Tract 19.01, District of Columbia, District of Columbia",12,0,10,0,0,0,0,2,12,11,0,9,0,0,0,0,2,1,0,1,0,0,0,0,0,110010019011009,4,402,402,4,psa_53,4D1
1000000US110010098101002,"Block 1002, Block Group 1, Census Tract 98.10, District of Columbia, District of Columbia",0,0,0,0,0,0,0,0,0,0,0,0,0,0,0,0,0,0,0,0,0,0,0,0,0,110010098101002,7,708,708,7,psa_1,7D3
1000000US110010010023007,"Block 3007, Block Group 3, Census Tract 10.02, District of Columbia, District of Columbia",0,0,0,0,0,0,0,0,0,0,0,0,0,0,0,0,0,0,0,0,0,0,0,0,0,110010010023007,2,204,204,2,psa_44,2D2
1000000US110010073011070,"Block 1070, Block Group 1, Census Tract 73.01, District of Columbia, District of Columbia",0,0,0,0,0,0,0,0,0,0,0,0,0,0,0,0,0,0,0,0,0,0,0,0,0,110010073011070,7,707,707,7,psa_4,7D2
1000000US110010009011015,"Block 1015, Block Group 1, Census Tract 9.01, District of Columbia, District of Columbia",39,22,10,0,0,0,0,7,39,36,20,10,0,0,0,0,6,3,2,0,0,0,0,0,1,110010009011015,2,205,205,2,psa_46,2D2
1000000US110010068041001,"Block 1001, Block Group 1, Census Tract 68.04, District of Columbia, District of Columbia",0,0,0,0,0,0,0,0,0,0,0,0,0,0,0,0,0,0,0,0,0,0,0,0,0,110010068041001,5,507,507,5,psa_23,5D3
1000000US110010080022002,"Block 2002, Block Group 2, Census Tract 80.02, District of Columbia, District of Columbia",97,21,72,2,2,0,0,0,97,95,20,72,1,2,0,0,0,2,1,0,1,0,0,0,0,110010080022002,1,108,108,1,psa_17,1D2
1000000US110010109002004,"Block 2004, Block Group 2, Census Tract 109, District of Columbia, District of Columbia",434,2,421,0,3,0,0,8,434,426,1,417,0,3,0,0,5,8,1,4,0,0,0,0,3,110010109002004,7,708,708,7,psa_1,7D3
1000000US110010017022016,"Block 2016, Block Group 2, Census Tract 17.02, District of Columbia, District of Columbia",113,8,95,0,0,0,0,10,113,103,7,95,0,0,0,0,1,10,1,0,0,0,0,0,9,110010017022016,4,406,406,4,psa_54,4D2
1000000US110010053013001,"Block 3001, Block Group 3, Census Tract 53.01, District of Columbia, District of Columbia",1102,856,51,1,137,2,21,34,1102,986,770,48,0,136,1,5,26,116,86,3,1,1,1,16,8,110010053013001,2,208,208,2,psa_33,2D3
1000000US110010073043005,"Block 3005, Block Group 3, Census Tract 73.04, District of Columbia, District of Columbia",7,0,7,0,0,0,0,0,7,7,0,7,0,0,0,0,0,0,0,0,0,0,0,0,0,110010073043005,7,705,705,7,psa_3,7D2
1000000US110010076051003,"Block 1003, Block Group 1, Census Tract 76.05, District of Columbia, District of Columbia",0,0,0,0,0,0,0,0,0,0,0,0,0,0,0,0,0,0,0,0,0,0,0,0,0,110010076051003,6,607,607,6,psa_10,6D2
1000000US110010073011105,"Block 1105, Block Group 1, Census Tract 73.01, District of Columbia, District of Columbia",0,0,0,0,0,0,0,0,0,0,0,0,0,0,0,0,0,0,0,0,0,0,0,0,0,110010073011105,7,708,708,7,psa_1,7D3
1000000US110010088042008,"Block 2008, Block Group 2, Census Tract 88.04, District of Columbia, District of Columbia",104,0,97,0,0,0,3,4,104,103,0,97,0,0,0,2,4,1,0,0,0,0,0,1,0,110010088042008,5,506,506,5,psa_26,5D3
1000000US110010098071014,"Block 1014, Block Group 1, Census Tract 98.07, District of Columbia, District of Columbia",100,0,97,0,3,0,0,0,100,100,0,97,0,3,0,0,0,0,0,0,0,0,0,0,0,110010098071014,7,708,708,7,psa_1,7D3
1000000US110010026002005,"Block 2005, Block Group 2, Census Tract 26, District of Columbia, District of Columbia",0,0,0,0,0,0,0,0,0,0,0,0,0,0,0,0,0,0,0,0,0,0,0,0,0,110010026002005,4,403,403,4,psa_51,4D1
1000000US110010073011053,"Block 1053, Block Group 1, Census Tract 73.01, District of Columbia, District of Columbia",0,0,0,0,0,0,0,0,0,0,0,0,0,0,0,0,0,0,0,0,0,0,0,0,0,110010073011053,7,708,708,7,psa_1,7D3
1000000US110010108003009,"Block 3009, Block Group 3, Census Tract 108.00, District of Columbia, District of Columbia",0,0,0,0,0,0,0,0,0,0,0,0,0,0,0,0,0,0,0,0,0,0,0,0,0,110010108003009,2,207,207,2,psa_24,2D3
1000000US110010021014007,"Block 4007, Block Group 4, Census Tract 21.01, District of Columbia, District of Columbia",0,0,0,0,0,0,0,0,0,0,0,0,0,0,0,0,0,0,0,0,0,0,0,0,0,110010021014007,4,403,403,4,psa_51,4D1
1000000US110010076031003,"Block 1003, Block Group 1, Census Tract 76.03, District of Columbia, District of Columbia",114,0,108,0,0,0,0,6,114,114,0,108,0,0,0,0,6,0,0,0,0,0,0,0,0,110010076031003,6,606,606,6,psa_7,6D2
1000000US110010023021005,"Block 1005, Block Group 1, Census Tract 23.02, District of Columbia, District of Columbia",0,0,0,0,0,0,0,0,0,0,0,0,0,0,0,0,0,0,0,0,0,0,0,0,0,110010023021005,4,405,405,4,psa_49,4D2
1000000US110010098102001,"Block 2001, Block Group 2, Census Tract 98.10, District of Columbia, District of Columbia",80,2,74,0,0,0,2,2,80,77,2,74,0,0,0,0,1,3,0,0,0,0,0,2,1,110010098102001,7,708,708,7,psa_1,7D3
1000000US110010058002006,"Block 2006, Block Group 2, Census Tract 58, District of Columbia, District of Columbia",3,0,3,0,0,0,0,0,3,3,0,3,0,0,0,0,0,0,0,0,0,0,0,0,0,110010058002006,1,101,101,1,psa_20,1D1
1000000US110010009013027,"Block 3027, Block Group 3, Census Tract 9.01, District of Columbia, District of Columbia",43,38,2,0,2,0,0,1,43,40,37,0,0,2,0,0,1,3,1,2,0,0,0,0,0,110010009013027,2,205,205,2,psa_46,2D2
1000000US110010093013006,"Block 3006, Block Group 3, Census Tract 93.01, District of Columbia, District of Columbia",76,30,34,1,2,0,4,5,76,63,25,34,1,2,0,0,1,13,5,0,0,0,0,4,4,110010093013006,5,504,504,5,psa_43,5D2
1000000US110010099021011,"Block 1011, Block Group 1, Census Tract 99.02, District of Columbia, District of Columbia",45,0,41,1,0,0,0,3,45,44,0,40,1,0,0,0,3,1,0,1,0,0,0,0,0,110010099021011,6,605,605,6,psa_11,6D2
1000000US110010101001020,"Block 1020, Block Group 1, Census Tract 101, District of Columbia, District of Columbia",0,0,0,0,0,0,0,0,0,0,0,0,0,0,0,0,0,0,0,0,0,0,0,0,0,110010101001020,2,209,209,2,psa_57,2D3
1000000US110010082002000,"Block 2000, Block Group 2, Census Tract 82, District of Columbia, District of Columbia",41,32,4,0,0,0,2,3,41,36,31,4,0,0,0,0,1,5,1,0,0,0,0,2,2,110010082002000,1,108,108,1,psa_17,1D2
1000000US110010091021003,"Block 1003, Block Group 1, Census Tract 91.02, District of Columbia, District of Columbia",55,3,52,0,0,0,0,0,55,55,3,52,0,0,0,0,0,0,0,0,0,0,0,0,0,110010091021003,5,505,505,5,psa_34,5D2
1000000US110010053012004,"Block 2004, Block Group 2, Census Tract 53.01, District of Columbia, District of Columbia",417,336,16,2,36,0,8,19,417,392,319,16,2,36,0,1,18,25,17,0,0,0,0,7,1,110010053012004,2,208,208,2,psa_33,2D3
1000000US110010076013012,"Block 3012, Block Group 3, Census Tract 76.01, District of Columbia, District of Columbia",57,26,29,1,0,0,0,1,57,57,26,29,1,0,0,0,1,0,0,0,0,0,0,0,0,110010076013012,6,607,607,6,psa_10,6D2
1000000US110010080022001,"Block 2001, Block Group 2, Census Tract 80.02, District of Columbia, District of Columbia",86,25,57,0,0,0,0,4,86,85,24,57,0,0,0,0,4,1,1,0,0,0,0,0,0,110010080022001,1,108,108,1,psa_17,1D2
1000000US110010088031009,"Block 1009, Block Group 1, Census Tract 88.03, District of Columbia, District of Columbia",108,0,99,0,6,0,0,3,108,106,0,99,0,6,0,0,1,2,0,0,0,0,0,0,2,110010088031009,5,506,506,5,psa_26,5D3
1000000US110010094004017,"Block 4017, Block Group 4, Census Tract 94, District of Columbia, District of Columbia",77,16,58,0,1,0,0,2,77,70,9,58,0,1,0,0,2,7,7,0,0,0,0,0,0,110010094004017,5,503,503,5,psa_45,5D2
1000000US110010107002016,"Block 2016, Block Group 2, Census Tract 107, District of Columbia, District of Columbia",0,0,0,0,0,0,0,0,0,0,0,0,0,0,0,0,0,0,0,0,0,0,0,0,0,110010107002016,2,208,208,2,psa_33,2D3
1000000US110010009012002,"Block 2002, Block Group 2, Census Tract 9.01, District of Columbia, District of Columbia",18,14,0,0,0,0,0,4,18,18,14,0,0,0,0,0,4,0,0,0,0,0,0,0,0,110010009012002,2,205,205,2,psa_46,2D2
1000000US110010026001006,"Block 1006, Block Group 1, Census Tract 26, District of Columbia, District of Columbia",46,34,10,0,0,0,0,2,46,45,33,10,0,0,0,0,2,1,1,0,0,0,0,0,0,110010026001006,4,404,404,4,psa_48,4D3
1000000US110010078071008,"Block 1008, Block Group 1, Census Tract 78.07, District of Columbia, District of Columbia",84,0,82,1,0,0,0,1,84,84,0,82,1,0,0,0,1,0,0,0,0,0,0,0,0,110010078071008,6,608,608,6,psa_19,6D1
1000000US110010062021131,"Block 1131, Block Group 1, Census Tract 62.02, District of Columbia, District of Columbia",0,0,0,0,0,0,0,0,0,0,0,0,0,0,0,0,0,0,0,0,0,0,0,0,0,110010062021131,1,102,102,1,psa_18,1D1
1000000US110010075041002,"Block 1002, Block Group 1, Census Tract 75.04, District of Columbia, District of Columbia",27,0,25,0,0,0,2,0,27,25,0,25,0,0,0,0,0,2,0,0,0,0,0,2,0,110010075041002,7,701,701,7,psa_9,7D1
1000000US110010005021002,"Block 1002, Block Group 1, Census Tract 5.02, District of Columbia, District of Columbia",188,173,6,0,4,0,2,3,188,175,163,4,0,4,0,1,3,13,10,2,0,0,0,1,0,110010005021002,2,204,204,2,psa_44,2D2
1000000US110010023012014,"Block 2014, Block Group 2, Census Tract 23.01, District of Columbia, District of Columbia",67,20,40,0,0,0,0,7,67,57,15,37,0,0,0,0,5,10,5,3,0,0,0,0,2,110010023012014,4,407,407,4,psa_47,4D2
1000000US110010062021194,"Block 1194, Block Group 1, Census Tract 62.02, District of Columbia, District of Columbia",0,0,0,0,0,0,0,0,0,0,0,0,0,0,0,0,0,0,0,0,0,0,0,0,0,110010062021194,1,103,103,1,psa_12,1D1
1000000US110010095052018,"Block 2018, Block Group 2, Census Tract 95.05, District of Columbia, District of Columbia",35,4,30,0,0,0,0,1,35,34,3,30,0,0,0,0,1,1,1,0,0,0,0,0,0,110010095052018,4,406,406,4,psa_54,4D2
1000000US110010056002010,"Block 2010, Block Group 2, Census Tract 56, District of Columbia, District of Columbia",0,0,0,0,0,0,0,0,0,0,0,0,0,0,0,0,0,0,0,0,0,0,0,0,0,110010056002010,2,206,206,2,psa_29,2D2
1000000US110010010016007,"Block 6007, Block Group 6, Census Tract 10.01, District of Columbia, District of Columbia",48,42,1,1,1,0,3,0,48,42,39,1,1,1,0,0,0,6,3,0,0,0,0,3,0,110010010016007,2,202,202,2,psa_52,2D1
1000000US110010021022008,"Block 2008, Block Group 2, Census Tract 21.02, District of Columbia, District of Columbia",161,14,140,0,0,0,5,2,161,146,11,134,0,0,0,0,1,15,3,6,0,0,0,5,1,110010021022008,4,403,403,4,psa_51,4D1
1000000US110010014023009,"Block 3009, Block Group 3, Census Tract 14.02, District of Columbia, District of Columbia",31,25,4,0,0,0,0,2,31,30,24,4,0,0,0,0,2,1,1,0,0,0,0,0,0,110010014023009,2,203,203,2,psa_50,2D1
1000000US110010096021026,"Block 1026, Block Group 1, Census Tract 96.02, District of Columbia, District of Columbia",0,0,0,0,0,0,0,0,0,0,0,0,0,0,0,0,0,0,0,0,0,0,0,0,0,110010096021026,6,601,601,6,psa_30,6D1
1000000US110010095071003,"Block 1003, Block Group 1, Census Tract 95.07, District of Columbia, District of Columbia",194,3,184,1,0,0,5,1,194,189,3,184,1,0,0,0,1,5,0,0,0,0,0,5,0,110010095071003,4,406,406,4,psa_54,4D2
1000000US110010074071009,"Block 1009, Block Group 1, Census Tract 74.07, District of Columbia, District of Columbia",43,0,42,0,0,0,1,0,43,42,0,42,0,0,0,0,0,1,0,0,0,0,0,1,0,110010074071009,7,703,703,7,psa_8,7D1
1000000US110010039003001,"Block 3001, Block Group 3, Census Tract 39, District of Columbia, District of Columbia",116,61,34,0,9,0,12,0,116,95,50,34,0,9,0,2,0,21,11,0,0,0,0,10,0,110010039003001,3,303,303,3,psa_37,3D3
1000000US110010093011000,"Block 1000, Block Group 1, Census Tract 93.01, District of Columbia, District of Columbia",96,18,73,0,3,0,2,0,96,95,18,73,0,3,0,1,0,1,0,0,0,0,0,1,0,110010093011000,5,504,504,5,psa_43,5D2
1000000US110010073011110,"Block 1110, Block Group 1, Census Tract 73.01, District of Columbia, District of Columbia",0,0,0,0,0,0,0,0,0,0,0,0,0,0,0,0,0,0,0,0,0,0,0,0,0,110010073011110,7,708,708,7,psa_1,7D3
1000000US110010009022037,"Block 2037, Block Group 2, Census Tract 9.02, District of Columbia, District of Columbia",0,0,0,0,0,0,0,0,0,0,0,0,0,0,0,0,0,0,0,0,0,0,0,0,0,110010009022037,2,205,205,2,psa_46,2D2
1000000US110010032002005,"Block 2005, Block Group 2, Census Tract 32, District of Columbia, District of Columbia",102,34,62,0,0,0,5,1,102,94,32,62,0,0,0,0,0,8,2,0,0,0,0,5,1,110010032002005,4,409,409,4,psa_41,4D3
1000000US110010076033000,"Block 3000, Block Group 3, Census Tract 76.03, District of Columbia, District of Columbia",115,7,103,1,0,0,0,4,115,113,7,102,1,0,0,0,3,2,0,1,0,0,0,0,1,110010076033000,6,606,606,6,psa_7,6D2
1000000US110010104002021,"Block 2021, Block Group 2, Census Tract 104, District of Columbia, District of Columbia",0,0,0,0,0,0,0,0,0,0,0,0,0,0,0,0,0,0,0,0,0,0,0,0,0,110010104002021,7,703,703,7,psa_8,7D1
1000000US110010010023000,"Block 3000, Block Group 3, Census Tract 10.02, District of Columbia, District of Columbia",1,1,0,0,0,0,0,0,1,1,1,0,0,0,0,0,0,0,0,0,0,0,0,0,0,110010010023000,2,202,202,2,psa_52,2D1
1000000US110010018031015,"Block 1015, Block Group 1, Census Tract 18.03, District of Columbia, District of Columbia",0,0,0,0,0,0,0,0,0,0,0,0,0,0,0,0,0,0,0,0,0,0,0,0,0,110010018031015,4,402,402,4,psa_53,4D1
1000000US110010046002012,"Block 2012, Block Group 2, Census Tract 46, District of Columbia, District of Columbia",0,0,0,0,0,0,0,0,0,0,0,0,0,0,0,0,0,0,0,0,0,0,0,0,0,110010046002012,3,308,308,3,psa_27,3D2
1000000US110010066001021,"Block 1021, Block Group 1, Census Tract 66, District of Columbia, District of Columbia",38,37,0,0,0,0,0,1,38,36,35,0,0,0,0,0,1,2,2,0,0,0,0,0,0,110010066001021,1,107,107,1,psa_16,1D2
1000000US110010077082007,"Block 2007, Block Group 2, Census Tract 77.08, District of Columbia, District of Columbia",125,0,118,0,0,0,0,7,125,124,0,117,0,0,0,0,7,1,0,1,0,0,0,0,0,110010077082007,6,603,603,6,psa_15,6D3
1000000US110010068011006,"Block 1006, Block Group 1, Census Tract 68.01, District of Columbia, District of Columbia",132,30,96,0,2,0,0,4,132,130,28,96,0,2,0,0,4,2,2,0,0,0,0,0,0,110010068011006,1,107,107,1,psa_16,1D2
1000000US110010027023016,"Block 3016, Block Group 3, Census Tract 27.02, District of Columbia, District of Columbia",0,0,0,0,0,0,0,0,0,0,0,0,0,0,0,0,0,0,0,0,0,0,0,0,0,110010027023016,3,303,303,3,psa_37,3D3
1000000US110010076051009,"Block 1009, Block Group 1, Census Tract 76.05, District of Columbia, District of Columbia",57,0,57,0,0,0,0,0,57,57,0,57,0,0,0,0,0,0,0,0,0,0,0,0,0,110010076051009,6,607,607,6,psa_10,6D2
1000000US110010078031002,"Block 1002, Block Group 1, Census Tract 78.03, District of Columbia, District of Columbia",0,0,0,0,0,0,0,0,0,0,0,0,0,0,0,0,0,0,0,0,0,0,0,0,0,110010078031002,6,602,602,6,psa_25,6D1
1000000US110010078082015,"Block 2015, Block Group 2, Census Tract 78.08, District of Columbia, District of Columbia",36,0,36,0,0,0,0,0,36,36,0,36,0,0,0,0,0,0,0,0,0,0,0,0,0,110010078082015,6,608,608,6,psa_19,6D1
1000000US110010073043004,"Block 3004, Block Group 3, Census Tract 73.04, District of Columbia, District of Columbia",54,2,51,0,0,0,0,1,54,54,2,51,0,0,0,0,1,0,0,0,0,0,0,0,0,110010073043004,7,705,705,7,psa_3,7D2
1000000US110010077091005,"Block 1005, Block Group 1, Census Tract 77.09, District of Columbia, District of Columbia",0,0,0,0,0,0,0,0,0,0,0,0,0,0,0,0,0,0,0,0,0,0,0,0,0,110010077091005,6,605,605,6,psa_11,6D2
1000000US110010077092010,"Block 2010, Block Group 2, Census Tract 77.09, District of Columbia, District of Columbia",0,0,0,0,0,0,0,0,0,0,0,0,0,0,0,0,0,0,0,0,0,0,0,0,0,110010077092010,6,605,605,6,psa_11,6D2
1000000US110010094003015,"Block 3015, Block Group 3, Census Tract 94, District of Columbia, District of Columbia",58,6,47,0,0,0,0,5,58,58,6,47,0,0,0,0,5,0,0,0,0,0,0,0,0,110010094003015,5,503,503,5,psa_45,5D2
1000000US110010001001001,"Block 1001, Block Group 1, Census Tract 1, District of Columbia, District of Columbia",30,25,0,0,1,0,4,0,30,26,25,0,0,1,0,0,0,4,0,0,0,0,0,4,0,110010001001001,2,206,206,2,psa_29,2D2
1000000US110010035002000,"Block 2000, Block Group 2, Census Tract 35, District of Columbia, District of Columbia",0,0,0,0,0,0,0,0,0,0,0,0,0,0,0,0,0,0,0,0,0,0,0,0,0,110010035002000,3,304,304,3,psa_36,3D1
1000000US110010074043004,"Block 3004, Block Group 3, Census Tract 74.04, District of Columbia, District of Columbia",28,0,28,0,0,0,0,0,28,28,0,28,0,0,0,0,0,0,0,0,0,0,0,0,0,110010074043004,7,704,704,7,psa_5,7D2
1000000US110010070002005,"Block 2005, Block Group 2, Census Tract 70, District of Columbia, District of Columbia",0,0,0,0,0,0,0,0,0,0,0,0,0,0,0,0,0,0,0,0,0,0,0,0,0,110010070002005,1,106,106,1,psa_13,1D3
1000000US110010023012005,"Block 2005, Block Group 2, Census Tract 23.01, District of Columbia, District of Columbia",140,12,126,0,0,0,0,2,140,139,11,126,0,0,0,0,2,1,1,0,0,0,0,0,0,110010023012005,4,407,407,4,psa_47,4D2
1000000US110010055001003,"Block 1003, Block Group 1, Census Tract 55, District of Columbia, District of Columbia",73,61,0,0,5,0,3,4,73,69,59,0,0,5,0,2,3,4,2,0,0,0,0,1,1,110010055001003,2,208,208,2,psa_33,2D3
1000000US110010078031011,"Block 1011, Block Group 1, Census Tract 78.03, District of Columbia, District of Columbia",0,0,0,0,0,0,0,0,0,0,0,0,0,0,0,0,0,0,0,0,0,0,0,0,0,110010078031011,6,602,602,6,psa_25,6D1
1000000US110010062021168,"Block 1168, Block Group 1, Census Tract 62.02, District of Columbia, District of Columbia",0,0,0,0,0,0,0,0,0,0,0,0,0,0,0,0,0,0,0,0,0,0,0,0,0,110010062021168,2,207,207,2,psa_24,2D3
1000000US110010079014000,"Block 4000, Block Group 4, Census Tract 79.01, District of Columbia, District of Columbia",91,9,82,0,0,0,0,0,91,90,8,82,0,0,0,0,0,1,1,0,0,0,0,0,0,110010079014000,5,507,507,5,psa_23,5D3
1000000US110010093021008,"Block 1008, Block Group 1, Census Tract 93.02, District of Columbia, District of Columbia",42,5,36,0,0,0,0,1,42,41,4,36,0,0,0,0,1,1,1,0,0,0,0,0,0,110010093021008,5,504,504,5,psa_43,5D2
1000000US110010025011007,"Block 1007, Block Group 1, Census Tract 25.01, District of Columbia, District of Columbia",215,1,205,2,0,0,2,5,215,212,1,205,1,0,0,0,5,3,0,0,1,0,0,2,0,110010025011007,4,404,404,4,psa_48,4D3
1000000US110010068041024,"Block 1024, Block Group 1, Census Tract 68.04, District of Columbia, District of Columbia",0,0,0,0,0,0,0,0,0,0,0,0,0,0,0,0,0,0,0,0,0,0,0,0,0,110010068041024,1,107,107,1,psa_16,1D2
1000000US110010095033003,"Block 3003, Block Group 3, Census Tract 95.03, District of Columbia, District of Columbia",22,1,19,0,0,0,0,2,22,22,1,19,0,0,0,0,2,0,0,0,0,0,0,0,0,110010095033003,4,405,405,4,psa_49,4D2
1000000US110010021015002,"Block 5002, Block Group 5, Census Tract 21.01, District of Columbia, District of Columbia",0,0,0,0,0,0,0,0,0,0,0,0,0,0,0,0,0,0,0,0,0,0,0,0,0,110010021015002,4,403,403,4,psa_51,4D1
1000000US110010046002014,"Block 2014, Block Group 2, Census Tract 46, District of Columbia, District of Columbia",75,27,36,0,2,0,5,5,75,64,22,35,0,2,0,0,5,11,5,1,0,0,0,5,0,110010046002014,3,308,308,3,psa_27,3D2
1000000US110010056002011,"Block 2011, Block Group 2, Census Tract 56, District of Columbia, District of Columbia",0,0,0,0,0,0,0,0,0,0,0,0,0,0,0,0,0,0,0,0,0,0,0,0,0,110010056002011,2,206,206,2,psa_29,2D2
1000000US110010017021002,"Block 1002, Block Group 1, Census Tract 17.02, District of Columbia, District of Columbia",22,5,12,0,0,0,4,1,22,21,5,12,0,0,0,3,1,1,0,0,0,0,0,1,0,110010017021002,4,401,401,4,psa_56,4D1
1000000US110010082002007,"Block 2007, Block Group 2, Census Tract 82, District of Columbia, District of Columbia",6,6,0,0,0,0,0,0,6,6,6,0,0,0,0,0,0,0,0,0,0,0,0,0,0,110010082002007,1,102,102,1,psa_18,1D1
1000000US110010107002020,"Block 2020, Block Group 2, Census Tract 107, District of Columbia, District of Columbia",40,33,1,0,6,0,0,0,40,36,29,1,0,6,0,0,0,4,4,0,0,0,0,0,0,110010107002020,2,208,208,2,psa_33,2D3
1000000US110010044001016,"Block 1016, Block Group 1, Census Tract 44, District of Columbia, District of Columbia",290,226,30,1,21,0,3,9,290,267,211,29,1,21,0,1,4,23,15,1,0,0,0,2,5,110010044001016,3,305,305,3,psa_32,3D2
1000000US110010087011006,"Block 1006, Block Group 1, Census Tract 87.01, District of Columbia, District of Columbia",179,21,148,0,5,0,2,3,179,174,20,148,0,5,0,0,1,5,1,0,0,0,0,2,2,110010087011006,5,502,502,5,psa_40,5D1
1000000US110010019022019,"Block 2019, Block Group 2, Census Tract 19.02, District of Columbia, District of Columbia",0,0,0,0,0,0,0,0,0,0,0,0,0,0,0,0,0,0,0,0,0,0,0,0,0,110010019022019,4,406,406,4,psa_54,4D2
1000000US110010071002013,"Block 2013, Block Group 2, Census Tract 71, District of Columbia, District of Columbia",109,50,45,0,3,0,0,11,109,92,42,45,0,3,0,0,2,17,8,0,0,0,0,0,9,110010071002013,1,106,106,1,psa_13,1D3
1000000US110010077091001,"Block 1001, Block Group 1, Census Tract 77.09, District of Columbia, District of Columbia",29,0,28,1,0,0,0,0,29,29,0,28,1,0,0,0,0,0,0,0,0,0,0,0,0,110010077091001,6,605,605,6,psa_11,6D2
1000000US110010104002009,"Block 2009, Block Group 2, Census Tract 104, District of Columbia, District of Columbia",0,0,0,0,0,0,0,0,0,0,0,0,0,0,0,0,0,0,0,0,0,0,0,0,0,110010104002009,7,703,703,7,psa_8,7D1
1000000US110010095033006,"Block 3006, Block Group 3, Census Tract 95.03, District of Columbia, District of Columbia",6,0,6,0,0,0,0,0,6,6,0,6,0,0,0,0,0,0,0,0,0,0,0,0,0,110010095033006,4,405,405,4,psa_49,4D2
1000000US110010103003005,"Block 3005, Block Group 3, Census Tract 103, District of Columbia, District of Columbia",62,16,34,0,2,0,7,3,62,54,15,34,0,2,0,0,3,8,1,0,0,0,0,7,0,110010103003005,4,401,401,4,psa_56,4D1
1000000US110010078043002,"Block 3002, Block Group 3, Census Tract 78.04, District of Columbia, District of Columbia",37,1,36,0,0,0,0,0,37,37,1,36,0,0,0,0,0,0,0,0,0,0,0,0,0,110010078043002,6,602,602,6,psa_25,6D1
1000000US110010106002015,"Block 2015, Block Group 2, Census Tract 106, District of Columbia, District of Columbia",152,44,94,5,3,0,6,0,152,134,38,93,0,3,0,0,0,18,6,1,5,0,0,6,0,110010106002015,5,501,501,5,psa_35,5D1
1000000US110010020012013,"Block 2013, Block Group 2, Census Tract 20.01, District of Columbia, District of Columbia",78,30,39,0,6,0,0,3,78,76,29,39,0,6,0,0,2,2,1,0,0,0,0,0,1,110010020012013,4,403,403,4,psa_51,4D1
1000000US110010024001000,"Block 1000, Block Group 1, Census Tract 24, District of Columbia, District of Columbia",223,68,121,0,3,0,23,8,223,169,39,121,0,3,0,0,6,54,29,0,0,0,0,23,2,110010024001000,4,407,407,4,psa_47,4D2
1000000US110010056001009,"Block 1009, Block Group 1, Census Tract 56, District of Columbia, District of Columbia",2,1,1,0,0,0,0,0,2,2,1,1,0,0,0,0,0,0,0,0,0,0,0,0,0,110010056001009,2,207,207,2,psa_24,2D3
1000000US110010005021001,"Block 1001, Block Group 1, Census Tract 5.02, District of Columbia, District of Columbia",303,262,9,2,18,0,10,2,303,282,250,9,2,18,0,1,2,21,12,0,0,0,0,9,0,110010005021001,2,204,204,2,psa_44,2D2
1000000US110010050011004,"Block 1004, Block Group 1, Census Tract 50.01, District of Columbia, District of Columbia",0,0,0,0,0,0,0,0,0,0,0,0,0,0,0,0,0,0,0,0,0,0,0,0,0,110010050011004,3,307,307,3,psa_28,3D3
1000000US110010094003000,"Block 3000, Block Group 3, Census Tract 94, District of Columbia, District of Columbia",144,28,83,2,16,0,14,1,144,112,14,80,2,16,0,0,0,32,14,3,0,0,0,14,1,110010094003000,5,503,503,5,psa_45,5D2
1000000US110010001003006,"Block 3006, Block Group 3, Census Tract 1, District of Columbia, District of Columbia",124,123,0,0,0,0,1,0,124,115,115,0,0,0,0,0,0,9,8,0,0,0,0,1,0,110010001003006,2,206,206,2,psa_29,2D2
1000000US110010016003012,"Block 3012, Block Group 3, Census Tract 16, District of Columbia, District of Columbia",22,1,21,0,0,0,0,0,22,22,1,21,0,0,0,0,0,0,0,0,0,0,0,0,0,110010016003012,4,401,401,4,psa_56,4D1
1000000US110010056004006,"Block 4006, Block Group 4, Census Tract 56, District of Columbia, District of Columbia",0,0,0,0,0,0,0,0,0,0,0,0,0,0,0,0,0,0,0,0,0,0,0,0,0,110010056004006,2,207,207,2,psa_24,2D3
1000000US110010095091006,"Block 1006, Block Group 1, Census Tract 95.09, District of Columbia, District of Columbia",139,0,138,0,1,0,0,0,139,133,0,132,0,1,0,0,0,6,0,6,0,0,0,0,0,110010095091006,4,405,405,4,psa_49,4D2
1000000US110010106002019,"Block 2019, Block Group 2, Census Tract 106, District of Columbia, District of Columbia",0,0,0,0,0,0,0,0,0,0,0,0,0,0,0,0,0,0,0,0,0,0,0,0,0,110010106002019,5,501,501,5,psa_35,5D1
1000000US110010072001020,"Block 1020, Block Group 1, Census Tract 72, District of Columbia, District of Columbia",52,21,30,0,0,0,0,1,52,51,20,30,0,0,0,0,1,1,1,0,0,0,0,0,0,110010072001020,1,106,106,1,psa_13,1D3
1000000US110010014012017,"Block 2017, Block Group 2, Census Tract 14.01, District of Columbia, District of Columbia",70,62,0,0,5,0,1,2,70,66,61,0,0,5,0,0,0,4,1,0,0,0,0,1,2,110010014012017,2,201,201,2,psa_55,2D1
1000000US110010077071012,"Block 1012, Block Group 1, Census Tract 77.07, District of Columbia, District of Columbia",51,0,51,0,0,0,0,0,51,51,0,51,0,0,0,0,0,0,0,0,0,0,0,0,0,110010077071012,6,604,604,6,psa_14,6D3
1000000US110010095053017,"Block 3017, Block Group 3, Census Tract 95.05, District of Columbia, District of Columbia",29,0,29,0,0,0,0,0,29,29,0,29,0,0,0,0,0,0,0,0,0,0,0,0,0,110010095053017,4,406,406,4,psa_54,4D2
1000000US110010027023012,"Block 3012, Block Group 3, Census Tract 27.02, District of Columbia, District of Columbia",0,0,0,0,0,0,0,0,0,0,0,0,0,0,0,0,0,0,0,0,0,0,0,0,0,110010027023012,3,302,302,3,psa_42,3D1
1000000US110010044001009,"Block 1009, Block Group 1, Census Tract 44, District of Columbia, District of Columbia",137,101,15,0,13,0,0,8,137,133,99,15,0,13,0,0,6,4,2,0,0,0,0,0,2,110010044001009,3,305,305,3,psa_32,3D2
1000000US110010005011010,"Block 1010, Block Group 1, Census Tract 5.01, District of Columbia, District of Columbia",0,0,0,0,0,0,0,0,0,0,0,0,0,0,0,0,0,0,0,0,0,0,0,0,0,110010005011010,2,204,204,2,psa_44,2D2
1000000US110010041003009,"Block 3009, Block Group 3, Census Tract 41, District of Columbia, District of Columbia",0,0,0,0,0,0,0,0,0,0,0,0,0,0,0,0,0,0,0,0,0,0,0,0,0,110010041003009,2,208,208,2,psa_33,2D3
1000000US110010078042007,"Block 2007, Block Group 2, Census Tract 78.04, District of Columbia, District of Columbia",204,0,191,0,0,0,0,13,204,204,0,191,0,0,0,0,13,0,0,0,0,0,0,0,0,110010078042007,6,602,602,6,psa_25,6D1
1000000US110010111003024,"Block 3024, Block Group 3, Census Tract 111, District of Columbia, District of Columbia",0,0,0,0,0,0,0,0,0,0,0,0,0,0,0,0,0,0,0,0,0,0,0,0,0,110010111003024,5,503,503,5,psa_45,5D2
1000000US110010009012020,"Block 2020, Block Group 2, Census Tract 9.01, District of Columbia, District of Columbia",74,70,0,0,3,0,1,0,74,71,68,0,0,3,0,0,0,3,2,0,0,0,0,1,0,110010009012020,2,205,205,2,psa_46,2D2
1000000US110010098022001,"Block 2001, Block Group 2, Census Tract 98.02, District of Columbia, District of Columbia",118,3,112,0,0,0,0,3,118,115,3,109,0,0,0,0,3,3,0,3,0,0,0,0,0,110010098022001,7,706,706,7,psa_2,7D3
1000000US110010019013012,"Block 3012, Block Group 3, Census Tract 19.01, District of Columbia, District of Columbia",143,17,114,0,1,0,5,6,143,123,12,107,0,1,0,0,3,20,5,7,0,0,0,5,3,110010019013012,4,402,402,4,psa_53,4D1
1000000US110010055001017,"Block 1017, Block Group 1, Census Tract 55, District of Columbia, District of Columbia",179,156,7,0,11,0,1,4,179,171,151,5,0,11,0,0,4,8,5,2,0,0,0,1,0,110010055001017,2,208,208,2,psa_33,2D3
1000000US110010062021026,"Block 1026, Block Group 1, Census Tract 62.02, District of Columbia, District of Columbia",0,0,0,0,0,0,0,0,0,0,0,0,0,0,0,0,0,0,0,0,0,0,0,0,0,110010062021026,2,209,209,2,psa_57,2D3
1000000US110010009021004,"Block 1004, Block Group 1, Census Tract 9.02, District of Columbia, District of Columbia",22,17,2,0,1,0,0,2,22,22,17,2,0,1,0,0,2,0,0,0,0,0,0,0,0,110010009021004,2,205,205,2,psa_46,2D2
1000000US110010059001036,"Block 1036, Block Group 1, Census Tract 59, District of Columbia, District of Columbia",0,0,0,0,0,0,0,0,0,0,0,0,0,0,0,0,0,0,0,0,0,0,0,0,0,110010059001036,1,101,101,1,psa_20,1D1
1000000US110010093012013,"Block 2013, Block Group 2, Census Tract 93.01, District of Columbia, District of Columbia",7,4,3,0,0,0,0,0,7,6,3,3,0,0,0,0,0,1,1,0,0,0,0,0,0,110010093012013,5,504,504,5,psa_43,5D2
1000000US110010008013027,"Block 3027, Block Group 3, Census Tract 8.01, District of Columbia, District of Columbia",48,43,1,0,4,0,0,0,48,48,43,1,0,4,0,0,0,0,0,0,0,0,0,0,0,110010008013027,2,205,205,2,psa_46,2D2
1000000US110010089031005,"Block 1005, Block Group 1, Census Tract 89.03, District of Columbia, District of Columbia",213,4,198,0,3,0,0,8,213,213,4,198,0,3,0,0,8,0,0,0,0,0,0,0,0,110010089031005,5,507,507,5,psa_23,5D3
1000000US110010012004011,"Block 4011, Block Group 4, Census Tract 12, District of Columbia, District of Columbia",0,0,0,0,0,0,0,0,0,0,0,0,0,0,0,0,0,0,0,0,0,0,0,0,0,110010012004011,2,203,203,2,psa_50,2D1
1000000US110010021025000,"Block 5000, Block Group 5, Census Tract 21.02, District of Columbia, District of Columbia",124,23,95,5,0,0,1,0,124,110,14,91,5,0,0,0,0,14,9,4,0,0,0,1,0,110010021025000,4,403,403,4,psa_51,4D1
1000000US110010058001012,"Block 1012, Block Group 1, Census Tract 58, District of Columbia, District of Columbia",0,0,0,0,0,0,0,0,0,0,0,0,0,0,0,0,0,0,0,0,0,0,0,0,0,110010058001012,2,209,209,2,psa_57,2D3
1000000US110010062021072,"Block 1072, Block Group 1, Census Tract 62.02, District of Columbia, District of Columbia",0,0,0,0,0,0,0,0,0,0,0,0,0,0,0,0,0,0,0,0,0,0,0,0,0,110010062021072,2,207,207,2,psa_24,2D3
1000000US110010015001010,"Block 1010, Block Group 1, Census Tract 15, District of Columbia, District of Columbia",66,45,20,1,0,0,0,0,66,58,37,20,1,0,0,0,0,8,8,0,0,0,0,0,0,110010015001010,2,201,201,2,psa_55,2D1
1000000US110010062021029,"Block 1029, Block Group 1, Census Tract 62.02, District of Columbia, District of Columbia",0,0,0,0,0,0,0,0,0,0,0,0,0,0,0,0,0,0,0,0,0,0,0,0,0,110010062021029,2,207,207,2,psa_24,2D3
1000000US110010053014001,"Block 4001, Block Group 4, Census Tract 53.01, District of Columbia, District of Columbia",110,94,2,0,4,0,7,3,110,100,90,2,0,4,0,1,3,10,4,0,0,0,0,6,0,110010053014001,3,301,301,3,psa_31,3D3
1000000US110010079012001,"Block 2001, Block Group 2, Census Tract 79.01, District of Columbia, District of Columbia",127,16,102,1,0,0,0,8,127,125,14,102,1,0,0,0,8,2,2,0,0,0,0,0,0,110010079012001,5,507,507,5,psa_23,5D3
1000000US110010080012005,"Block 2005, Block Group 2, Census Tract 80.01, District of Columbia, District of Columbia",68,39,23,0,1,0,1,4,68,65,38,23,0,1,0,0,3,3,1,0,0,0,0,1,1,110010080012005,1,108,108,1,psa_17,1D2
1000000US110010009011013,"Block 1013, Block Group 1, Census Tract 9.01, District of Columbia, District of Columbia",95,86,1,1,5,0,0,2,95,90,82,1,0,5,0,0,2,5,4,0,1,0,0,0,0,110010009011013,2,205,205,2,psa_46,2D2
1000000US110010010013006,"Block 3006, Block Group 3, Census Tract 10.01, District of Columbia, District of Columbia",89,87,0,0,0,0,0,2,89,87,85,0,0,0,0,0,2,2,2,0,0,0,0,0,0,110010010013006,2,202,202,2,psa_52,2D1
1000000US110010087022002,"Block 2002, Block Group 2, Census Tract 87.02, District of Columbia, District of Columbia",49,32,14,0,0,0,2,1,49,39,24,14,0,0,0,0,1,10,8,0,0,0,0,2,0,110010087022002,5,502,502,5,psa_40,5D1
1000000US110010092032013,"Block 2013, Block Group 2, Census Tract 92.03, District of Columbia, District of Columbia",131,6,102,0,12,0,7,4,131,125,6,102,0,12,0,1,4,6,0,0,0,0,0,6,0,110010092032013,5,502,502,5,psa_40,5D1
1000000US110010110002010,"Block 2010, Block Group 2, Census Tract 110, District of Columbia, District of Columbia",0,0,0,0,0,0,0,0,0,0,0,0,0,0,0,0,0,0,0,0,0,0,0,0,0,110010110002010,1,105,105,1,psa_22,1D3
1000000US110010009022006,"Block 2006, Block Group 2, Census Tract 9.02, District of Columbia, District of Columbia",63,50,4,0,5,0,0,4,63,63,50,4,0,5,0,0,4,0,0,0,0,0,0,0,0,110010009022006,2,205,205,2,psa_46,2D2
1000000US110010016002009,"Block 2009, Block Group 2, Census Tract 16, District of Columbia, District of Columbia",48,9,26,0,0,0,4,9,48,38,8,26,0,0,0,0,4,10,1,0,0,0,0,4,5,110010016002009,4,401,401,4,psa_56,4D1
1000000US110010016003010,"Block 3010, Block Group 3, Census Tract 16, District of Columbia, District of Columbia",59,12,47,0,0,0,0,0,59,59,12,47,0,0,0,0,0,0,0,0,0,0,0,0,0,110010016003010,4,401,401,4,psa_56,4D1
1000000US110010078092004,"Block 2004, Block Group 2, Census Tract 78.09, District of Columbia, District of Columbia",44,0,44,0,0,0,0,0,44,44,0,44,0,0,0,0,0,0,0,0,0,0,0,0,0,110010078092004,6,602,602,6,psa_25,6D1
1000000US110010074011011,"Block 1011, Block Group 1, Census Tract 74.01, District of Columbia, District of Columbia",0,0,0,0,0,0,0,0,0,0,0,0,0,0,0,0,0,0,0,0,0,0,0,0,0,110010074011011,7,701,701,7,psa_9,7D1
1000000US110010015001023,"Block 1023, Block Group 1, Census Tract 15, District of Columbia, District of Columbia",64,35,23,0,6,0,0,0,64,63,34,23,0,6,0,0,0,1,1,0,0,0,0,0,0,110010015001023,2,201,201,2,psa_55,2D1
1000000US110010034002017,"Block 2017, Block Group 2, Census Tract 34, District of Columbia, District of Columbia",72,17,54,0,0,0,0,1,72,69,15,53,0,0,0,0,1,3,2,1,0,0,0,0,0,110010034002017,3,306,306,3,psa_38,3D2
1000000US110010073011001,"Block 1001, Block Group 1, Census Tract 73.01, District of Columbia, District of Columbia",0,0,0,0,0,0,0,0,0,0,0,0,0,0,0,0,0,0,0,0,0,0,0,0,0,110010073011001,7,703,703,7,psa_8,7D1
1000000US110010068012000,"Block 2000, Block Group 2, Census Tract 68.01, District of Columbia, District of Columbia",78,20,56,0,0,0,0,2,78,77,19,56,0,0,0,0,2,1,1,0,0,0,0,0,0,110010068012000,1,107,107,1,psa_16,1D2
1000000US110010052012002,"Block 2002, Block Group 2, Census Tract 52.01, District of Columbia, District of Columbia",172,143,5,0,14,1,2,7,172,154,127,5,0,14,1,0,7,18,16,0,0,0,0,2,0,110010052012002,3,301,301,3,psa_31,3D3
1000000US110010019013010,"Block 3010, Block Group 3, Census Tract 19.01, District of Columbia, District of Columbia",78,12,62,0,4,0,0,0,78,64,3,57,0,4,0,0,0,14,9,5,0,0,0,0,0,110010019013010,4,402,402,4,psa_53,4D1
1000000US110010020021004,"Block 1004, Block Group 1, Census Tract 20.02, District of Columbia, District of Columbia",21,9,10,0,0,0,2,0,21,19,9,10,0,0,0,0,0,2,0,0,0,0,0,2,0,110010020021004,4,403,403,4,psa_51,4D1
1000000US110010078041008,"Block 1008, Block Group 1, Census Tract 78.04, District of Columbia, District of Columbia",62,0,62,0,0,0,0,0,62,62,0,62,0,0,0,0,0,0,0,0,0,0,0,0,0,110010078041008,6,602,602,6,psa_25,6D1
1000000US110010095032013,"Block 2013, Block Group 2, Census Tract 95.03, District of Columbia, District of Columbia",46,6,38,0,0,0,0,2,46,45,5,38,0,0,0,0,2,1,1,0,0,0,0,0,0,110010095032013,5,504,504,5,psa_43,5D2
1000000US110010041002000,"Block 2000, Block Group 2, Census Tract 41, District of Columbia, District of Columbia",0,0,0,0,0,0,0,0,0,0,0,0,0,0,0,0,0,0,0,0,0,0,0,0,0,110010041002000,2,204,204,2,psa_44,2D2
1000000US110010106002047,"Block 2047, Block Group 2, Census Tract 106, District of Columbia, District of Columbia",92,32,56,0,0,0,0,4,92,91,31,56,0,0,0,0,4,1,1,0,0,0,0,0,0,110010106002047,5,501,501,5,psa_35,5D1
1000000US110010087022007,"Block 2007, Block Group 2, Census Tract 87.02, District of Columbia, District of Columbia",60,14,39,1,1,0,0,5,60,58,14,38,1,1,0,0,4,2,0,1,0,0,0,0,1,110010087022007,5,502,502,5,psa_40,5D1
1000000US110010006002000,"Block 2000, Block Group 2, Census Tract 6, District of Columbia, District of Columbia",173,155,3,0,8,0,3,4,173,149,137,2,0,8,0,0,2,24,18,1,0,0,0,3,2,110010006002000,2,203,203,2,psa_50,2D1
1000000US110010003004008,"Block 4008, Block Group 4, Census Tract 3, District of Columbia, District of Columbia",120,113,2,1,1,0,0,3,120,117,110,2,1,1,0,0,3,3,3,0,0,0,0,0,0,110010003004008,2,204,204,2,psa_44,2D2
1000000US110010041002012,"Block 2012, Block Group 2, Census Tract 41, District of Columbia, District of Columbia",202,174,5,2,16,0,0,5,202,186,162,4,0,15,0,0,5,16,12,1,2,1,0,0,0,110010041002012,2,208,208,2,psa_33,2D3
1000000US110010075041008,"Block 1008, Block Group 1, Census Tract 75.04, District of Columbia, District of Columbia",252,0,243,4,0,0,0,5,252,252,0,243,4,0,0,0,5,0,0,0,0,0,0,0,0,110010075041008,7,701,701,7,psa_9,7D1
1000000US110010095041014,"Block 1014, Block Group 1, Census Tract 95.04, District of Columbia, District of Columbia",107,10,94,1,0,0,2,0,107,104,10,93,1,0,0,0,0,3,0,1,0,0,0,2,0,110010095041014,4,405,405,4,psa_49,4D2
1000000US110010097001015,"Block 1015, Block Group 1, Census Tract 97, District of Columbia, District of Columbia",172,0,170,0,0,0,0,2,172,171,0,170,0,0,0,0,1,1,0,0,0,0,0,0,1,110010097001015,7,706,706,7,psa_2,7D3
1000000US110010103003000,"Block 3000, Block Group 3, Census Tract 103, District of Columbia, District of Columbia",55,29,21,0,0,0,0,5,55,49,23,21,0,0,0,0,5,6,6,0,0,0,0,0,0,110010103003000,4,401,401,4,psa_56,4D1
1000000US110010064002022,"Block 2022, Block Group 2, Census Tract 64, District of Columbia, District of Columbia",0,0,0,0,0,0,0,0,0,0,0,0,0,0,0,0,0,0,0,0,0,0,0,0,0,110010064002022,1,105,105,1,psa_22,1D3
1000000US110010094003014,"Block 3014, Block Group 3, Census Tract 94, District of Columbia, District of Columbia",73,12,61,0,0,0,0,0,73,68,7,61,0,0,0,0,0,5,5,0,0,0,0,0,0,110010094003014,5,503,503,5,psa_45,5D2
1000000US110010027022001,"Block 2001, Block Group 2, Census Tract 27.02, District of Columbia, District of Columbia",300,265,15,1,9,0,3,7,300,281,251,14,1,9,0,1,5,19,14,1,0,0,0,2,2,110010027022001,3,302,302,3,psa_42,3D1
1000000US110010021025005,"Block 5005, Block Group 5, Census Tract 21.02, District of Columbia, District of Columbia",122,13,88,0,0,0,18,3,122,99,9,86,0,0,0,1,3,23,4,2,0,0,0,17,0,110010021025005,4,403,403,4,psa_51,4D1
1000000US110010020023005,"Block 3005, Block Group 3, Census Tract 20.02, District of Columbia, District of Columbia",161,38,106,1,7,0,7,2,161,150,33,106,1,7,0,1,2,11,5,0,0,0,0,6,0,110010020023005,4,403,403,4,psa_51,4D1
1000000US110010001004026,"Block 4026, Block Group 4, Census Tract 1, District of Columbia, District of Columbia",0,0,0,0,0,0,0,0,0,0,0,0,0,0,0,0,0,0,0,0,0,0,0,0,0,110010001004026,2,206,206,2,psa_29,2D2
1000000US110010009011009,"Block 1009, Block Group 1, Census Tract 9.01, District of Columbia, District of Columbia",162,149,5,0,5,0,0,3,162,162,149,5,0,5,0,0,3,0,0,0,0,0,0,0,0,110010009011009,2,205,205,2,psa_46,2D2
1000000US110010092031005,"Block 1005, Block Group 1, Census Tract 92.03, District of Columbia, District of Columbia",173,19,152,0,2,0,0,0,173,172,19,151,0,2,0,0,0,1,0,1,0,0,0,0,0,110010092031005,5,502,502,5,psa_40,5D1
1000000US110010012004002,"Block 4002, Block Group 4, Census Tract 12, District of Columbia, District of Columbia",12,12,0,0,0,0,0,0,12,11,11,0,0,0,0,0,0,1,1,0,0,0,0,0,0,110010012004002,2,202,202,2,psa_52,2D1
1000000US110010049012001,"Block 2001, Block Group 2, Census Tract 49.01, District of Columbia, District of Columbia",65,33,14,1,6,0,9,2,65,51,29,14,1,6,0,0,1,14,4,0,0,0,0,9,1,110010049012001,3,307,307,3,psa_28,3D3
1000000US110010074072008,"Block 2008, Block Group 2, Census Tract 74.07, District of Columbia, District of Columbia",239,0,229,0,0,0,0,10,239,239,0,229,0,0,0,0,10,0,0,0,0,0,0,0,0,110010074072008,7,703,703,7,psa_8,7D1
1000000US110010084101015,"Block 1015, Block Group 1, Census Tract 84.10, District of Columbia, District of Columbia",105,33,70,0,2,0,0,0,105,103,31,70,0,2,0,0,0,2,2,0,0,0,0,0,0,110010084101015,1,104,104,1,psa_21,1D2
1000000US110010095082005,"Block 2005, Block Group 2, Census Tract 95.08, District of Columbia, District of Columbia",435,20,376,1,6,0,25,7,435,400,15,373,0,6,0,0,6,35,5,3,1,0,0,25,1,110010095082005,4,406,406,4,psa_54,4D2
1000000US110010008013015,"Block 3015, Block Group 3, Census Tract 8.01, District of Columbia, District of Columbia",63,59,0,0,4,0,0,0,63,61,57,0,0,4,0,0,0,2,2,0,0,0,0,0,0,110010008013015,2,205,205,2,psa_46,2D2
1000000US110010071001027,"Block 1027, Block Group 1, Census Tract 71, District of Columbia, District of Columbia",0,0,0,0,0,0,0,0,0,0,0,0,0,0,0,0,0,0,0,0,0,0,0,0,0,110010071001027,1,106,106,1,psa_13,1D3
1000000US110010010016005,"Block 6005, Block Group 6, Census Tract 10.01, District of Columbia, District of Columbia",0,0,0,0,0,0,0,0,0,0,0,0,0,0,0,0,0,0,0,0,0,0,0,0,0,110010010016005,2,202,202,2,psa_52,2D1
1000000US110010030001002,"Block 1002, Block Group 1, Census Tract 30, District of Columbia, District of Columbia",0,0,0,0,0,0,0,0,0,0,0,0,0,0,0,0,0,0,0,0,0,0,0,0,0,110010030001002,3,302,302,3,psa_42,3D1
1000000US110010077072021,"Block 2021, Block Group 2, Census Tract 77.07, District of Columbia, District of Columbia",45,0,44,0,0,0,0,1,45,45,0,44,0,0,0,0,1,0,0,0,0,0,0,0,0,110010077072021,6,604,604,6,psa_14,6D3
1000000US110010022013005,"Block 3005, Block Group 3, Census Tract 22.01, District of Columbia, District of Columbia",0,0,0,0,0,0,0,0,0,0,0,0,0,0,0,0,0,0,0,0,0,0,0,0,0,110010022013005,4,407,407,4,psa_47,4D2
1000000US110010095032000,"Block 2000, Block Group 2, Census Tract 95.03, District of Columbia, District of Columbia",86,9,77,0,0,0,0,0,86,86,9,77,0,0,0,0,0,0,0,0,0,0,0,0,0,110010095032000,4,405,405,4,psa_49,4D2
1000000US110010003002000,"Block 2000, Block Group 2, Census Tract 3, District of Columbia, District of Columbia",154,139,4,0,5,0,2,4,154,151,138,4,0,5,0,0,4,3,1,0,0,0,0,2,0,110010003002000,2,204,204,2,psa_44,2D2
1000000US110010019012011,"Block 2011, Block Group 2, Census Tract 19.01, District of Columbia, District of Columbia",0,0,0,0,0,0,0,0,0,0,0,0,0,0,0,0,0,0,0,0,0,0,0,0,0,110010019012011,4,402,402,4,psa_53,4D1
1000000US110010052014005,"Block 4005, Block Group 4, Census Tract 52.01, District of Columbia, District of Columbia",555,484,14,0,44,0,4,9,555,522,457,13,0,44,0,2,6,33,27,1,0,0,0,2,3,110010052014005,2,208,208,2,psa_33,2D3
1000000US110010106002010,"Block 2010, Block Group 2, Census Tract 106, District of Columbia, District of Columbia",49,7,27,0,14,0,0,1,49,48,7,26,0,14,0,0,1,1,0,1,0,0,0,0,0,110010106002010,5,501,501,5,psa_35,5D1
1000000US110010096032006,"Block 2006, Block Group 2, Census Tract 96.03, District of Columbia, District of Columbia",95,0,83,5,0,0,1,6,95,94,0,83,5,0,0,0,6,1,0,0,0,0,0,1,0,110010096032006,6,603,603,6,psa_15,6D3
1000000US110010095081007,"Block 1007, Block Group 1, Census Tract 95.08, District of Columbia, District of Columbia",0,0,0,0,0,0,0,0,0,0,0,0,0,0,0,0,0,0,0,0,0,0,0,0,0,110010095081007,4,405,405,4,psa_49,4D2
1000000US110010066001008,"Block 1008, Block Group 1, Census Tract 66, District of Columbia, District of Columbia",109,97,1,1,8,0,0,2,109,108,96,1,1,8,0,0,2,1,1,0,0,0,0,0,0,110010066001008,1,107,107,1,psa_16,1D2
1000000US110010077071006,"Block 1006, Block Group 1, Census Tract 77.07, District of Columbia, District of Columbia",390,0,375,2,0,0,12,1,390,373,0,371,2,0,0,0,0,17,0,4,0,0,0,12,1,110010077071006,6,604,604,6,psa_14,6D3
1000000US110010094002025,"Block 2025, Block Group 2, Census Tract 94, District of Columbia, District of Columbia",35,0,35,0,0,0,0,0,35,35,0,35,0,0,0,0,0,0,0,0,0,0,0,0,0,110010094002025,5,503,503,5,psa_45,5D2
1000000US110010106001003,"Block 1003, Block Group 1, Census Tract 106, District of Columbia, District of Columbia",177,69,83,0,8,0,1,16,177,171,65,82,0,8,0,0,16,6,4,1,0,0,0,1,0,110010106001003,5,501,501,5,psa_35,5D1
1000000US110010001004005,"Block 4005, Block Group 4, Census Tract 1, District of Columbia, District of Columbia",86,82,0,0,4,0,0,0,86,84,80,0,0,4,0,0,0,2,2,0,0,0,0,0,0,110010001004005,2,206,206,2,psa_29,2D2
1000000US110010056001008,"Block 1008, Block Group 1, Census Tract 56, District of Columbia, District of Columbia",111,99,3,0,4,0,2,3,111,105,93,3,0,4,0,2,3,6,6,0,0,0,0,0,0,110010056001008,2,207,207,2,psa_24,2D3
1000000US110010075041004,"Block 1004, Block Group 1, Census Tract 75.04, District of Columbia, District of Columbia",1305,18,1259,1,3,0,0,24,1305,1305,18,1259,1,3,0,0,24,0,0,0,0,0,0,0,0,110010075041004,7,701,701,7,psa_9,7D1
1000000US110010020012009,"Block 2009, Block Group 2, Census Tract 20.01, District of Columbia, District of Columbia",5,0,5,0,0,0,0,0,5,5,0,5,0,0,0,0,0,0,0,0,0,0,0,0,0,110010020012009,4,403,403,4,psa_51,4D1
1000000US110010062021010,"Block 1010, Block Group 1, Census Tract 62.02, District of Columbia, District of Columbia",0,0,0,0,0,0,0,0,0,0,0,0,0,0,0,0,0,0,0,0,0,0,0,0,0,110010062021010,1,102,102,1,psa_18,1D1
1000000US110010105001009,"Block 1009, Block Group 1, Census Tract 105, District of Columbia, District of Columbia",192,0,188,0,0,0,4,0,192,188,0,188,0,0,0,0,0,4,0,0,0,0,0,4,0,110010105001009,1,105,105,1,psa_22,1D3
1000000US110010109002025,"Block 2025, Block Group 2, Census Tract 109, District of Columbia, District of Columbia",0,0,0,0,0,0,0,0,0,0,0,0,0,0,0,0,0,0,0,0,0,0,0,0,0,110010109002025,7,708,708,7,psa_1,7D3
1000000US110010040012000,"Block 2000, Block Group 2, Census Tract 40.01, District of Columbia, District of Columbia",297,258,17,0,10,0,7,5,297,279,247,17,0,10,0,0,5,18,11,0,0,0,0,7,0,110010040012000,3,303,303,3,psa_37,3D3
1000000US110010075041009,"Block 1009, Block Group 1, Census Tract 75.04, District of Columbia, District of Columbia",165,2,153,0,0,0,0,10,165,164,2,153,0,0,0,0,9,1,0,0,0,0,0,0,1,110010075041009,7,701,701,7,psa_9,7D1
1000000US110010111002020,"Block 2020, Block Group 2, Census Tract 111, District of Columbia, District of Columbia",83,13,61,1,0,0,8,0,83,63,3,59,1,0,0,0,0,20,10,2,0,0,0,8,0,110010111002020,5,503,503,5,psa_45,5D2
1000000US110010064001000,"Block 1000, Block Group 1, Census Tract 64, District of Columbia, District of Columbia",71,16,33,1,18,0,0,3,71,71,16,33,1,18,0,0,3,0,0,0,0,0,0,0,0,110010064001000,1,105,105,1,psa_22,1D3
1000000US110010073011088,"Block 1088, Block Group 1, Census Tract 73.01, District of Columbia, District of Columbia",0,0,0,0,0,0,0,0,0,0,0,0,0,0,0,0,0,0,0,0,0,0,0,0,0,110010073011088,7,707,707,7,psa_4,7D2
1000000US110010001001010,"Block 1010, Block Group 1, Census Tract 1, District of Columbia, District of Columbia",133,125,0,0,2,0,3,3,133,118,112,0,0,2,0,2,2,15,13,0,0,0,0,1,1,110010001001010,2,206,206,2,psa_29,2D2
1000000US110010076042011,"Block 2011, Block Group 2, Census Tract 76.04, District of Columbia, District of Columbia",26,4,22,0,0,0,0,0,26,24,2,22,0,0,0,0,0,2,2,0,0,0,0,0,0,110010076042011,6,606,606,6,psa_7,6D2
1000000US110010009011004,"Block 1004, Block Group 1, Census Tract 9.01, District of Columbia, District of Columbia",115,105,4,0,4,0,1,1,115,113,104,4,0,4,0,0,1,2,1,0,0,0,0,1,0,110010009011004,2,205,205,2,psa_46,2D2
1000000US110010055001006,"Block 1006, Block Group 1, Census Tract 55, District of Columbia, District of Columbia",0,0,0,0,0,0,0,0,0,0,0,0,0,0,0,0,0,0,0,0,0,0,0,0,0,110010055001006,2,208,208,2,psa_33,2D3
1000000US110010097001000,"Block 1000, Block Group 1, Census Tract 97, District of Columbia, District of Columbia",0,0,0,0,0,0,0,0,0,0,0,0,0,0,0,0,0,0,0,0,0,0,0,0,0,110010097001000,7,705,705,7,psa_3,7D2
1000000US110010021021001,"Block 1001, Block Group 1, Census Tract 21.02, District of Columbia, District of Columbia",73,6,65,0,0,0,0,2,73,71,4,65,0,0,0,0,2,2,2,0,0,0,0,0,0,110010021021001,4,406,406,4,psa_54,4D2
1000000US110010088042004,"Block 2004, Block Group 2, Census Tract 88.04, District of Columbia, District of Columbia",139,3,130,0,0,0,6,0,139,131,2,129,0,0,0,0,0,8,1,1,0,0,0,6,0,110010088042004,5,506,506,5,psa_26,5D3
1000000US110010099051003,"Block 1003, Block Group 1, Census Tract 99.05, District of Columbia, District of Columbia",27,0,27,0,0,0,0,0,27,27,0,27,0,0,0,0,0,0,0,0,0,0,0,0,0,110010099051003,6,604,604,6,psa_14,6D3
1000000US110010104002025,"Block 2025, Block Group 2, Census Tract 104, District of Columbia, District of Columbia",0,0,0,0,0,0,0,0,0,0,0,0,0,0,0,0,0,0,0,0,0,0,0,0,0,110010104002025,7,703,703,7,psa_8,7D1
1000000US110010002024008,"Block 4008, Block Group 4, Census Tract 2.02, District of Columbia, District of Columbia",0,0,0,0,0,0,0,0,0,0,0,0,0,0,0,0,0,0,0,0,0,0,0,0,0,110010002024008,2,206,206,2,psa_29,2D2
1000000US110010087021009,"Block 1009, Block Group 1, Census Tract 87.02, District of Columbia, District of Columbia",115,13,100,0,2,0,0,0,115,114,13,100,0,1,0,0,0,1,0,0,0,1,0,0,0,110010087021009,5,502,502,5,psa_40,5D1
1000000US110010101002003,"Block 2003, Block Group 2, Census Tract 101, District of Columbia, District of Columbia",0,0,0,0,0,0,0,0,0,0,0,0,0,0,0,0,0,0,0,0,0,0,0,0,0,110010101002003,2,207,207,2,psa_24,2D3
1000000US110010001004043,"Block 4043, Block Group 4, Census Tract 1, District of Columbia, District of Columbia",0,0,0,0,0,0,0,0,0,0,0,0,0,0,0,0,0,0,0,0,0,0,0,0,0,110010001004043,2,206,206,2,psa_29,2D2
1000000US110010089031010,"Block 1010, Block Group 1, Census Tract 89.03, District of Columbia, District of Columbia",150,10,134,0,0,0,1,5,150,147,9,134,0,0,0,1,3,3,1,0,0,0,0,0,2,110010089031010,5,507,507,5,psa_23,5D3
1000000US110010089042009,"Block 2009, Block Group 2, Census Tract 89.04, District of Columbia, District of Columbia",167,4,153,0,4,0,1,5,167,165,3,153,0,4,0,0,5,2,1,0,0,0,0,1,0,110010089042009,5,507,507,5,psa_23,5D3
1000000US110010070002000,"Block 2000, Block Group 2, Census Tract 70, District of Columbia, District of Columbia",0,0,0,0,0,0,0,0,0,0,0,0,0,0,0,0,0,0,0,0,0,0,0,0,0,110010070002000,1,107,107,1,psa_16,1D2
1000000US110010076042009,"Block 2009, Block Group 2, Census Tract 76.04, District of Columbia, District of Columbia",67,5,58,0,0,0,0,4,67,67,5,58,0,0,0,0,4,0,0,0,0,0,0,0,0,110010076042009,6,606,606,6,psa_7,6D2
1000000US110010062021133,"Block 1133, Block Group 1, Census Tract 62.02, District of Columbia, District of Columbia",0,0,0,0,0,0,0,0,0,0,0,0,0,0,0,0,0,0,0,0,0,0,0,0,0,110010062021133,1,102,102,1,psa_18,1D1
1000000US110010081002005,"Block 2005, Block Group 2, Census Tract 81, District of Columbia, District of Columbia",161,120,27,1,5,0,0,8,161,155,116,25,1,5,0,0,8,6,4,2,0,0,0,0,0,110010081002005,1,108,108,1,psa_17,1D2
1000000US110010087021002,"Block 1002, Block Group 1, Census Tract 87.02, District of Columbia, District of Columbia",5,0,1,0,0,0,4,0,5,1,0,1,0,0,0,0,0,4,0,0,0,0,0,4,0,110010087021002,5,502,502,5,psa_40,5D1
1000000US110010036003002,"Block 3002, Block Group 3, Census Tract 36, District of Columbia, District of Columbia",328,192,83,1,12,0,28,12,328,278,174,80,1,11,0,1,11,50,18,3,0,1,0,27,1,110010036003002,3,304,304,3,psa_36,3D1
1000000US110010027021002,"Block 1002, Block Group 1, Census Tract 27.02, District of Columbia, District of Columbia",0,0,0,0,0,0,0,0,0,0,0,0,0,0,0,0,0,0,0,0,0,0,0,0,0,110010027021002,3,302,302,3,psa_42,3D1
1000000US110010101001026,"Block 1026, Block Group 1, Census Tract 101, District of Columbia, District of Columbia",0,0,0,0,0,0,0,0,0,0,0,0,0,0,0,0,0,0,0,0,0,0,0,0,0,110010101001026,2,207,207,2,psa_24,2D3
1000000US110010076012009,"Block 2009, Block Group 2, Census Tract 76.01, District of Columbia, District of Columbia",91,11,79,0,1,0,0,0,91,91,11,79,0,1,0,0,0,0,0,0,0,0,0,0,0,110010076012009,6,607,607,6,psa_10,6D2
1000000US110010098022002,"Block 2002, Block Group 2, Census Tract 98.02, District of Columbia, District of Columbia",118,2,114,0,0,0,0,2,118,116,2,113,0,0,0,0,1,2,0,1,0,0,0,0,1,110010098022002,7,706,706,7,psa_2,7D3
1000000US110010099012026,"Block 2026, Block Group 2, Census Tract 99.01, District of Columbia, District of Columbia",110,5,105,0,0,0,0,0,110,109,5,104,0,0,0,0,0,1,0,1,0,0,0,0,0,110010099012026,6,605,605,6,psa_11,6D2
1000000US110010105002005,"Block 2005, Block Group 2, Census Tract 105, District of Columbia, District of Columbia",0,0,0,0,0,0,0,0,0,0,0,0,0,0,0,0,0,0,0,0,0,0,0,0,0,110010105002005,1,103,103,1,psa_12,1D1
1000000US110010025023000,"Block 3000, Block Group 3, Census Tract 25.02, District of Columbia, District of Columbia",192,34,67,0,3,0,67,21,192,109,31,67,0,3,0,0,8,83,3,0,0,0,0,67,13,110010025023000,4,404,404,4,psa_48,4D3
1000000US110010018031010,"Block 1010, Block Group 1, Census Tract 18.03, District of Columbia, District of Columbia",0,0,0,0,0,0,0,0,0,0,0,0,0,0,0,0,0,0,0,0,0,0,0,0,0,110010018031010,2,201,201,2,psa_55,2D1
1000000US110010092041002,"Block 1002, Block Group 1, Census Tract 92.04, District of Columbia, District of Columbia",211,45,156,1,0,0,9,0,211,195,40,154,1,0,0,0,0,16,5,2,0,0,0,9,0,110010092041002,5,502,502,5,psa_40,5D1
1000000US110010103002011,"Block 2011, Block Group 2, Census Tract 103, District of Columbia, District of Columbia",0,0,0,0,0,0,0,0,0,0,0,0,0,0,0,0,0,0,0,0,0,0,0,0,0,110010103002011,4,401,401,4,psa_56,4D1
1000000US110010025024004,"Block 4004, Block Group 4, Census Tract 25.02, District of Columbia, District of Columbia",534,120,155,9,12,0,203,35,534,169,28,124,1,12,0,1,3,365,92,31,8,0,0,202,32,110010025024004,4,404,404,4,psa_48,4D3
1000000US110010093013020,"Block 3020, Block Group 3, Census Tract 93.01, District of Columbia, District of Columbia",0,0,0,0,0,0,0,0,0,0,0,0,0,0,0,0,0,0,0,0,0,0,0,0,0,110010093013020,5,504,504,5,psa_43,5D2
1000000US110010103001014,"Block 1014, Block Group 1, Census Tract 103, District of Columbia, District of Columbia",69,24,39,0,3,0,0,3,69,69,24,39,0,3,0,0,3,0,0,0,0,0,0,0,0,110010103001014,4,401,401,4,psa_56,4D1
1000000US110010002021004,"Block 1004, Block Group 1, Census Tract 2.02, District of Columbia, District of Columbia",107,89,1,0,13,0,2,2,107,104,86,1,0,13,0,2,2,3,3,0,0,0,0,0,0,110010002021004,2,206,206,2,psa_29,2D2
1000000US110010021014005,"Block 4005, Block Group 4, Census Tract 21.01, District of Columbia, District of Columbia",0,0,0,0,0,0,0,0,0,0,0,0,0,0,0,0,0,0,0,0,0,0,0,0,0,110010021014005,4,403,403,4,psa_51,4D1
1000000US110010077082016,"Block 2016, Block Group 2, Census Tract 77.08, District of Columbia, District of Columbia",40,0,40,0,0,0,0,0,40,40,0,40,0,0,0,0,0,0,0,0,0,0,0,0,0,110010077082016,6,603,603,6,psa_15,6D3
1000000US110010043002006,"Block 2006, Block Group 2, Census Tract 43, District of Columbia, District of Columbia",225,148,52,1,8,0,10,6,225,194,131,51,0,8,0,0,4,31,17,1,1,0,0,10,2,110010043002006,3,301,301,3,psa_31,3D3
1000000US110010062021128,"Block 1128, Block Group 1, Census Tract 62.02, District of Columbia, District of Columbia",0,0,0,0,0,0,0,0,0,0,0,0,0,0,0,0,0,0,0,0,0,0,0,0,0,110010062021128,1,102,102,1,psa_18,1D1
1000000US110010104002003,"Block 2003, Block Group 2, Census Tract 104, District of Columbia, District of Columbia",0,0,0,0,0,0,0,0,0,0,0,0,0,0,0,0,0,0,0,0,0,0,0,0,0,110010104002003,7,703,703,7,psa_8,7D1
1000000US110010096011042,"Block 1042, Block Group 1, Census Tract 96.01, District of Columbia, District of Columbia",0,0,0,0,0,0,0,0,0,0,0,0,0,0,0,0,0,0,0,0,0,0,0,0,0,110010096011042,6,602,602,6,psa_25,6D1
1000000US110010010014021,"Block 4021, Block Group 4, Census Tract 10.01, District of Columbia, District of Columbia",248,196,22,0,25,1,3,1,248,238,189,22,0,25,1,0,1,10,7,0,0,0,0,3,0,110010010014021,2,202,202,2,psa_52,2D1
1000000US110010026002003,"Block 2003, Block Group 2, Census Tract 26, District of Columbia, District of Columbia",0,0,0,0,0,0,0,0,0,0,0,0,0,0,0,0,0,0,0,0,0,0,0,0,0,110010026002003,2,203,203,2,psa_50,2D1
1000000US110010015003000,"Block 3000, Block Group 3, Census Tract 15, District of Columbia, District of Columbia",20,20,0,0,0,0,0,0,20,17,17,0,0,0,0,0,0,3,3,0,0,0,0,0,0,110010015003000,2,201,201,2,psa_55,2D1
1000000US110010072002020,"Block 2020, Block Group 2, Census Tract 72, District of Columbia, District of Columbia",0,0,0,0,0,0,0,0,0,0,0,0,0,0,0,0,0,0,0,0,0,0,0,0,0,110010072002020,1,106,106,1,psa_13,1D3
1000000US110010077072022,"Block 2022, Block Group 2, Census Tract 77.07, District of Columbia, District of Columbia",34,3,30,0,0,0,0,1,34,34,3,30,0,0,0,0,1,0,0,0,0,0,0,0,0,110010077072022,6,604,604,6,psa_14,6D3
1000000US110010078081007,"Block 1007, Block Group 1, Census Tract 78.08, District of Columbia, District of Columbia",136,0,133,3,0,0,0,0,136,135,0,132,3,0,0,0,0,1,0,1,0,0,0,0,0,110010078081007,6,608,608,6,psa_19,6D1
1000000US110010032001006,"Block 1006, Block Group 1, Census Tract 32, District of Columbia, District of Columbia",152,23,109,0,3,0,12,5,152,132,21,107,0,3,0,0,1,20,2,2,0,0,0,12,4,110010032001006,4,409,409,4,psa_41,4D3
1000000US110010102002036,"Block 2036, Block Group 2, Census Tract 102, District of Columbia, District of Columbia",0,0,0,0,0,0,0,0,0,0,0,0,0,0,0,0,0,0,0,0,0,0,0,0,0,110010102002036,1,103,103,1,psa_12,1D1
1000000US110010103001011,"Block 1011, Block Group 1, Census Tract 103, District of Columbia, District of Columbia",2,1,0,0,0,0,0,1,2,2,1,0,0,0,0,0,1,0,0,0,0,0,0,0,0,110010103001011,4,401,401,4,psa_56,4D1
1000000US110010022023005,"Block 3005, Block Group 3, Census Tract 22.02, District of Columbia, District of Columbia",148,13,100,3,7,0,19,6,148,113,13,91,0,7,0,0,2,35,0,9,3,0,0,19,4,110010022023005,4,407,407,4,psa_47,4D2
1000000US110010062021103,"Block 1103, Block Group 1, Census Tract 62.02, District of Columbia, District of Columbia",0,0,0,0,0,0,0,0,0,0,0,0,0,0,0,0,0,0,0,0,0,0,0,0,0,110010062021103,1,103,103,1,psa_12,1D1
1000000US110010094002003,"Block 2003, Block Group 2, Census Tract 94, District of Columbia, District of Columbia",0,0,0,0,0,0,0,0,0,0,0,0,0,0,0,0,0,0,0,0,0,0,0,0,0,110010094002003,5,503,503,5,psa_45,5D2
1000000US110010099012024,"Block 2024, Block Group 2, Census Tract 99.01, District of Columbia, District of Columbia",47,5,39,0,0,0,2,1,47,42,4,37,0,0,0,0,1,5,1,2,0,0,0,2,0,110010099012024,6,605,605,6,psa_11,6D2
1000000US110010026002030,"Block 2030, Block Group 2, Census Tract 26, District of Columbia, District of Columbia",40,13,22,0,5,0,0,0,40,36,9,22,0,5,0,0,0,4,4,0,0,0,0,0,0,110010026002030,4,404,404,4,psa_48,4D3
1000000US110010071001030,"Block 1030, Block Group 1, Census Tract 71, District of Columbia, District of Columbia",0,0,0,0,0,0,0,0,0,0,0,0,0,0,0,0,0,0,0,0,0,0,0,0,0,110010071001030,1,106,106,1,psa_13,1D3
1000000US110010046001002,"Block 1002, Block Group 1, Census Tract 46, District of Columbia, District of Columbia",172,37,116,0,11,0,0,8,172,160,32,112,0,11,0,0,5,12,5,4,0,0,0,0,3,110010046001002,3,308,308,3,psa_27,3D2
1000000US110010104002033,"Block 2033, Block Group 2, Census Tract 104, District of Columbia, District of Columbia",264,15,238,2,3,0,1,5,264,255,15,234,1,3,0,0,2,9,0,4,1,0,0,1,3,110010104002033,7,703,703,7,psa_8,7D1
1000000US110010026001003,"Block 1003, Block Group 1, Census Tract 26, District of Columbia, District of Columbia",46,25,21,0,0,0,0,0,46,45,24,21,0,0,0,0,0,1,1,0,0,0,0,0,0,110010026001003,4,404,404,4,psa_48,4D3
1000000US110010075021003,"Block 1003, Block Group 1, Census Tract 75.02, District of Columbia, District of Columbia",223,0,222,0,1,0,0,0,223,223,0,222,0,1,0,0,0,0,0,0,0,0,0,0,0,110010075021003,7,702,702,7,psa_6,7D1
1000000US110010107001020,"Block 1020, Block Group 1, Census Tract 107, District of Columbia, District of Columbia",0,0,0,0,0,0,0,0,0,0,0,0,0,0,0,0,0,0,0,0,0,0,0,0,0,110010107001020,2,207,207,2,psa_24,2D3
1000000US110010106002031,"Block 2031, Block Group 2, Census Tract 106, District of Columbia, District of Columbia",0,0,0,0,0,0,0,0,0,0,0,0,0,0,0,0,0,0,0,0,0,0,0,0,0,110010106002031,1,102,102,1,psa_18,1D1
1000000US110010053012001,"Block 2001, Block Group 2, Census Tract 53.01, District of Columbia, District of Columbia",553,485,14,0,34,0,6,14,553,521,459,14,0,34,0,0,14,32,26,0,0,0,0,6,0,110010053012001,2,208,208,2,psa_33,2D3
1000000US110010076033003,"Block 3003, Block Group 3, Census Tract 76.03, District of Columbia, District of Columbia",67,11,53,0,0,0,3,0,67,64,11,53,0,0,0,0,0,3,0,0,0,0,0,3,0,110010076033003,6,606,606,6,psa_7,6D2
1000000US110010059001027,"Block 1027, Block Group 1, Census Tract 59, District of Columbia, District of Columbia",0,0,0,0,0,0,0,0,0,0,0,0,0,0,0,0,0,0,0,0,0,0,0,0,0,110010059001027,1,102,102,1,psa_18,1D1
1000000US110010096021016,"Block 1016, Block Group 1, Census Tract 96.02, District of Columbia, District of Columbia",0,0,0,0,0,0,0,0,0,0,0,0,0,0,0,0,0,0,0,0,0,0,0,0,0,110010096021016,6,601,601,6,psa_30,6D1
1000000US110010001004004,"Block 4004, Block Group 4, Census Tract 1, District of Columbia, District of Columbia",78,63,8,0,5,0,0,2,78,73,58,8,0,5,0,0,2,5,5,0,0,0,0,0,0,110010001004004,2,206,206,2,psa_29,2D2
1000000US110010078061017,"Block 1017, Block Group 1, Census Tract 78.06, District of Columbia, District of Columbia",61,1,54,0,0,0,0,6,61,61,1,54,0,0,0,0,6,0,0,0,0,0,0,0,0,110010078061017,6,602,602,6,psa_25,6D1
1000000US110010078081006,"Block 1006, Block Group 1, Census Tract 78.08, District of Columbia, District of Columbia",120,2,118,0,0,0,0,0,120,120,2,118,0,0,0,0,0,0,0,0,0,0,0,0,0,110010078081006,6,608,608,6,psa_19,6D1
1000000US110010093012018,"Block 2018, Block Group 2, Census Tract 93.01, District of Columbia, District of Columbia",98,28,60,1,0,0,2,7,98,85,23,59,1,0,0,0,2,13,5,1,0,0,0,2,5,110010093012018,5,504,504,5,psa_43,5D2
1000000US110010008022000,"Block 2000, Block Group 2, Census Tract 8.02, District of Columbia, District of Columbia",0,0,0,0,0,0,0,0,0,0,0,0,0,0,0,0,0,0,0,0,0,0,0,0,0,110010008022000,2,204,204,2,psa_44,2D2
1000000US110010027022000,"Block 2000, Block Group 2, Census Tract 27.02, District of Columbia, District of Columbia",270,224,18,3,5,0,9,11,270,228,198,18,0,5,0,0,7,42,26,0,3,0,0,9,4,110010027022000,3,302,302,3,psa_42,3D1
1000000US110010010011003,"Block 1003, Block Group 1, Census Tract 10.01, District of Columbia, District of Columbia",56,48,2,0,2,0,2,2,56,44,39,2,0,2,0,0,1,12,9,0,0,0,0,2,1,110010010011003,2,202,202,2,psa_52,2D1
1000000US110010076031004,"Block 1004, Block Group 1, Census Tract 76.03, District of Columbia, District of Columbia",259,13,240,5,0,0,1,0,259,251,13,233,5,0,0,0,0,8,0,7,0,0,0,1,0,110010076031004,6,606,606,6,psa_7,6D2
1000000US110010099042006,"Block 2006, Block Group 2, Census Tract 99.04, District of Columbia, District of Columbia",152,3,136,3,0,0,6,4,152,134,1,128,2,0,0,0,3,18,2,8,1,0,0,6,1,110010099042006,6,604,604,6,psa_14,6D3
1000000US110010020023003,"Block 3003, Block Group 3, Census Tract 20.02, District of Columbia, District of Columbia",142,2,102,0,0,0,38,0,142,99,2,97,0,0,0,0,0,43,0,5,0,0,0,38,0,110010020023003,4,403,403,4,psa_51,4D1
1000000US110010024004003,"Block 4003, Block Group 4, Census Tract 24, District of Columbia, District of Columbia",188,58,99,5,0,0,25,1,188,122,26,95,0,0,0,0,1,66,32,4,5,0,0,25,0,110010024004003,4,407,407,4,psa_47,4D2
1000000US110010007014003,"Block 4003, Block Group 4, Census Tract 7.01, District of Columbia, District of Columbia",370,307,22,0,20,4,4,13,370,348,289,22,0,20,4,3,10,22,18,0,0,0,0,1,3,110010007014003,2,204,204,2,psa_44,2D2
1000000US110010059001025,"Block 1025, Block Group 1, Census Tract 59, District of Columbia, District of Columbia",169,16,128,3,0,0,16,6,169,131,10,116,3,0,0,0,2,38,6,12,0,0,0,16,4,110010059001025,1,101,101,1,psa_20,1D1
1000000US110010068022002,"Block 2002, Block Group 2, Census Tract 68.02, District of Columbia, District of Columbia",168,85,67,0,0,0,8,8,168,153,82,65,0,0,0,2,4,15,3,2,0,0,0,6,4,110010068022002,1,107,107,1,psa_16,1D2
1000000US110010016002012,"Block 2012, Block Group 2, Census Tract 16, District of Columbia, District of Columbia",45,17,28,0,0,0,0,0,45,43,16,27,0,0,0,0,0,2,1,1,0,0,0,0,0,110010016002012,4,401,401,4,psa_56,4D1
1000000US110010084101010,"Block 1010, Block Group 1, Census Tract 84.10, District of Columbia, District of Columbia",59,27,26,1,1,0,4,0,59,54,22,26,1,1,0,4,0,5,5,0,0,0,0,0,0,110010084101010,5,501,501,5,psa_35,5D1
1000000US110010095011004,"Block 1004, Block Group 1, Census Tract 95.01, District of Columbia, District of Columbia",344,32,278,0,2,0,21,11,344,315,31,274,0,2,0,1,7,29,1,4,0,0,0,20,4,110010095011004,4,405,405,4,psa_49,4D2
1000000US110010079013001,"Block 3001, Block Group 3, Census Tract 79.01, District of Columbia, District of Columbia",480,28,421,3,2,0,4,22,480,464,22,418,3,2,0,3,16,16,6,3,0,0,0,1,6,110010079013001,5,507,507,5,psa_23,5D3
1000000US110010088042017,"Block 2017, Block Group 2, Census Tract 88.04, District of Columbia, District of Columbia",0,0,0,0,0,0,0,0,0,0,0,0,0,0,0,0,0,0,0,0,0,0,0,0,0,110010088042017,5,506,506,5,psa_26,5D3
1000000US110010076012004,"Block 2004, Block Group 2, Census Tract 76.01, District of Columbia, District of Columbia",0,0,0,0,0,0,0,0,0,0,0,0,0,0,0,0,0,0,0,0,0,0,0,0,0,110010076012004,6,607,607,6,psa_10,6D2
1000000US110010111001035,"Block 1035, Block Group 1, Census Tract 111, District of Columbia, District of Columbia",91,0,73,0,0,0,4,14,91,73,0,71,0,0,0,0,2,18,0,2,0,0,0,4,12,110010111001035,5,503,503,5,psa_45,5D2
1000000US110010013011018,"Block 1018, Block Group 1, Census Tract 13.01, District of Columbia, District of Columbia",22,13,7,0,0,0,2,0,22,20,13,7,0,0,0,0,0,2,0,0,0,0,0,2,0,110010013011018,2,203,203,2,psa_50,2D1
1000000US110010101001021,"Block 1021, Block Group 1, Census Tract 101, District of Columbia, District of Columbia",0,0,0,0,0,0,0,0,0,0,0,0,0,0,0,0,0,0,0,0,0,0,0,0,0,110010101001021,2,209,209,2,psa_57,2D3
1000000US110010018042016,"Block 2016, Block Group 2, Census Tract 18.04, District of Columbia, District of Columbia",0,0,0,0,0,0,0,0,0,0,0,0,0,0,0,0,0,0,0,0,0,0,0,0,0,110010018042016,4,402,402,4,psa_53,4D1
1000000US110010094004018,"Block 4018, Block Group 4, Census Tract 94, District of Columbia, District of Columbia",22,0,22,0,0,0,0,0,22,22,0,22,0,0,0,0,0,0,0,0,0,0,0,0,0,110010094004018,5,503,503,5,psa_45,5D2
1000000US110010093012021,"Block 2021, Block Group 2, Census Tract 93.01, District of Columbia, District of Columbia",50,16,30,0,0,0,4,0,50,42,12,30,0,0,0,0,0,8,4,0,0,0,0,4,0,110010093012021,5,504,504,5,psa_43,5D2
1000000US110010004001004,"Block 1004, Block Group 1, Census Tract 4, District of Columbia, District of Columbia",31,31,0,0,0,0,0,0,31,29,29,0,0,0,0,0,0,2,2,0,0,0,0,0,0,110010004001004,2,204,204,2,psa_44,2D2
1000000US110010101001007,"Block 1007, Block Group 1, Census Tract 101, District of Columbia, District of Columbia",0,0,0,0,0,0,0,0,0,0,0,0,0,0,0,0,0,0,0,0,0,0,0,0,0,110010101001007,2,207,207,2,psa_24,2D3
1000000US110010103003007,"Block 3007, Block Group 3, Census Tract 103, District of Columbia, District of Columbia",175,19,90,8,3,0,33,22,175,107,12,85,0,3,0,1,6,68,7,5,8,0,0,32,16,110010103003007,4,401,401,4,psa_56,4D1
1000000US110010019021018,"Block 1018, Block Group 1, Census Tract 19.02, District of Columbia, District of Columbia",64,3,53,0,0,0,0,8,64,64,3,53,0,0,0,0,8,0,0,0,0,0,0,0,0,110010019021018,4,402,402,4,psa_53,4D1
1000000US110010041002015,"Block 2015, Block Group 2, Census Tract 41, District of Columbia, District of Columbia",31,22,1,0,6,0,0,2,31,31,22,1,0,6,0,0,2,0,0,0,0,0,0,0,0,110010041002015,2,208,208,2,psa_33,2D3
1000000US110010053011000,"Block 1000, Block Group 1, Census Tract 53.01, District of Columbia, District of Columbia",269,232,9,0,10,0,11,7,269,252,227,9,0,9,0,0,7,17,5,0,0,1,0,11,0,110010053011000,3,301,301,3,psa_31,3D3
1000000US110010087022004,"Block 2004, Block Group 2, Census Tract 87.02, District of Columbia, District of Columbia",75,18,57,0,0,0,0,0,75,74,17,57,0,0,0,0,0,1,1,0,0,0,0,0,0,110010087022004,5,502,502,5,psa_40,5D1
1000000US110010098011001,"Block 1001, Block Group 1, Census Tract 98.01, District of Columbia, District of Columbia",0,0,0,0,0,0,0,0,0,0,0,0,0,0,0,0,0,0,0,0,0,0,0,0,0,110010098011001,7,706,706,7,psa_2,7D3
1000000US110010104001003,"Block 1003, Block Group 1, Census Tract 104, District of Columbia, District of Columbia",0,0,0,0,0,0,0,0,0,0,0,0,0,0,0,0,0,0,0,0,0,0,0,0,0,110010104001003,7,705,705,7,psa_3,7D2
1000000US110010013013003,"Block 3003, Block Group 3, Census Tract 13.01, District of Columbia, District of Columbia",237,213,9,2,8,0,0,5,237,229,206,9,2,8,0,0,4,8,7,0,0,0,0,0,1,110010013013003,2,203,203,2,psa_50,2D1
1000000US110010104001026,"Block 1026, Block Group 1, Census Tract 104, District of Columbia, District of Columbia",0,0,0,0,0,0,0,0,0,0,0,0,0,0,0,0,0,0,0,0,0,0,0,0,0,110010104001026,7,707,707,7,psa_4,7D2
1000000US110010072001012,"Block 1012, Block Group 1, Census Tract 72, District of Columbia, District of Columbia",0,0,0,0,0,0,0,0,0,0,0,0,0,0,0,0,0,0,0,0,0,0,0,0,0,110010072001012,1,106,106,1,psa_13,1D3
1000000US110010093014001,"Block 4001, Block Group 4, Census Tract 93.01, District of Columbia, District of Columbia",85,43,22,3,7,0,4,6,85,78,43,22,3,7,0,1,2,7,0,0,0,0,0,3,4,110010093014001,5,504,504,5,psa_43,5D2
1000000US110010036001001,"Block 1001, Block Group 1, Census Tract 36, District of Columbia, District of Columbia",636,104,462,1,3,0,52,14,636,547,81,454,1,3,0,0,8,89,23,8,0,0,0,52,6,110010036001001,3,304,304,3,psa_36,3D1
1000000US110010062021081,"Block 1081, Block Group 1, Census Tract 62.02, District of Columbia, District of Columbia",0,0,0,0,0,0,0,0,0,0,0,0,0,0,0,0,0,0,0,0,0,0,0,0,0,110010062021081,2,207,207,2,psa_24,2D3
1000000US110010076012011,"Block 2011, Block Group 2, Census Tract 76.01, District of Columbia, District of Columbia",9,1,7,1,0,0,0,0,9,9,1,7,1,0,0,0,0,0,0,0,0,0,0,0,0,110010076012011,6,607,607,6,psa_10,6D2
1000000US110010055002004,"Block 2004, Block Group 2, Census Tract 55, District of Columbia, District of Columbia",282,232,9,1,30,0,3,7,282,264,217,9,1,30,0,0,7,18,15,0,0,0,0,3,0,110010055002004,2,208,208,2,psa_33,2D3
1000000US110010102002028,"Block 2028, Block Group 2, Census Tract 102, District of Columbia, District of Columbia",0,0,0,0,0,0,0,0,0,0,0,0,0,0,0,0,0,0,0,0,0,0,0,0,0,110010102002028,1,103,103,1,psa_12,1D1
1000000US110010014023007,"Block 3007, Block Group 3, Census Tract 14.02, District of Columbia, District of Columbia",78,58,11,1,4,0,2,2,78,74,56,11,0,4,0,1,2,4,2,0,1,0,0,1,0,110010014023007,2,203,203,2,psa_50,2D1
1000000US110010078061016,"Block 1016, Block Group 1, Census Tract 78.06, District of Columbia, District of Columbia",28,0,28,0,0,0,0,0,28,28,0,28,0,0,0,0,0,0,0,0,0,0,0,0,0,110010078061016,6,602,602,6,psa_25,6D1
1000000US110010010023003,"Block 3003, Block Group 3, Census Tract 10.02, District of Columbia, District of Columbia",31,29,0,0,2,0,0,0,31,24,22,0,0,2,0,0,0,7,7,0,0,0,0,0,0,110010010023003,2,202,202,2,psa_52,2D1
1000000US110010070001004,"Block 1004, Block Group 1, Census Tract 70, District of Columbia, District of Columbia",105,93,8,0,0,0,1,3,105,101,90,8,0,0,0,0,3,4,3,0,0,0,0,1,0,110010070001004,1,106,106,1,psa_13,1D3
1000000US110010092011004,"Block 1004, Block Group 1, Census Tract 92.01, District of Columbia, District of Columbia",662,199,396,0,26,1,23,17,662,609,173,394,0,26,1,3,12,53,26,2,0,0,0,20,5,110010092011004,5,502,502,5,psa_40,5D1
1000000US110010026002011,"Block 2011, Block Group 2, Census Tract 26, District of Columbia, District of Columbia",0,0,0,0,0,0,0,0,0,0,0,0,0,0,0,0,0,0,0,0,0,0,0,0,0,110010026002011,4,403,403,4,psa_51,4D1
1000000US110010038001001,"Block 1001, Block Group 1, Census Tract 38, District of Columbia, District of Columbia",463,270,82,1,20,0,79,11,463,323,215,77,1,20,0,0,10,140,55,5,0,0,0,79,1,110010038001001,3,303,303,3,psa_37,3D3
1000000US110010062021145,"Block 1145, Block Group 1, Census Tract 62.02, District of Columbia, District of Columbia",0,0,0,0,0,0,0,0,0,0,0,0,0,0,0,0,0,0,0,0,0,0,0,0,0,110010062021145,1,102,102,1,psa_18,1D1
1000000US110010080011001,"Block 1001, Block Group 1, Census Tract 80.01, District of Columbia, District of Columbia",145,69,76,0,0,0,0,0,145,142,66,76,0,0,0,0,0,3,3,0,0,0,0,0,0,110010080011001,1,104,104,1,psa_21,1D2
1000000US110010068041005,"Block 1005, Block Group 1, Census Tract 68.04, District of Columbia, District of Columbia",0,0,0,0,0,0,0,0,0,0,0,0,0,0,0,0,0,0,0,0,0,0,0,0,0,110010068041005,1,108,108,1,psa_17,1D2
1000000US110010053012002,"Block 2002, Block Group 2, Census Tract 53.01, District of Columbia, District of Columbia",9,8,0,0,1,0,0,0,9,9,8,0,0,1,0,0,0,0,0,0,0,0,0,0,0,110010053012002,2,208,208,2,psa_33,2D3
1000000US110010068041018,"Block 1018, Block Group 1, Census Tract 68.04, District of Columbia, District of Columbia",0,0,0,0,0,0,0,0,0,0,0,0,0,0,0,0,0,0,0,0,0,0,0,0,0,110010068041018,1,107,107,1,psa_16,1D2
1000000US110010099031001,"Block 1001, Block Group 1, Census Tract 99.03, District of Columbia, District of Columbia",303,3,288,0,0,0,5,7,303,292,3,284,0,0,0,0,5,11,0,4,0,0,0,5,2,110010099031001,6,604,604,6,psa_14,6D3
1000000US110010014011007,"Block 1007, Block Group 1, Census Tract 14.01, District of Columbia, District of Columbia",0,0,0,0,0,0,0,0,0,0,0,0,0,0,0,0,0,0,0,0,0,0,0,0,0,110010014011007,2,201,201,2,psa_55,2D1
1000000US110010083012001,"Block 2001, Block Group 2, Census Tract 83.01, District of Columbia, District of Columbia",0,0,0,0,0,0,0,0,0,0,0,0,0,0,0,0,0,0,0,0,0,0,0,0,0,110010083012001,1,104,104,1,psa_21,1D2
1000000US110010050011002,"Block 1002, Block Group 1, Census Tract 50.01, District of Columbia, District of Columbia",24,21,0,0,3,0,0,0,24,23,20,0,0,3,0,0,0,1,1,0,0,0,0,0,0,110010050011002,3,307,307,3,psa_28,3D3
1000000US110010071002004,"Block 2004, Block Group 2, Census Tract 71, District of Columbia, District of Columbia",753,22,712,1,6,0,0,12,753,749,21,711,1,6,0,0,10,4,1,1,0,0,0,0,2,110010071002004,1,106,106,1,psa_13,1D3
1000000US110010040013000,"Block 3000, Block Group 3, Census Tract 40.01, District of Columbia, District of Columbia",121,111,2,0,5,0,0,3,121,110,101,1,0,5,0,0,3,11,10,1,0,0,0,0,0,110010040013000,3,303,303,3,psa_37,3D3
1000000US110010041003022,"Block 3022, Block Group 3, Census Tract 41, District of Columbia, District of Columbia",0,0,0,0,0,0,0,0,0,0,0,0,0,0,0,0,0,0,0,0,0,0,0,0,0,110010041003022,2,208,208,2,psa_33,2D3
1000000US110010078043007,"Block 3007, Block Group 3, Census Tract 78.04, District of Columbia, District of Columbia",0,0,0,0,0,0,0,0,0,0,0,0,0,0,0,0,0,0,0,0,0,0,0,0,0,110010078043007,6,602,602,6,psa_25,6D1
1000000US110010018041007,"Block 1007, Block Group 1, Census Tract 18.04, District of Columbia, District of Columbia",127,21,90,0,2,0,5,9,127,113,13,90,0,2,0,0,8,14,8,0,0,0,0,5,1,110010018041007,4,402,402,4,psa_53,4D1
1000000US110010050011003,"Block 1003, Block Group 1, Census Tract 50.01, District of Columbia, District of Columbia",224,186,18,0,14,0,3,3,224,208,173,18,0,14,0,1,2,16,13,0,0,0,0,2,1,110010050011003,3,307,307,3,psa_28,3D3
1000000US110010016004005,"Block 4005, Block Group 4, Census Tract 16, District of Columbia, District of Columbia",84,0,82,0,0,0,0,2,84,81,0,79,0,0,0,0,2,3,0,3,0,0,0,0,0,110010016004005,4,401,401,4,psa_56,4D1
1000000US110010095032003,"Block 2003, Block Group 2, Census Tract 95.03, District of Columbia, District of Columbia",54,2,44,0,2,0,6,0,54,48,2,44,0,2,0,0,0,6,0,0,0,0,0,6,0,110010095032003,5,504,504,5,psa_43,5D2
1000000US110010107002000,"Block 2000, Block Group 2, Census Tract 107, District of Columbia, District of Columbia",0,0,0,0,0,0,0,0,0,0,0,0,0,0,0,0,0,0,0,0,0,0,0,0,0,110010107002000,2,208,208,2,psa_33,2D3
1000000US110010074081011,"Block 1011, Block Group 1, Census Tract 74.08, District of Columbia, District of Columbia",197,2,188,1,0,0,1,5,197,197,2,188,1,0,0,1,5,0,0,0,0,0,0,0,0,110010074081011,7,702,702,7,psa_6,7D1
1000000US110010104001013,"Block 1013, Block Group 1, Census Tract 104, District of Columbia, District of Columbia",33,0,33,0,0,0,0,0,33,33,0,33,0,0,0,0,0,0,0,0,0,0,0,0,0,110010104001013,7,705,705,7,psa_3,7D2
1000000US110010080022018,"Block 2018, Block Group 2, Census Tract 80.02, District of Columbia, District of Columbia",0,0,0,0,0,0,0,0,0,0,0,0,0,0,0,0,0,0,0,0,0,0,0,0,0,110010080022018,1,108,108,1,psa_17,1D2
1000000US110010078061001,"Block 1001, Block Group 1, Census Tract 78.06, District of Columbia, District of Columbia",146,0,142,0,0,0,4,0,146,140,0,140,0,0,0,0,0,6,0,2,0,0,0,4,0,110010078061001,6,602,602,6,psa_25,6D1
1000000US110010088031000,"Block 1000, Block Group 1, Census Tract 88.03, District of Columbia, District of Columbia",0,0,0,0,0,0,0,0,0,0,0,0,0,0,0,0,0,0,0,0,0,0,0,0,0,110010088031000,5,506,506,5,psa_26,5D3
1000000US110010009012013,"Block 2013, Block Group 2, Census Tract 9.01, District of Columbia, District of Columbia",42,41,0,0,1,0,0,0,42,40,39,0,0,1,0,0,0,2,2,0,0,0,0,0,0,110010009012013,2,205,205,2,psa_46,2D2
1000000US110010092011008,"Block 1008, Block Group 1, Census Tract 92.01, District of Columbia, District of Columbia",0,0,0,0,0,0,0,0,0,0,0,0,0,0,0,0,0,0,0,0,0,0,0,0,0,110010092011008,5,502,502,5,psa_40,5D1
1000000US110010018031001,"Block 1001, Block Group 1, Census Tract 18.03, District of Columbia, District of Columbia",148,23,108,0,0,0,16,1,148,128,18,107,0,0,0,2,1,20,5,1,0,0,0,14,0,110010018031001,4,401,401,4,psa_56,4D1
1000000US110010099021005,"Block 1005, Block Group 1, Census Tract 99.02, District of Columbia, District of Columbia",44,0,38,0,0,0,6,0,44,38,0,38,0,0,0,0,0,6,0,0,0,0,0,6,0,110010099021005,6,605,605,6,psa_11,6D2
1000000US110010050022000,"Block 2000, Block Group 2, Census Tract 50.02, District of Columbia, District of Columbia",74,61,6,1,3,0,3,0,74,67,58,6,0,3,0,0,0,7,3,0,1,0,0,3,0,110010050022000,3,307,307,3,psa_28,3D3
1000000US110010088041005,"Block 1005, Block Group 1, Census Tract 88.04, District of Columbia, District of Columbia",186,4,173,1,0,0,7,1,186,179,4,173,1,0,0,0,1,7,0,0,0,0,0,7,0,110010088041005,5,506,506,5,psa_26,5D3
1000000US110010072001004,"Block 1004, Block Group 1, Census Tract 72, District of Columbia, District of Columbia",0,0,0,0,0,0,0,0,0,0,0,0,0,0,0,0,0,0,0,0,0,0,0,0,0,110010072001004,1,106,106,1,psa_13,1D3
1000000US110010077031004,"Block 1004, Block Group 1, Census Tract 77.03, District of Columbia, District of Columbia",35,1,34,0,0,0,0,0,35,35,1,34,0,0,0,0,0,0,0,0,0,0,0,0,0,110010077031004,6,603,603,6,psa_15,6D3
1000000US110010104001019,"Block 1019, Block Group 1, Census Tract 104, District of Columbia, District of Columbia",0,0,0,0,0,0,0,0,0,0,0,0,0,0,0,0,0,0,0,0,0,0,0,0,0,110010104001019,7,707,707,7,psa_4,7D2
1000000US110010003001006,"Block 1006, Block Group 1, Census Tract 3, District of Columbia, District of Columbia",163,144,2,0,10,0,0,7,163,153,134,2,0,10,0,0,7,10,10,0,0,0,0,0,0,110010003001006,2,206,206,2,psa_29,2D2
1000000US110010008021011,"Block 1011, Block Group 1, Census Tract 8.02, District of Columbia, District of Columbia",98,91,4,0,0,0,1,2,98,96,90,4,0,0,0,0,2,2,1,0,0,0,0,1,0,110010008021011,2,205,205,2,psa_46,2D2
1000000US110010080011003,"Block 1003, Block Group 1, Census Tract 80.01, District of Columbia, District of Columbia",143,66,60,0,10,1,0,6,143,139,63,59,0,10,1,0,6,4,3,1,0,0,0,0,0,110010080011003,1,104,104,1,psa_21,1D2
1000000US110010078034005,"Block 4005, Block Group 4, Census Tract 78.03, District of Columbia, District of Columbia",84,1,80,2,0,0,1,0,84,83,0,80,2,0,0,1,0,1,1,0,0,0,0,0,0,110010078034005,6,602,602,6,psa_25,6D1
1000000US110010088022011,"Block 2011, Block Group 2, Census Tract 88.02, District of Columbia, District of Columbia",41,5,36,0,0,0,0,0,41,39,3,36,0,0,0,0,0,2,2,0,0,0,0,0,0,110010088022011,5,506,506,5,psa_26,5D3
1000000US110010033012001,"Block 2001, Block Group 2, Census Tract 33.01, District of Columbia, District of Columbia",293,117,155,1,7,0,2,11,293,273,110,150,0,7,0,0,6,20,7,5,1,0,0,2,5,110010033012001,3,306,306,3,psa_38,3D2
1000000US110010097001014,"Block 1014, Block Group 1, Census Tract 97, District of Columbia, District of Columbia",77,0,77,0,0,0,0,0,77,77,0,77,0,0,0,0,0,0,0,0,0,0,0,0,0,110010097001014,7,706,706,7,psa_2,7D3
1000000US110010078031006,"Block 1006, Block Group 1, Census Tract 78.03, District of Columbia, District of Columbia",70,0,62,4,0,0,0,4,70,70,0,62,4,0,0,0,4,0,0,0,0,0,0,0,0,110010078031006,6,602,602,6,psa_25,6D1
1000000US110010042022005,"Block 2005, Block Group 2, Census Tract 42.02, District of Columbia, District of Columbia",5,5,0,0,0,0,0,0,5,5,5,0,0,0,0,0,0,0,0,0,0,0,0,0,0,110010042022005,2,208,208,2,psa_33,2D3
1000000US110010099051011,"Block 1011, Block Group 1, Census Tract 99.05, District of Columbia, District of Columbia",146,4,128,0,0,0,1,13,146,139,4,124,0,0,0,1,10,7,0,4,0,0,0,0,3,110010099051011,6,604,604,6,psa_14,6D3
1000000US110010108001001,"Block 1001, Block Group 1, Census Tract 108.00, District of Columbia, District of Columbia",1,0,1,0,0,0,0,0,1,1,0,1,0,0,0,0,0,0,0,0,0,0,0,0,0,110010108001001,2,207,207,2,psa_24,2D3
1000000US110010001002001,"Block 2001, Block Group 2, Census Tract 1, District of Columbia, District of Columbia",273,237,9,0,13,0,3,11,273,248,219,8,0,13,0,1,7,25,18,1,0,0,0,2,4,110010001002001,2,206,206,2,psa_29,2D2
1000000US110010019022004,"Block 2004, Block Group 2, Census Tract 19.02, District of Columbia, District of Columbia",0,0,0,0,0,0,0,0,0,0,0,0,0,0,0,0,0,0,0,0,0,0,0,0,0,110010019022004,4,402,402,4,psa_53,4D1
1000000US110010062021223,"Block 1223, Block Group 1, Census Tract 62.02, District of Columbia, District of Columbia",0,0,0,0,0,0,0,0,0,0,0,0,0,0,0,0,0,0,0,0,0,0,0,0,0,110010062021223,2,207,207,2,psa_24,2D3
1000000US110010097001007,"Block 1007, Block Group 1, Census Tract 97, District of Columbia, District of Columbia",74,1,73,0,0,0,0,0,74,74,1,73,0,0,0,0,0,0,0,0,0,0,0,0,0,110010097001007,7,706,706,7,psa_2,7D3
1000000US110010011002009,"Block 2009, Block Group 2, Census Tract 11, District of Columbia, District of Columbia",78,72,0,1,2,0,1,2,78,69,63,0,1,2,0,1,2,9,9,0,0,0,0,0,0,110010011002009,2,202,202,2,psa_52,2D1
1000000US110010042021008,"Block 1008, Block Group 1, Census Tract 42.02, District of Columbia, District of Columbia",72,70,2,0,0,0,0,0,72,63,62,1,0,0,0,0,0,9,8,1,0,0,0,0,0,110010042021008,2,208,208,2,psa_33,2D3
1000000US110010049012003,"Block 2003, Block Group 2, Census Tract 49.01, District of Columbia, District of Columbia",99,19,71,3,0,0,0,6,99,98,19,71,2,0,0,0,6,1,0,0,1,0,0,0,0,110010049012003,3,307,307,3,psa_28,3D3
1000000US110010076043004,"Block 3004, Block Group 3, Census Tract 76.04, District of Columbia, District of Columbia",95,0,93,1,0,0,0,1,95,89,0,87,1,0,0,0,1,6,0,6,0,0,0,0,0,110010076043004,6,607,607,6,psa_10,6D2
1000000US110010079031000,"Block 1000, Block Group 1, Census Tract 79.03, District of Columbia, District of Columbia",156,23,131,0,1,0,1,0,156,154,23,130,0,1,0,0,0,2,0,1,0,0,0,1,0,110010079031000,5,507,507,5,psa_23,5D3
1000000US110010021012003,"Block 2003, Block Group 2, Census Tract 21.01, District of Columbia, District of Columbia",252,78,90,0,12,0,54,18,252,126,24,89,0,10,0,0,3,126,54,1,0,2,0,54,15,110010021012003,4,403,403,4,psa_51,4D1
1000000US110010066001015,"Block 1015, Block Group 1, Census Tract 66, District of Columbia, District of Columbia",122,112,2,0,5,0,0,3,122,121,111,2,0,5,0,0,3,1,1,0,0,0,0,0,0,110010066001015,1,107,107,1,psa_16,1D2
1000000US110010067002009,"Block 2009, Block Group 2, Census Tract 67, District of Columbia, District of Columbia",77,71,2,0,0,0,2,2,77,70,66,2,0,0,0,0,2,7,5,0,0,0,0,2,0,110010067002009,1,107,107,1,psa_16,1D2
1000000US110010049012013,"Block 2013, Block Group 2, Census Tract 49.01, District of Columbia, District of Columbia",100,69,15,1,12,0,0,3,100,96,65,15,1,12,0,0,3,4,4,0,0,0,0,0,0,110010049012013,3,307,307,3,psa_28,3D3
1000000US110010004002005,"Block 2005, Block Group 2, Census Tract 4, District of Columbia, District of Columbia",35,31,1,0,0,0,0,3,35,33,31,1,0,0,0,0,1,2,0,0,0,0,0,0,2,110010004002005,2,204,204,2,psa_44,2D2
1000000US110010019022010,"Block 2010, Block Group 2, Census Tract 19.02, District of Columbia, District of Columbia",0,0,0,0,0,0,0,0,0,0,0,0,0,0,0,0,0,0,0,0,0,0,0,0,0,110010019022010,4,406,406,4,psa_54,4D2
1000000US110010068041021,"Block 1021, Block Group 1, Census Tract 68.04, District of Columbia, District of Columbia",0,0,0,0,0,0,0,0,0,0,0,0,0,0,0,0,0,0,0,0,0,0,0,0,0,110010068041021,1,108,108,1,psa_17,1D2
1000000US110010083011007,"Block 1007, Block Group 1, Census Tract 83.01, District of Columbia, District of Columbia",168,112,46,0,2,0,2,6,168,166,111,46,0,2,0,1,6,2,1,0,0,0,0,1,0,110010083011007,1,104,104,1,psa_21,1D2
1000000US110010042012002,"Block 2002, Block Group 2, Census Tract 42.01, District of Columbia, District of Columbia",216,176,8,0,20,0,3,9,216,206,170,8,0,20,0,0,8,10,6,0,0,0,0,3,1,110010042012002,3,301,301,3,psa_31,3D3
1000000US110010076042003,"Block 2003, Block Group 2, Census Tract 76.04, District of Columbia, District of Columbia",0,0,0,0,0,0,0,0,0,0,0,0,0,0,0,0,0,0,0,0,0,0,0,0,0,110010076042003,6,607,607,6,psa_10,6D2
1000000US110010014021013,"Block 1013, Block Group 1, Census Tract 14.02, District of Columbia, District of Columbia",24,24,0,0,0,0,0,0,24,23,23,0,0,0,0,0,0,1,1,0,0,0,0,0,0,110010014021013,2,201,201,2,psa_55,2D1
1000000US110010049021006,"Block 1006, Block Group 1, Census Tract 49.02, District of Columbia, District of Columbia",259,63,13,3,3,0,164,13,259,44,28,13,0,3,0,0,0,215,35,0,3,0,0,164,13,110010049021006,3,307,307,3,psa_28,3D3
1000000US110010103002003,"Block 2003, Block Group 2, Census Tract 103, District of Columbia, District of Columbia",68,0,61,0,0,0,7,0,68,59,0,59,0,0,0,0,0,9,0,2,0,0,0,7,0,110010103002003,4,401,401,4,psa_56,4D1
1000000US110010077033005,"Block 3005, Block Group 3, Census Tract 77.03, District of Columbia, District of Columbia",112,0,112,0,0,0,0,0,112,111,0,111,0,0,0,0,0,1,0,1,0,0,0,0,0,110010077033005,6,603,603,6,psa_15,6D3
1000000US110010018043003,"Block 3003, Block Group 3, Census Tract 18.04, District of Columbia, District of Columbia",167,5,115,0,0,0,38,9,167,115,0,115,0,0,0,0,0,52,5,0,0,0,0,38,9,110010018043003,4,402,402,4,psa_53,4D1
1000000US110010102001010,"Block 1010, Block Group 1, Census Tract 102, District of Columbia, District of Columbia",0,0,0,0,0,0,0,0,0,0,0,0,0,0,0,0,0,0,0,0,0,0,0,0,0,110010102001010,1,103,103,1,psa_12,1D1
1000000US110010077071013,"Block 1013, Block Group 1, Census Tract 77.07, District of Columbia, District of Columbia",11,0,11,0,0,0,0,0,11,11,0,11,0,0,0,0,0,0,0,0,0,0,0,0,0,110010077071013,6,604,604,6,psa_14,6D3
1000000US110010096011003,"Block 1003, Block Group 1, Census Tract 96.01, District of Columbia, District of Columbia",0,0,0,0,0,0,0,0,0,0,0,0,0,0,0,0,0,0,0,0,0,0,0,0,0,110010096011003,6,601,601,6,psa_30,6D1
1000000US110010010012000,"Block 2000, Block Group 2, Census Tract 10.01, District of Columbia, District of Columbia",50,49,0,0,0,0,1,0,50,41,41,0,0,0,0,0,0,9,8,0,0,0,0,1,0,110010010012000,2,202,202,2,psa_52,2D1
1000000US110010071001025,"Block 1025, Block Group 1, Census Tract 71, District of Columbia, District of Columbia",0,0,0,0,0,0,0,0,0,0,0,0,0,0,0,0,0,0,0,0,0,0,0,0,0,110010071001025,1,106,106,1,psa_13,1D3
1000000US110010102002046,"Block 2046, Block Group 2, Census Tract 102, District of Columbia, District of Columbia",0,0,0,0,0,0,0,0,0,0,0,0,0,0,0,0,0,0,0,0,0,0,0,0,0,110010102002046,1,103,103,1,psa_12,1D1
1000000US110010065002024,"Block 2024, Block Group 2, Census Tract 65, District of Columbia, District of Columbia",0,0,0,0,0,0,0,0,0,0,0,0,0,0,0,0,0,0,0,0,0,0,0,0,0,110010065002024,1,106,106,1,psa_13,1D3
1000000US110010003004002,"Block 4002, Block Group 4, Census Tract 3, District of Columbia, District of Columbia",172,164,0,0,1,0,2,5,172,163,160,0,0,1,0,0,2,9,4,0,0,0,0,2,3,110010003004002,2,204,204,2,psa_44,2D2
1000000US110010111002015,"Block 2015, Block Group 2, Census Tract 111, District of Columbia, District of Columbia",55,5,41,0,0,0,7,2,55,47,5,41,0,0,0,0,1,8,0,0,0,0,0,7,1,110010111002015,5,503,503,5,psa_45,5D2
1000000US110010049022005,"Block 2005, Block Group 2, Census Tract 49.02, District of Columbia, District of Columbia",56,43,12,0,0,1,0,0,56,55,43,12,0,0,0,0,0,1,0,0,0,0,1,0,0,110010049022005,3,307,307,3,psa_28,3D3
1000000US110010052012006,"Block 2006, Block Group 2, Census Tract 52.01, District of Columbia, District of Columbia",300,240,14,0,31,0,5,10,300,282,233,12,0,31,0,0,6,18,7,2,0,0,0,5,4,110010052012006,2,208,208,2,psa_33,2D3
1000000US110010013011013,"Block 1013, Block Group 1, Census Tract 13.01, District of Columbia, District of Columbia",0,0,0,0,0,0,0,0,0,0,0,0,0,0,0,0,0,0,0,0,0,0,0,0,0,110010013011013,2,203,203,2,psa_50,2D1
1000000US110010042021007,"Block 1007, Block Group 1, Census Tract 42.02, District of Columbia, District of Columbia",0,0,0,0,0,0,0,0,0,0,0,0,0,0,0,0,0,0,0,0,0,0,0,0,0,110010042021007,2,208,208,2,psa_33,2D3
1000000US110010025024000,"Block 4000, Block Group 4, Census Tract 25.02, District of Columbia, District of Columbia",417,120,109,3,6,1,123,55,417,154,40,102,1,6,1,0,4,263,80,7,2,0,0,123,51,110010025024000,4,404,404,4,psa_48,4D3
1000000US110010028022003,"Block 2003, Block Group 2, Census Tract 28.02, District of Columbia, District of Columbia",202,7,153,0,3,0,36,3,202,155,2,150,0,3,0,0,0,47,5,3,0,0,0,36,3,110010028022003,3,302,302,3,psa_42,3D1
1000000US110010074011014,"Block 1014, Block Group 1, Census Tract 74.01, District of Columbia, District of Columbia",0,0,0,0,0,0,0,0,0,0,0,0,0,0,0,0,0,0,0,0,0,0,0,0,0,110010074011014,7,703,703,7,psa_8,7D1
1000000US110010011002013,"Block 2013, Block Group 2, Census Tract 11, District of Columbia, District of Columbia",59,52,2,0,5,0,0,0,59,55,48,2,0,5,0,0,0,4,4,0,0,0,0,0,0,110010011002013,2,202,202,2,psa_52,2D1
1000000US110010014021002,"Block 1002, Block Group 1, Census Tract 14.02, District of Columbia, District of Columbia",74,66,3,0,2,0,1,2,74,72,64,3,0,2,0,1,2,2,2,0,0,0,0,0,0,110010014021002,2,201,201,2,psa_55,2D1
1000000US110010073011100,"Block 1100, Block Group 1, Census Tract 73.01, District of Columbia, District of Columbia",0,0,0,0,0,0,0,0,0,0,0,0,0,0,0,0,0,0,0,0,0,0,0,0,0,110010073011100,7,708,708,7,psa_1,7D3
1000000US110010099061007,"Block 1007, Block Group 1, Census Tract 99.06, District of Columbia, District of Columbia",349,7,333,0,2,0,1,6,349,342,4,331,0,2,0,0,5,7,3,2,0,0,0,1,1,110010099061007,6,604,604,6,psa_14,6D3
1000000US110010099041007,"Block 1007, Block Group 1, Census Tract 99.04, District of Columbia, District of Columbia",373,26,320,1,1,0,23,2,373,327,7,316,1,1,0,0,2,46,19,4,0,0,0,23,0,110010099041007,6,604,604,6,psa_14,6D3
1000000US110010076014004,"Block 4004, Block Group 4, Census Tract 76.01, District of Columbia, District of Columbia",120,0,120,0,0,0,0,0,120,120,0,120,0,0,0,0,0,0,0,0,0,0,0,0,0,110010076014004,6,607,607,6,psa_10,6D2
1000000US110010078061000,"Block 1000, Block Group 1, Census Tract 78.06, District of Columbia, District of Columbia",36,0,36,0,0,0,0,0,36,36,0,36,0,0,0,0,0,0,0,0,0,0,0,0,0,110010078061000,6,602,602,6,psa_25,6D1
1000000US110010103002007,"Block 2007, Block Group 2, Census Tract 103, District of Columbia, District of Columbia",49,0,43,0,0,0,5,1,49,45,0,43,0,0,0,1,1,4,0,0,0,0,0,4,0,110010103002007,4,401,401,4,psa_56,4D1
1000000US110010009022002,"Block 2002, Block Group 2, Census Tract 9.02, District of Columbia, District of Columbia",0,0,0,0,0,0,0,0,0,0,0,0,0,0,0,0,0,0,0,0,0,0,0,0,0,110010009022002,2,205,205,2,psa_46,2D2
1000000US110010008012010,"Block 2010, Block Group 2, Census Tract 8.01, District of Columbia, District of Columbia",25,19,5,0,1,0,0,0,25,25,19,5,0,1,0,0,0,0,0,0,0,0,0,0,0,110010008012010,2,205,205,2,psa_46,2D2
1000000US110010067001007,"Block 1007, Block Group 1, Census Tract 67, District of Columbia, District of Columbia",0,0,0,0,0,0,0,0,0,0,0,0,0,0,0,0,0,0,0,0,0,0,0,0,0,110010067001007,1,107,107,1,psa_16,1D2
1000000US110010095051009,"Block 1009, Block Group 1, Census Tract 95.05, District of Columbia, District of Columbia",36,3,33,0,0,0,0,0,36,36,3,33,0,0,0,0,0,0,0,0,0,0,0,0,0,110010095051009,4,406,406,4,psa_54,4D2
1000000US110010103003001,"Block 3001, Block Group 3, Census Tract 103, District of Columbia, District of Columbia",92,42,48,1,0,0,0,1,92,89,41,47,0,0,0,0,1,3,1,1,1,0,0,0,0,110010103003001,4,401,401,4,psa_56,4D1
1000000US110010106002032,"Block 2032, Block Group 2, Census Tract 106, District of Columbia, District of Columbia",0,0,0,0,0,0,0,0,0,0,0,0,0,0,0,0,0,0,0,0,0,0,0,0,0,110010106002032,1,102,102,1,psa_18,1D1
1000000US110010107002013,"Block 2013, Block Group 2, Census Tract 107, District of Columbia, District of Columbia",0,0,0,0,0,0,0,0,0,0,0,0,0,0,0,0,0,0,0,0,0,0,0,0,0,110010107002013,2,208,208,2,psa_33,2D3
1000000US110010076011000,"Block 1000, Block Group 1, Census Tract 76.01, District of Columbia, District of Columbia",54,2,49,0,0,0,3,0,54,46,0,46,0,0,0,0,0,8,2,3,0,0,0,3,0,110010076011000,6,607,607,6,psa_10,6D2
1000000US110010099041004,"Block 1004, Block Group 1, Census Tract 99.04, District of Columbia, District of Columbia",48,1,47,0,0,0,0,0,48,46,1,45,0,0,0,0,0,2,0,2,0,0,0,0,0,110010099041004,6,604,604,6,psa_14,6D3
1000000US110010004001013,"Block 1013, Block Group 1, Census Tract 4, District of Columbia, District of Columbia",57,54,0,0,2,0,0,1,57,51,48,0,0,2,0,0,1,6,6,0,0,0,0,0,0,110010004001013,2,204,204,2,psa_44,2D2
1000000US110010009013024,"Block 3024, Block Group 3, Census Tract 9.01, District of Columbia, District of Columbia",0,0,0,0,0,0,0,0,0,0,0,0,0,0,0,0,0,0,0,0,0,0,0,0,0,110010009013024,2,205,205,2,psa_46,2D2
1000000US110010049011000,"Block 1000, Block Group 1, Census Tract 49.01, District of Columbia, District of Columbia",390,62,309,1,0,0,15,3,390,320,15,303,1,0,0,0,1,70,47,6,0,0,0,15,2,110010049011000,3,307,307,3,psa_28,3D3
1000000US110010021026002,"Block 6002, Block Group 6, Census Tract 21.02, District of Columbia, District of Columbia",82,5,61,0,0,0,16,0,82,64,5,59,0,0,0,0,0,18,0,2,0,0,0,16,0,110010021026002,4,403,403,4,psa_51,4D1
1000000US110010099021003,"Block 1003, Block Group 1, Census Tract 99.02, District of Columbia, District of Columbia",0,0,0,0,0,0,0,0,0,0,0,0,0,0,0,0,0,0,0,0,0,0,0,0,0,110010099021003,6,605,605,6,psa_11,6D2
1000000US110010099053001,"Block 3001, Block Group 3, Census Tract 99.05, District of Columbia, District of Columbia",63,0,55,3,0,0,0,5,63,59,0,55,3,0,0,0,1,4,0,0,0,0,0,0,4,110010099053001,6,604,604,6,psa_14,6D3
1000000US110010013012012,"Block 2012, Block Group 2, Census Tract 13.01, District of Columbia, District of Columbia",39,35,1,0,3,0,0,0,39,38,34,1,0,3,0,0,0,1,1,0,0,0,0,0,0,110010013012012,2,203,203,2,psa_50,2D1
1000000US110010065002008,"Block 2008, Block Group 2, Census Tract 65, District of Columbia, District of Columbia",2,2,0,0,0,0,0,0,2,2,2,0,0,0,0,0,0,0,0,0,0,0,0,0,0,110010065002008,1,106,106,1,psa_13,1D3
1000000US110010010016001,"Block 6001, Block Group 6, Census Tract 10.01, District of Columbia, District of Columbia",47,45,0,0,0,0,0,2,47,41,39,0,0,0,0,0,2,6,6,0,0,0,0,0,0,110010010016001,2,202,202,2,psa_52,2D1
1000000US110010016001017,"Block 1017, Block Group 1, Census Tract 16, District of Columbia, District of Columbia",76,26,43,0,0,0,0,7,76,69,23,43,0,0,0,0,3,7,3,0,0,0,0,0,4,110010016001017,4,401,401,4,psa_56,4D1
1000000US110010049022013,"Block 2013, Block Group 2, Census Tract 49.02, District of Columbia, District of Columbia",371,278,22,3,45,0,11,12,371,331,255,22,0,45,0,2,7,40,23,0,3,0,0,9,5,110010049022013,3,307,307,3,psa_28,3D3
1000000US110010099051004,"Block 1004, Block Group 1, Census Tract 99.05, District of Columbia, District of Columbia",144,2,136,0,0,0,0,6,144,144,2,136,0,0,0,0,6,0,0,0,0,0,0,0,0,110010099051004,6,604,604,6,psa_14,6D3
1000000US110010041002014,"Block 2014, Block Group 2, Census Tract 41, District of Columbia, District of Columbia",41,35,0,0,2,0,0,4,41,41,35,0,0,2,0,0,4,0,0,0,0,0,0,0,0,110010041002014,2,208,208,2,psa_33,2D3
1000000US110010056002015,"Block 2015, Block Group 2, Census Tract 56, District of Columbia, District of Columbia",0,0,0,0,0,0,0,0,0,0,0,0,0,0,0,0,0,0,0,0,0,0,0,0,0,110010056002015,2,207,207,2,psa_24,2D3
1000000US110010010013009,"Block 3009, Block Group 3, Census Tract 10.01, District of Columbia, District of Columbia",58,51,4,0,0,0,0,3,58,58,51,4,0,0,0,0,3,0,0,0,0,0,0,0,0,110010010013009,2,202,202,2,psa_52,2D1
1000000US110010038003006,"Block 3006, Block Group 3, Census Tract 38, District of Columbia, District of Columbia",0,0,0,0,0,0,0,0,0,0,0,0,0,0,0,0,0,0,0,0,0,0,0,0,0,110010038003006,3,303,303,3,psa_37,3D3
1000000US110010011003008,"Block 3008, Block Group 3, Census Tract 11, District of Columbia, District of Columbia",43,41,2,0,0,0,0,0,43,43,41,2,0,0,0,0,0,0,0,0,0,0,0,0,0,110010011003008,2,201,201,2,psa_55,2D1
1000000US110010077033002,"Block 3002, Block Group 3, Census Tract 77.03, District of Columbia, District of Columbia",514,3,496,2,0,0,8,5,514,502,2,492,2,0,0,4,2,12,1,4,0,0,0,4,3,110010077033002,6,603,603,6,psa_15,6D3
1000000US110010096011000,"Block 1000, Block Group 1, Census Tract 96.01, District of Columbia, District of Columbia",0,0,0,0,0,0,0,0,0,0,0,0,0,0,0,0,0,0,0,0,0,0,0,0,0,110010096011000,5,503,503,5,psa_45,5D2
1000000US110010078032004,"Block 2004, Block Group 2, Census Tract 78.03, District of Columbia, District of Columbia",92,4,88,0,0,0,0,0,92,90,2,88,0,0,0,0,0,2,2,0,0,0,0,0,0,110010078032004,6,602,602,6,psa_25,6D1
1000000US110010013022011,"Block 2011, Block Group 2, Census Tract 13.02, District of Columbia, District of Columbia",0,0,0,0,0,0,0,0,0,0,0,0,0,0,0,0,0,0,0,0,0,0,0,0,0,110010013022011,2,203,203,2,psa_50,2D1
1000000US110010050023000,"Block 3000, Block Group 3, Census Tract 50.02, District of Columbia, District of Columbia",0,0,0,0,0,0,0,0,0,0,0,0,0,0,0,0,0,0,0,0,0,0,0,0,0,110010050023000,3,307,307,3,psa_28,3D3
1000000US110010010016013,"Block 6013, Block Group 6, Census Tract 10.01, District of Columbia, District of Columbia",54,52,0,0,2,0,0,0,54,50,48,0,0,2,0,0,0,4,4,0,0,0,0,0,0,110010010016013,2,202,202,2,psa_52,2D1
1000000US110010016003004,"Block 3004, Block Group 3, Census Tract 16, District of Columbia, District of Columbia",59,17,41,0,1,0,0,0,59,55,17,37,0,1,0,0,0,4,0,4,0,0,0,0,0,110010016003004,4,401,401,4,psa_56,4D1
1000000US110010027022003,"Block 2003, Block Group 2, Census Tract 27.02, District of Columbia, District of Columbia",183,125,31,0,13,0,6,8,183,157,112,28,0,13,0,1,3,26,13,3,0,0,0,5,5,110010027022003,3,302,302,3,psa_42,3D1
1000000US110010102002039,"Block 2039, Block Group 2, Census Tract 102, District of Columbia, District of Columbia",0,0,0,0,0,0,0,0,0,0,0,0,0,0,0,0,0,0,0,0,0,0,0,0,0,110010102002039,1,103,103,1,psa_12,1D1
1000000US110010015001006,"Block 1006, Block Group 1, Census Tract 15, District of Columbia, District of Columbia",74,46,24,0,0,0,0,4,74,69,41,24,0,0,0,0,4,5,5,0,0,0,0,0,0,110010015001006,2,201,201,2,psa_55,2D1
1000000US110010095091003,"Block 1003, Block Group 1, Census Tract 95.09, District of Columbia, District of Columbia",162,6,149,3,0,0,0,4,162,159,6,148,1,0,0,0,4,3,0,1,2,0,0,0,0,110010095091003,4,405,405,4,psa_49,4D2
1000000US110010062021152,"Block 1152, Block Group 1, Census Tract 62.02, District of Columbia, District of Columbia",0,0,0,0,0,0,0,0,0,0,0,0,0,0,0,0,0,0,0,0,0,0,0,0,0,110010062021152,2,207,207,2,psa_24,2D3
1000000US110010083012008,"Block 2008, Block Group 2, Census Tract 83.01, District of Columbia, District of Columbia",135,118,13,0,4,0,0,0,135,131,115,12,0,4,0,0,0,4,3,1,0,0,0,0,0,110010083012008,1,108,108,1,psa_17,1D2
1000000US110010005022006,"Block 2006, Block Group 2, Census Tract 5.02, District of Columbia, District of Columbia",653,549,22,0,47,0,11,24,653,612,521,21,0,47,0,3,20,41,28,1,0,0,0,8,4,110010005022006,2,204,204,2,psa_44,2D2
1000000US110010013023010,"Block 3010, Block Group 3, Census Tract 13.02, District of Columbia, District of Columbia",0,0,0,0,0,0,0,0,0,0,0,0,0,0,0,0,0,0,0,0,0,0,0,0,0,110010013023010,2,203,203,2,psa_50,2D1
1000000US110010015003008,"Block 3008, Block Group 3, Census Tract 15, District of Columbia, District of Columbia",99,78,7,0,4,0,0,10,99,94,73,7,0,4,0,0,10,5,5,0,0,0,0,0,0,110010015003008,2,201,201,2,psa_55,2D1
1000000US110010008021017,"Block 1017, Block Group 1, Census Tract 8.02, District of Columbia, District of Columbia",0,0,0,0,0,0,0,0,0,0,0,0,0,0,0,0,0,0,0,0,0,0,0,0,0,110010008021017,2,206,206,2,psa_29,2D2
1000000US110010010014019,"Block 4019, Block Group 4, Census Tract 10.01, District of Columbia, District of Columbia",21,17,1,0,1,0,0,2,21,16,12,1,0,1,0,0,2,5,5,0,0,0,0,0,0,110010010014019,2,202,202,2,psa_52,2D1
1000000US110010001004035,"Block 4035, Block Group 4, Census Tract 1, District of Columbia, District of Columbia",0,0,0,0,0,0,0,0,0,0,0,0,0,0,0,0,0,0,0,0,0,0,0,0,0,110010001004035,2,206,206,2,psa_29,2D2
1000000US110010098011006,"Block 1006, Block Group 1, Census Tract 98.01, District of Columbia, District of Columbia",0,0,0,0,0,0,0,0,0,0,0,0,0,0,0,0,0,0,0,0,0,0,0,0,0,110010098011006,7,706,706,7,psa_2,7D3
1000000US110010010022005,"Block 2005, Block Group 2, Census Tract 10.02, District of Columbia, District of Columbia",32,32,0,0,0,0,0,0,32,27,27,0,0,0,0,0,0,5,5,0,0,0,0,0,0,110010010022005,2,204,204,2,psa_44,2D2
1000000US110010096021013,"Block 1013, Block Group 1, Census Tract 96.02, District of Columbia, District of Columbia",0,0,0,0,0,0,0,0,0,0,0,0,0,0,0,0,0,0,0,0,0,0,0,0,0,110010096021013,6,601,601,6,psa_30,6D1
1000000US110010111001017,"Block 1017, Block Group 1, Census Tract 111, District of Columbia, District of Columbia",20,0,20,0,0,0,0,0,20,20,0,20,0,0,0,0,0,0,0,0,0,0,0,0,0,110010111001017,5,503,503,5,psa_45,5D2
1000000US110010026002002,"Block 2002, Block Group 2, Census Tract 26, District of Columbia, District of Columbia",0,0,0,0,0,0,0,0,0,0,0,0,0,0,0,0,0,0,0,0,0,0,0,0,0,110010026002002,2,203,203,2,psa_50,2D1
1000000US110010072001015,"Block 1015, Block Group 1, Census Tract 72, District of Columbia, District of Columbia",2,2,0,0,0,0,0,0,2,1,1,0,0,0,0,0,0,1,1,0,0,0,0,0,0,110010072001015,1,106,106,1,psa_13,1D3
1000000US110010090002003,"Block 2003, Block Group 2, Census Tract 90, District of Columbia, District of Columbia",285,41,196,0,36,0,0,12,285,283,41,196,0,36,0,0,10,2,0,0,0,0,0,0,2,110010090002003,5,503,503,5,psa_45,5D2
1000000US110010094002017,"Block 2017, Block Group 2, Census Tract 94, District of Columbia, District of Columbia",91,16,67,0,1,0,0,7,91,85,16,62,0,1,0,0,6,6,0,5,0,0,0,0,1,110010094002017,5,504,504,5,psa_43,5D2
1000000US110010032004010,"Block 4010, Block Group 4, Census Tract 32, District of Columbia, District of Columbia",117,13,86,1,17,0,0,0,117,113,13,82,1,17,0,0,0,4,0,4,0,0,0,0,0,110010032004010,3,306,306,3,psa_38,3D2
1000000US110010091022001,"Block 2001, Block Group 2, Census Tract 91.02, District of Columbia, District of Columbia",0,0,0,0,0,0,0,0,0,0,0,0,0,0,0,0,0,0,0,0,0,0,0,0,0,110010091022001,5,505,505,5,psa_34,5D2
1000000US110010001004050,"Block 4050, Block Group 4, Census Tract 1, District of Columbia, District of Columbia",0,0,0,0,0,0,0,0,0,0,0,0,0,0,0,0,0,0,0,0,0,0,0,0,0,110010001004050,2,207,207,2,psa_24,2D3
1000000US110010083021006,"Block 1006, Block Group 1, Census Tract 83.02, District of Columbia, District of Columbia",102,69,29,0,1,0,1,2,102,93,61,28,0,1,0,1,2,9,8,1,0,0,0,0,0,110010083021006,1,104,104,1,psa_21,1D2
1000000US110010016001013,"Block 1013, Block Group 1, Census Tract 16, District of Columbia, District of Columbia",25,1,21,0,0,0,1,2,25,24,1,21,0,0,0,0,2,1,0,0,0,0,0,1,0,110010016001013,4,401,401,4,psa_56,4D1
1000000US110010111002002,"Block 2002, Block Group 2, Census Tract 111, District of Columbia, District of Columbia",33,3,26,0,0,0,0,4,33,32,3,26,0,0,0,0,3,1,0,0,0,0,0,0,1,110010111002002,5,503,503,5,psa_45,5D2
1000000US110010009013013,"Block 3013, Block Group 3, Census Tract 9.01, District of Columbia, District of Columbia",26,20,1,0,1,0,0,4,26,26,20,1,0,1,0,0,4,0,0,0,0,0,0,0,0,110010009013013,2,205,205,2,psa_46,2D2
1000000US110010029001002,"Block 1002, Block Group 1, Census Tract 29, District of Columbia, District of Columbia",180,83,56,1,6,0,26,8,180,128,65,55,0,6,0,0,2,52,18,1,1,0,0,26,6,110010029001002,4,408,408,4,psa_39,4D3
1000000US110010014011008,"Block 1008, Block Group 1, Census Tract 14.01, District of Columbia, District of Columbia",71,57,4,0,10,0,0,0,71,71,57,4,0,10,0,0,0,0,0,0,0,0,0,0,0,110010014011008,2,201,201,2,psa_55,2D1
1000000US110010072001018,"Block 1018, Block Group 1, Census Tract 72, District of Columbia, District of Columbia",0,0,0,0,0,0,0,0,0,0,0,0,0,0,0,0,0,0,0,0,0,0,0,0,0,110010072001018,1,106,106,1,psa_13,1D3
1000000US110010073011066,"Block 1066, Block Group 1, Census Tract 73.01, District of Columbia, District of Columbia",609,393,130,7,21,0,14,44,609,557,372,113,6,21,0,6,39,52,21,17,1,0,0,8,5,110010073011066,7,707,707,7,psa_4,7D2
1000000US110010111003030,"Block 3030, Block Group 3, Census Tract 111, District of Columbia, District of Columbia",0,0,0,0,0,0,0,0,0,0,0,0,0,0,0,0,0,0,0,0,0,0,0,0,0,110010111003030,5,503,503,5,psa_45,5D2
1000000US110010015001031,"Block 1031, Block Group 1, Census Tract 15, District of Columbia, District of Columbia",170,111,37,1,3,0,8,10,170,146,101,33,1,3,0,2,6,24,10,4,0,0,0,6,4,110010015001031,2,201,201,2,psa_55,2D1
1000000US110010047012005,"Block 2005, Block Group 2, Census Tract 47.01, District of Columbia, District of Columbia",0,0,0,0,0,0,0,0,0,0,0,0,0,0,0,0,0,0,0,0,0,0,0,0,0,110010047012005,1,101,101,1,psa_20,1D1
1000000US110010076033012,"Block 3012, Block Group 3, Census Tract 76.03, District of Columbia, District of Columbia",0,0,0,0,0,0,0,0,0,0,0,0,0,0,0,0,0,0,0,0,0,0,0,0,0,110010076033012,6,606,606,6,psa_7,6D2
1000000US110010095031011,"Block 1011, Block Group 1, Census Tract 95.03, District of Columbia, District of Columbia",98,3,91,0,0,0,0,4,98,97,3,90,0,0,0,0,4,1,0,1,0,0,0,0,0,110010095031011,4,405,405,4,psa_49,4D2
1000000US110010008013031,"Block 3031, Block Group 3, Census Tract 8.01, District of Columbia, District of Columbia",37,29,1,0,1,0,6,0,37,31,29,1,0,1,0,0,0,6,0,0,0,0,0,6,0,110010008013031,2,205,205,2,psa_46,2D2
1000000US110010095013009,"Block 3009, Block Group 3, Census Tract 95.01, District of Columbia, District of Columbia",125,83,25,1,13,0,1,2,125,116,77,24,1,13,0,0,1,9,6,1,0,0,0,1,1,110010095013009,4,405,405,4,psa_49,4D2
1000000US110010069001011,"Block 1011, Block Group 1, Census Tract 69, District of Columbia, District of Columbia",0,0,0,0,0,0,0,0,0,0,0,0,0,0,0,0,0,0,0,0,0,0,0,0,0,110010069001011,1,107,107,1,psa_16,1D2
1000000US110010010015015,"Block 5015, Block Group 5, Census Tract 10.01, District of Columbia, District of Columbia",49,49,0,0,0,0,0,0,49,47,47,0,0,0,0,0,0,2,2,0,0,0,0,0,0,110010010015015,2,202,202,2,psa_52,2D1
1000000US110010013012003,"Block 2003, Block Group 2, Census Tract 13.01, District of Columbia, District of Columbia",15,15,0,0,0,0,0,0,15,12,12,0,0,0,0,0,0,3,3,0,0,0,0,0,0,110010013012003,2,203,203,2,psa_50,2D1
1000000US110010020021008,"Block 1008, Block Group 1, Census Tract 20.02, District of Columbia, District of Columbia",10,3,7,0,0,0,0,0,10,10,3,7,0,0,0,0,0,0,0,0,0,0,0,0,0,110010020021008,4,404,404,4,psa_48,4D3
1000000US110010080022017,"Block 2017, Block Group 2, Census Tract 80.02, District of Columbia, District of Columbia",76,28,36,0,5,0,3,4,76,73,27,36,0,5,0,1,4,3,1,0,0,0,0,2,0,110010080022017,1,108,108,1,psa_17,1D2
1000000US110010009021001,"Block 1001, Block Group 1, Census Tract 9.02, District of Columbia, District of Columbia",111,100,4,0,4,0,0,3,111,97,87,4,0,4,0,0,2,14,13,0,0,0,0,0,1,110010009021001,2,205,205,2,psa_46,2D2
1000000US110010015003001,"Block 3001, Block Group 3, Census Tract 15, District of Columbia, District of Columbia",123,108,7,1,4,0,0,3,123,116,102,7,0,4,0,0,3,7,6,0,1,0,0,0,0,110010015003001,2,201,201,2,psa_55,2D1
1000000US110010028011000,"Block 1000, Block Group 1, Census Tract 28.01, District of Columbia, District of Columbia",0,0,0,0,0,0,0,0,0,0,0,0,0,0,0,0,0,0,0,0,0,0,0,0,0,110010028011000,4,408,408,4,psa_39,4D3
1000000US110010076015015,"Block 5015, Block Group 5, Census Tract 76.01, District of Columbia, District of Columbia",125,3,116,0,2,0,1,3,125,122,1,116,0,2,0,0,3,3,2,0,0,0,0,1,0,110010076015015,6,607,607,6,psa_10,6D2
1000000US110010079014002,"Block 4002, Block Group 4, Census Tract 79.01, District of Columbia, District of Columbia",138,5,131,1,0,0,0,1,138,135,4,131,0,0,0,0,0,3,1,0,1,0,0,0,1,110010079014002,5,507,507,5,psa_23,5D3
1000000US110010096031004,"Block 1004, Block Group 1, Census Tract 96.03, District of Columbia, District of Columbia",95,0,95,0,0,0,0,0,95,95,0,95,0,0,0,0,0,0,0,0,0,0,0,0,0,110010096031004,6,603,603,6,psa_15,6D3
1000000US110010008021006,"Block 1006, Block Group 1, Census Tract 8.02, District of Columbia, District of Columbia",503,398,26,2,53,0,9,15,503,459,368,21,2,53,0,2,13,44,30,5,0,0,0,7,2,110010008021006,2,205,205,2,psa_46,2D2
1000000US110010010016017,"Block 6017, Block Group 6, Census Tract 10.01, District of Columbia, District of Columbia",81,72,6,0,1,0,0,2,81,70,61,6,0,1,0,0,2,11,11,0,0,0,0,0,0,110010010016017,2,202,202,2,psa_52,2D1
1000000US110010015001012,"Block 1012, Block Group 1, Census Tract 15, District of Columbia, District of Columbia",130,94,25,0,4,0,3,4,130,116,83,25,0,4,0,1,3,14,11,0,0,0,0,2,1,110010015001012,2,201,201,2,psa_55,2D1
1000000US110010021013004,"Block 3004, Block Group 3, Census Tract 21.01, District of Columbia, District of Columbia",221,44,133,1,2,0,32,9,221,163,26,133,0,2,0,0,2,58,18,0,1,0,0,32,7,110010021013004,4,403,403,4,psa_51,4D1
1000000US110010010011007,"Block 1007, Block Group 1, Census Tract 10.01, District of Columbia, District of Columbia",64,61,0,0,2,0,1,0,64,54,51,0,0,2,0,1,0,10,10,0,0,0,0,0,0,110010010011007,2,202,202,2,psa_52,2D1
1000000US110010023021017,"Block 1017, Block Group 1, Census Tract 23.02, District of Columbia, District of Columbia",0,0,0,0,0,0,0,0,0,0,0,0,0,0,0,0,0,0,0,0,0,0,0,0,0,110010023021017,4,405,405,4,psa_49,4D2
1000000US110010098072007,"Block 2007, Block Group 2, Census Tract 98.07, District of Columbia, District of Columbia",221,0,221,0,0,0,0,0,221,220,0,220,0,0,0,0,0,1,0,1,0,0,0,0,0,110010098072007,7,708,708,7,psa_1,7D3
1000000US110010074072006,"Block 2006, Block Group 2, Census Tract 74.07, District of Columbia, District of Columbia",586,3,573,0,0,0,2,8,586,575,3,566,0,0,0,0,6,11,0,7,0,0,0,2,2,110010074072006,7,703,703,7,psa_8,7D1
1000000US110010079012003,"Block 2003, Block Group 2, Census Tract 79.01, District of Columbia, District of Columbia",135,10,122,0,1,0,0,2,135,133,10,120,0,1,0,0,2,2,0,2,0,0,0,0,0,110010079012003,5,507,507,5,psa_23,5D3
1000000US110010010014001,"Block 4001, Block Group 4, Census Tract 10.01, District of Columbia, District of Columbia",71,71,0,0,0,0,0,0,71,70,70,0,0,0,0,0,0,1,1,0,0,0,0,0,0,110010010014001,2,202,202,2,psa_52,2D1
1000000US110010019012010,"Block 2010, Block Group 2, Census Tract 19.01, District of Columbia, District of Columbia",34,5,29,0,0,0,0,0,34,31,2,29,0,0,0,0,0,3,3,0,0,0,0,0,0,110010019012010,4,402,402,4,psa_53,4D1
1000000US110010070002017,"Block 2017, Block Group 2, Census Tract 70, District of Columbia, District of Columbia",0,0,0,0,0,0,0,0,0,0,0,0,0,0,0,0,0,0,0,0,0,0,0,0,0,110010070002017,1,106,106,1,psa_13,1D3
1000000US110010077031003,"Block 1003, Block Group 1, Census Tract 77.03, District of Columbia, District of Columbia",115,0,115,0,0,0,0,0,115,115,0,115,0,0,0,0,0,0,0,0,0,0,0,0,0,110010077031003,6,603,603,6,psa_15,6D3
1000000US110010022012009,"Block 2009, Block Group 2, Census Tract 22.01, District of Columbia, District of Columbia",158,27,96,0,0,0,29,6,158,122,21,96,0,0,0,3,2,36,6,0,0,0,0,26,4,110010022012009,4,407,407,4,psa_47,4D2
1000000US110010058001010,"Block 1010, Block Group 1, Census Tract 58, District of Columbia, District of Columbia",4,0,4,0,0,0,0,0,4,4,0,4,0,0,0,0,0,0,0,0,0,0,0,0,0,110010058001010,2,209,209,2,psa_57,2D3
1000000US110010062021177,"Block 1177, Block Group 1, Census Tract 62.02, District of Columbia, District of Columbia",0,0,0,0,0,0,0,0,0,0,0,0,0,0,0,0,0,0,0,0,0,0,0,0,0,110010062021177,2,207,207,2,psa_24,2D3
1000000US110010076015002,"Block 5002, Block Group 5, Census Tract 76.01, District of Columbia, District of Columbia",0,0,0,0,0,0,0,0,0,0,0,0,0,0,0,0,0,0,0,0,0,0,0,0,0,110010076015002,6,607,607,6,psa_10,6D2
1000000US110010093021002,"Block 1002, Block Group 1, Census Tract 93.02, District of Columbia, District of Columbia",102,26,72,0,1,0,0,3,102,97,22,71,0,1,0,0,3,5,4,1,0,0,0,0,0,110010093021002,5,504,504,5,psa_43,5D2
1000000US110010067003012,"Block 3012, Block Group 3, Census Tract 67, District of Columbia, District of Columbia",93,74,7,0,8,0,2,2,93,87,69,7,0,8,0,2,1,6,5,0,0,0,0,0,1,110010067003012,1,107,107,1,psa_16,1D2
1000000US110010098032002,"Block 2002, Block Group 2, Census Tract 98.03, District of Columbia, District of Columbia",0,0,0,0,0,0,0,0,0,0,0,0,0,0,0,0,0,0,0,0,0,0,0,0,0,110010098032002,7,707,707,7,psa_4,7D2
1000000US110010041003018,"Block 3018, Block Group 3, Census Tract 41, District of Columbia, District of Columbia",0,0,0,0,0,0,0,0,0,0,0,0,0,0,0,0,0,0,0,0,0,0,0,0,0,110010041003018,2,208,208,2,psa_33,2D3
1000000US110010050012005,"Block 2005, Block Group 2, Census Tract 50.01, District of Columbia, District of Columbia",206,129,40,0,22,0,6,9,206,187,117,39,0,22,0,0,9,19,12,1,0,0,0,6,0,110010050012005,3,307,307,3,psa_28,3D3
1000000US110010072002029,"Block 2029, Block Group 2, Census Tract 72, District of Columbia, District of Columbia",0,0,0,0,0,0,0,0,0,0,0,0,0,0,0,0,0,0,0,0,0,0,0,0,0,110010072002029,1,106,106,1,psa_13,1D3
1000000US110010056002016,"Block 2016, Block Group 2, Census Tract 56, District of Columbia, District of Columbia",0,0,0,0,0,0,0,0,0,0,0,0,0,0,0,0,0,0,0,0,0,0,0,0,0,110010056002016,2,207,207,2,psa_24,2D3
1000000US110010105002022,"Block 2022, Block Group 2, Census Tract 105, District of Columbia, District of Columbia",0,0,0,0,0,0,0,0,0,0,0,0,0,0,0,0,0,0,0,0,0,0,0,0,0,110010105002022,1,103,103,1,psa_12,1D1
1000000US110010019013005,"Block 3005, Block Group 3, Census Tract 19.01, District of Columbia, District of Columbia",63,5,47,0,0,0,11,0,63,52,5,47,0,0,0,0,0,11,0,0,0,0,0,11,0,110010019013005,4,402,402,4,psa_53,4D1
1000000US110010095091007,"Block 1007, Block Group 1, Census Tract 95.09, District of Columbia, District of Columbia",55,0,33,0,0,0,22,0,55,41,0,33,0,0,0,8,0,14,0,0,0,0,0,14,0,110010095091007,4,405,405,4,psa_49,4D2
1000000US110010011004017,"Block 4017, Block Group 4, Census Tract 11, District of Columbia, District of Columbia",0,0,0,0,0,0,0,0,0,0,0,0,0,0,0,0,0,0,0,0,0,0,0,0,0,110010011004017,2,202,202,2,psa_52,2D1
1000000US110010065002010,"Block 2010, Block Group 2, Census Tract 65, District of Columbia, District of Columbia",33,25,8,0,0,0,0,0,33,33,25,8,0,0,0,0,0,0,0,0,0,0,0,0,0,110010065002010,1,106,106,1,psa_13,1D3
1000000US110010107002005,"Block 2005, Block Group 2, Census Tract 107, District of Columbia, District of Columbia",1,0,1,0,0,0,0,0,1,1,0,1,0,0,0,0,0,0,0,0,0,0,0,0,0,110010107002005,2,208,208,2,psa_33,2D3
1000000US110010046002018,"Block 2018, Block Group 2, Census Tract 46, District of Columbia, District of Columbia",86,37,37,0,4,0,4,4,86,81,33,37,0,4,0,3,4,5,4,0,0,0,0,1,0,110010046002018,3,308,308,3,psa_27,3D2
1000000US110010008021009,"Block 1009, Block Group 1, Census Tract 8.02, District of Columbia, District of Columbia",25,20,0,0,4,0,0,1,25,24,19,0,0,4,0,0,1,1,1,0,0,0,0,0,0,110010008021009,2,205,205,2,psa_46,2D2
1000000US110010003004000,"Block 4000, Block Group 4, Census Tract 3, District of Columbia, District of Columbia",138,129,4,1,0,0,2,2,138,128,121,4,0,0,0,1,2,10,8,0,1,0,0,1,0,110010003004000,2,204,204,2,psa_44,2D2
1000000US110010079013003,"Block 3003, Block Group 3, Census Tract 79.01, District of Columbia, District of Columbia",138,29,98,2,0,0,5,4,138,129,23,98,2,0,0,2,4,9,6,0,0,0,0,3,0,110010079013003,5,507,507,5,psa_23,5D3
1000000US110010095031001,"Block 1001, Block Group 1, Census Tract 95.03, District of Columbia, District of Columbia",63,2,59,0,0,0,0,2,63,59,0,59,0,0,0,0,0,4,2,0,0,0,0,0,2,110010095031001,4,405,405,4,psa_49,4D2
1000000US110010076012014,"Block 2014, Block Group 2, Census Tract 76.01, District of Columbia, District of Columbia",0,0,0,0,0,0,0,0,0,0,0,0,0,0,0,0,0,0,0,0,0,0,0,0,0,110010076012014,6,607,607,6,psa_10,6D2
1000000US110010002024014,"Block 4014, Block Group 4, Census Tract 2.02, District of Columbia, District of Columbia",0,0,0,0,0,0,0,0,0,0,0,0,0,0,0,0,0,0,0,0,0,0,0,0,0,110010002024014,2,206,206,2,psa_29,2D2
1000000US110010044002016,"Block 2016, Block Group 2, Census Tract 44, District of Columbia, District of Columbia",121,36,81,0,3,0,1,0,121,119,36,80,0,3,0,0,0,2,0,1,0,0,0,1,0,110010044002016,3,305,305,3,psa_32,3D2
1000000US110010076043010,"Block 3010, Block Group 3, Census Tract 76.04, District of Columbia, District of Columbia",103,4,97,0,1,0,0,1,103,102,3,97,0,1,0,0,1,1,1,0,0,0,0,0,0,110010076043010,6,607,607,6,psa_10,6D2
1000000US110010028011002,"Block 1002, Block Group 1, Census Tract 28.01, District of Columbia, District of Columbia",26,8,8,0,2,0,8,0,26,14,7,5,0,2,0,0,0,12,1,3,0,0,0,8,0,110010028011002,4,408,408,4,psa_39,4D3
1000000US110010016004012,"Block 4012, Block Group 4, Census Tract 16, District of Columbia, District of Columbia",27,18,8,0,1,0,0,0,27,22,13,8,0,1,0,0,0,5,5,0,0,0,0,0,0,110010016004012,4,401,401,4,psa_56,4D1
1000000US110010094003019,"Block 3019, Block Group 3, Census Tract 94, District of Columbia, District of Columbia",65,10,44,0,0,0,10,1,65,47,2,44,0,0,0,0,1,18,8,0,0,0,0,10,0,110010094003019,5,503,503,5,psa_45,5D2
1000000US110010111001031,"Block 1031, Block Group 1, Census Tract 111, District of Columbia, District of Columbia",0,0,0,0,0,0,0,0,0,0,0,0,0,0,0,0,0,0,0,0,0,0,0,0,0,110010111001031,5,503,503,5,psa_45,5D2
1000000US110010002022008,"Block 2008, Block Group 2, Census Tract 2.02, District of Columbia, District of Columbia",105,97,0,0,8,0,0,0,105,103,95,0,0,8,0,0,0,2,2,0,0,0,0,0,0,110010002022008,2,206,206,2,psa_29,2D2
1000000US110010013012010,"Block 2010, Block Group 2, Census Tract 13.01, District of Columbia, District of Columbia",59,50,0,0,7,0,0,2,59,58,49,0,0,7,0,0,2,1,1,0,0,0,0,0,0,110010013012010,2,203,203,2,psa_50,2D1
1000000US110010099012012,"Block 2012, Block Group 2, Census Tract 99.01, District of Columbia, District of Columbia",25,0,25,0,0,0,0,0,25,25,0,25,0,0,0,0,0,0,0,0,0,0,0,0,0,110010099012012,6,605,605,6,psa_11,6D2
1000000US110010099071002,"Block 1002, Block Group 1, Census Tract 99.07, District of Columbia, District of Columbia",222,2,214,3,1,0,0,2,222,217,1,210,3,1,0,0,2,5,1,4,0,0,0,0,0,110010099071002,6,605,605,6,psa_11,6D2
1000000US110010008012003,"Block 2003, Block Group 2, Census Tract 8.01, District of Columbia, District of Columbia",76,76,0,0,0,0,0,0,76,74,74,0,0,0,0,0,0,2,2,0,0,0,0,0,0,110010008012003,2,205,205,2,psa_46,2D2
1000000US110010077091023,"Block 1023, Block Group 1, Census Tract 77.09, District of Columbia, District of Columbia",184,2,174,2,0,0,0,6,184,180,2,170,2,0,0,0,6,4,0,4,0,0,0,0,0,110010077091023,6,605,605,6,psa_11,6D2
1000000US110010013012004,"Block 2004, Block Group 2, Census Tract 13.01, District of Columbia, District of Columbia",11,6,5,0,0,0,0,0,11,5,2,3,0,0,0,0,0,6,4,2,0,0,0,0,0,110010013012004,2,203,203,2,psa_50,2D1
1000000US110010062021092,"Block 1092, Block Group 1, Census Tract 62.02, District of Columbia, District of Columbia",0,0,0,0,0,0,0,0,0,0,0,0,0,0,0,0,0,0,0,0,0,0,0,0,0,110010062021092,2,207,207,2,psa_24,2D3
1000000US110010089031014,"Block 1014, Block Group 1, Census Tract 89.03, District of Columbia, District of Columbia",0,0,0,0,0,0,0,0,0,0,0,0,0,0,0,0,0,0,0,0,0,0,0,0,0,110010089031014,5,507,507,5,psa_23,5D3
1000000US110010003001008,"Block 1008, Block Group 1, Census Tract 3, District of Columbia, District of Columbia",125,109,2,0,6,0,1,7,125,117,102,2,0,6,0,0,7,8,7,0,0,0,0,1,0,110010003001008,2,206,206,2,psa_29,2D2
1000000US110010076012012,"Block 2012, Block Group 2, Census Tract 76.01, District of Columbia, District of Columbia",34,2,32,0,0,0,0,0,34,34,2,32,0,0,0,0,0,0,0,0,0,0,0,0,0,110010076012012,6,607,607,6,psa_10,6D2
1000000US110010083021004,"Block 1004, Block Group 1, Census Tract 83.02, District of Columbia, District of Columbia",214,159,46,0,4,1,0,4,214,205,152,45,0,4,1,0,3,9,7,1,0,0,0,0,1,110010083021004,1,104,104,1,psa_21,1D2
1000000US110010009011001,"Block 1001, Block Group 1, Census Tract 9.01, District of Columbia, District of Columbia",38,37,0,0,1,0,0,0,38,38,37,0,0,1,0,0,0,0,0,0,0,0,0,0,0,110010009011001,2,205,205,2,psa_46,2D2
1000000US110010010021001,"Block 1001, Block Group 1, Census Tract 10.02, District of Columbia, District of Columbia",0,0,0,0,0,0,0,0,0,0,0,0,0,0,0,0,0,0,0,0,0,0,0,0,0,110010010021001,2,204,204,2,psa_44,2D2
1000000US110010104002000,"Block 2000, Block Group 2, Census Tract 104, District of Columbia, District of Columbia",0,0,0,0,0,0,0,0,0,0,0,0,0,0,0,0,0,0,0,0,0,0,0,0,0,110010104002000,7,703,703,7,psa_8,7D1
1000000US110010036002000,"Block 2000, Block Group 2, Census Tract 36, District of Columbia, District of Columbia",356,46,230,2,2,0,61,15,356,268,32,227,1,0,0,0,8,88,14,3,1,2,0,61,7,110010036002000,3,304,304,3,psa_36,3D1
1000000US110010004002015,"Block 2015, Block Group 2, Census Tract 4, District of Columbia, District of Columbia",0,0,0,0,0,0,0,0,0,0,0,0,0,0,0,0,0,0,0,0,0,0,0,0,0,110010004002015,2,204,204,2,psa_44,2D2
1000000US110010093012011,"Block 2011, Block Group 2, Census Tract 93.01, District of Columbia, District of Columbia",3,3,0,0,0,0,0,0,3,3,3,0,0,0,0,0,0,0,0,0,0,0,0,0,0,110010093012011,5,504,504,5,psa_43,5D2
1000000US110010006003002,"Block 3002, Block Group 3, Census Tract 6, District of Columbia, District of Columbia",115,90,4,1,8,0,6,6,115,106,85,4,1,8,0,3,5,9,5,0,0,0,0,3,1,110010006003002,2,203,203,2,psa_50,2D1
1000000US110010010014014,"Block 4014, Block Group 4, Census Tract 10.01, District of Columbia, District of Columbia",5,4,0,1,0,0,0,0,5,5,4,0,1,0,0,0,0,0,0,0,0,0,0,0,0,110010010014014,2,202,202,2,psa_52,2D1
1000000US110010093021004,"Block 1004, Block Group 1, Census Tract 93.02, District of Columbia, District of Columbia",0,0,0,0,0,0,0,0,0,0,0,0,0,0,0,0,0,0,0,0,0,0,0,0,0,110010093021004,5,504,504,5,psa_43,5D2
1000000US110010009022033,"Block 2033, Block Group 2, Census Tract 9.02, District of Columbia, District of Columbia",47,41,0,0,6,0,0,0,47,44,38,0,0,6,0,0,0,3,3,0,0,0,0,0,0,110010009022033,2,205,205,2,psa_46,2D2
1000000US110010078071011,"Block 1011, Block Group 1, Census Tract 78.07, District of Columbia, District of Columbia",86,5,78,0,0,0,0,3,86,81,2,78,0,0,0,0,1,5,3,0,0,0,0,0,2,110010078071011,6,608,608,6,psa_19,6D1
1000000US110010019014015,"Block 4015, Block Group 4, Census Tract 19.01, District of Columbia, District of Columbia",29,9,19,1,0,0,0,0,29,29,9,19,1,0,0,0,0,0,0,0,0,0,0,0,0,110010019014015,4,402,402,4,psa_53,4D1
1000000US110010022013003,"Block 3003, Block Group 3, Census Tract 22.01, District of Columbia, District of Columbia",171,8,145,1,1,0,14,2,171,151,2,145,1,1,0,0,2,20,6,0,0,0,0,14,0,110010022013003,4,407,407,4,psa_47,4D2
1000000US110010088022004,"Block 2004, Block Group 2, Census Tract 88.02, District of Columbia, District of Columbia",50,5,45,0,0,0,0,0,50,48,5,43,0,0,0,0,0,2,0,2,0,0,0,0,0,110010088022004,5,506,506,5,psa_26,5D3
1000000US110010088022000,"Block 2000, Block Group 2, Census Tract 88.02, District of Columbia, District of Columbia",105,6,93,0,1,0,0,5,105,102,6,90,0,1,0,0,5,3,0,3,0,0,0,0,0,110010088022000,5,506,506,5,psa_26,5D3
1000000US110010027023017,"Block 3017, Block Group 3, Census Tract 27.02, District of Columbia, District of Columbia",0,0,0,0,0,0,0,0,0,0,0,0,0,0,0,0,0,0,0,0,0,0,0,0,0,110010027023017,2,204,204,2,psa_44,2D2
1000000US110010006004014,"Block 4014, Block Group 4, Census Tract 6, District of Columbia, District of Columbia",61,56,0,0,2,0,0,3,61,58,53,0,0,2,0,0,3,3,3,0,0,0,0,0,0,110010006004014,2,203,203,2,psa_50,2D1
1000000US110010076014001,"Block 4001, Block Group 4, Census Tract 76.01, District of Columbia, District of Columbia",142,0,142,0,0,0,0,0,142,142,0,142,0,0,0,0,0,0,0,0,0,0,0,0,0,110010076014001,6,607,607,6,psa_10,6D2
1000000US110010110002009,"Block 2009, Block Group 2, Census Tract 110, District of Columbia, District of Columbia",0,0,0,0,0,0,0,0,0,0,0,0,0,0,0,0,0,0,0,0,0,0,0,0,0,110010110002009,1,105,105,1,psa_22,1D3
1000000US110010018041000,"Block 1000, Block Group 1, Census Tract 18.04, District of Columbia, District of Columbia",25,0,17,0,0,0,6,2,25,19,0,17,0,0,0,0,2,6,0,0,0,0,0,6,0,110010018041000,4,401,401,4,psa_56,4D1
1000000US110010041002009,"Block 2009, Block Group 2, Census Tract 41, District of Columbia, District of Columbia",0,0,0,0,0,0,0,0,0,0,0,0,0,0,0,0,0,0,0,0,0,0,0,0,0,110010041002009,2,208,208,2,psa_33,2D3
1000000US110010016001012,"Block 1012, Block Group 1, Census Tract 16, District of Columbia, District of Columbia",67,16,42,0,0,0,2,7,67,60,13,42,0,0,0,0,5,7,3,0,0,0,0,2,2,110010016001012,4,401,401,4,psa_56,4D1
1000000US110010062021065,"Block 1065, Block Group 1, Census Tract 62.02, District of Columbia, District of Columbia",0,0,0,0,0,0,0,0,0,0,0,0,0,0,0,0,0,0,0,0,0,0,0,0,0,110010062021065,2,207,207,2,psa_24,2D3
1000000US110010078041011,"Block 1011, Block Group 1, Census Tract 78.04, District of Columbia, District of Columbia",0,0,0,0,0,0,0,0,0,0,0,0,0,0,0,0,0,0,0,0,0,0,0,0,0,110010078041011,6,602,602,6,psa_25,6D1
1000000US110010002024003,"Block 4003, Block Group 4, Census Tract 2.02, District of Columbia, District of Columbia",93,84,2,0,4,1,2,0,93,84,76,1,0,4,1,2,0,9,8,1,0,0,0,0,0,110010002024003,2,206,206,2,psa_29,2D2
1000000US110010020011005,"Block 1005, Block Group 1, Census Tract 20.01, District of Columbia, District of Columbia",4,0,3,0,1,0,0,0,4,2,0,1,0,1,0,0,0,2,0,2,0,0,0,0,0,110010020011005,4,403,403,4,psa_51,4D1
1000000US110010038002001,"Block 2001, Block Group 2, Census Tract 38, District of Columbia, District of Columbia",0,0,0,0,0,0,0,0,0,0,0,0,0,0,0,0,0,0,0,0,0,0,0,0,0,110010038002001,3,303,303,3,psa_37,3D3
1000000US110010077072006,"Block 2006, Block Group 2, Census Tract 77.07, District of Columbia, District of Columbia",76,4,72,0,0,0,0,0,76,76,4,72,0,0,0,0,0,0,0,0,0,0,0,0,0,110010077072006,6,605,605,6,psa_11,6D2
1000000US110010087021007,"Block 1007, Block Group 1, Census Tract 87.02, District of Columbia, District of Columbia",105,1,101,0,0,0,2,1,105,96,1,95,0,0,0,0,0,9,0,6,0,0,0,2,1,110010087021007,5,502,502,5,psa_40,5D1
1000000US110010089041003,"Block 1003, Block Group 1, Census Tract 89.04, District of Columbia, District of Columbia",333,0,327,0,0,0,0,6,333,327,0,325,0,0,0,0,2,6,0,2,0,0,0,0,4,110010089041003,5,507,507,5,psa_23,5D3
1000000US110010095092011,"Block 2011, Block Group 2, Census Tract 95.09, District of Columbia, District of Columbia",122,15,102,0,3,0,0,2,122,114,7,102,0,3,0,0,2,8,8,0,0,0,0,0,0,110010095092011,4,405,405,4,psa_49,4D2
1000000US110010016004018,"Block 4018, Block Group 4, Census Tract 16, District of Columbia, District of Columbia",56,18,36,0,0,0,2,0,56,55,17,36,0,0,0,2,0,1,1,0,0,0,0,0,0,110010016004018,4,401,401,4,psa_56,4D1
1000000US110010096011045,"Block 1045, Block Group 1, Census Tract 96.01, District of Columbia, District of Columbia",0,0,0,0,0,0,0,0,0,0,0,0,0,0,0,0,0,0,0,0,0,0,0,0,0,110010096011045,6,601,601,6,psa_30,6D1
1000000US110010098033000,"Block 3000, Block Group 3, Census Tract 98.03, District of Columbia, District of Columbia",53,0,49,0,0,0,0,4,53,53,0,49,0,0,0,0,4,0,0,0,0,0,0,0,0,110010098033000,7,707,707,7,psa_4,7D2
1000000US110010015005008,"Block 5008, Block Group 5, Census Tract 15, District of Columbia, District of Columbia",64,60,4,0,0,0,0,0,64,64,60,4,0,0,0,0,0,0,0,0,0,0,0,0,0,110010015005008,2,201,201,2,psa_55,2D1
1000000US110010062021242,"Block 1242, Block Group 1, Census Tract 62.02, District of Columbia, District of Columbia",0,0,0,0,0,0,0,0,0,0,0,0,0,0,0,0,0,0,0,0,0,0,0,0,0,110010062021242,2,207,207,2,psa_24,2D3
1000000US110010020011006,"Block 1006, Block Group 1, Census Tract 20.01, District of Columbia, District of Columbia",97,19,66,0,1,0,4,7,97,91,19,65,0,1,0,0,6,6,0,1,0,0,0,4,1,110010020011006,4,403,403,4,psa_51,4D1
1000000US110010094002013,"Block 2013, Block Group 2, Census Tract 94, District of Columbia, District of Columbia",78,5,72,1,0,0,0,0,78,78,5,72,1,0,0,0,0,0,0,0,0,0,0,0,0,110010094002013,5,503,503,5,psa_45,5D2
1000000US110010037003001,"Block 3001, Block Group 3, Census Tract 37, District of Columbia, District of Columbia",403,109,114,0,14,0,152,14,403,178,47,110,0,11,0,5,5,225,62,4,0,3,0,147,9,110010037003001,3,304,304,3,psa_36,3D1
1000000US110010011001003,"Block 1003, Block Group 1, Census Tract 11, District of Columbia, District of Columbia",77,73,0,0,2,2,0,0,77,73,71,0,0,2,0,0,0,4,2,0,0,0,2,0,0,110010011001003,2,201,201,2,psa_55,2D1
1000000US110010050024002,"Block 4002, Block Group 4, Census Tract 50.02, District of Columbia, District of Columbia",302,169,78,0,29,0,19,7,302,245,132,77,0,29,0,0,7,57,37,1,0,0,0,19,0,110010050024002,3,307,307,3,psa_28,3D3
1000000US110010033011004,"Block 1004, Block Group 1, Census Tract 33.01, District of Columbia, District of Columbia",318,74,225,0,1,0,4,14,318,311,71,223,0,1,0,2,14,7,3,2,0,0,0,2,0,110010033011004,3,306,306,3,psa_38,3D2
1000000US110010050012002,"Block 2002, Block Group 2, Census Tract 50.01, District of Columbia, District of Columbia",295,134,136,0,12,0,2,11,295,277,122,133,0,12,0,1,9,18,12,3,0,0,0,1,2,110010050012002,3,307,307,3,psa_28,3D3
1000000US110010067001009,"Block 1009, Block Group 1, Census Tract 67, District of Columbia, District of Columbia",63,48,8,0,6,0,1,0,63,62,47,8,0,6,0,1,0,1,1,0,0,0,0,0,0,110010067001009,1,107,107,1,psa_16,1D2
1000000US110010015001009,"Block 1009, Block Group 1, Census Tract 15, District of Columbia, District of Columbia",57,35,16,0,2,0,0,4,57,56,34,16,0,2,0,0,4,1,1,0,0,0,0,0,0,110010015001009,2,201,201,2,psa_55,2D1
1000000US110010023021029,"Block 1029, Block Group 1, Census Tract 23.02, District of Columbia, District of Columbia",0,0,0,0,0,0,0,0,0,0,0,0,0,0,0,0,0,0,0,0,0,0,0,0,0,110010023021029,4,405,405,4,psa_49,4D2
1000000US110010088041004,"Block 1004, Block Group 1, Census Tract 88.04, District of Columbia, District of Columbia",121,5,114,0,0,0,1,1,121,119,5,113,0,0,0,0,1,2,0,1,0,0,0,1,0,110010088041004,5,506,506,5,psa_26,5D3
1000000US110010107001008,"Block 1008, Block Group 1, Census Tract 107, District of Columbia, District of Columbia",71,57,0,0,6,0,3,5,71,68,57,0,0,6,0,0,5,3,0,0,0,0,0,3,0,110010107001008,2,207,207,2,psa_24,2D3
1000000US110010111003025,"Block 3025, Block Group 3, Census Tract 111, District of Columbia, District of Columbia",0,0,0,0,0,0,0,0,0,0,0,0,0,0,0,0,0,0,0,0,0,0,0,0,0,110010111003025,5,503,503,5,psa_45,5D2
1000000US110010006004004,"Block 4004, Block Group 4, Census Tract 6, District of Columbia, District of Columbia",39,36,0,0,2,0,0,1,39,31,29,0,0,2,0,0,0,8,7,0,0,0,0,0,1,110010006004004,2,203,203,2,psa_50,2D1
1000000US110010049022011,"Block 2011, Block Group 2, Census Tract 49.02, District of Columbia, District of Columbia",0,0,0,0,0,0,0,0,0,0,0,0,0,0,0,0,0,0,0,0,0,0,0,0,0,110010049022011,3,307,307,3,psa_28,3D3
1000000US110010006004007,"Block 4007, Block Group 4, Census Tract 6, District of Columbia, District of Columbia",28,26,1,0,0,0,0,1,28,28,26,1,0,0,0,0,1,0,0,0,0,0,0,0,0,110010006004007,2,203,203,2,psa_50,2D1
1000000US110010016001021,"Block 1021, Block Group 1, Census Tract 16, District of Columbia, District of Columbia",35,16,18,0,1,0,0,0,35,34,15,18,0,1,0,0,0,1,1,0,0,0,0,0,0,110010016001021,4,401,401,4,psa_56,4D1
1000000US110010106002022,"Block 2022, Block Group 2, Census Tract 106, District of Columbia, District of Columbia",0,0,0,0,0,0,0,0,0,0,0,0,0,0,0,0,0,0,0,0,0,0,0,0,0,110010106002022,5,501,501,5,psa_35,5D1
1000000US110010079013005,"Block 3005, Block Group 3, Census Tract 79.01, District of Columbia, District of Columbia",150,38,112,0,0,0,0,0,150,148,36,112,0,0,0,0,0,2,2,0,0,0,0,0,0,110010079013005,5,507,507,5,psa_23,5D3
1000000US110010052011006,"Block 1006, Block Group 1, Census Tract 52.01, District of Columbia, District of Columbia",0,0,0,0,0,0,0,0,0,0,0,0,0,0,0,0,0,0,0,0,0,0,0,0,0,110010052011006,3,307,307,3,psa_28,3D3
1000000US110010073011079,"Block 1079, Block Group 1, Census Tract 73.01, District of Columbia, District of Columbia",0,0,0,0,0,0,0,0,0,0,0,0,0,0,0,0,0,0,0,0,0,0,0,0,0,110010073011079,7,707,707,7,psa_4,7D2
1000000US110010092011009,"Block 1009, Block Group 1, Census Tract 92.01, District of Columbia, District of Columbia",98,30,44,1,4,0,13,6,98,77,20,44,1,4,0,6,2,21,10,0,0,0,0,7,4,110010092011009,5,502,502,5,psa_40,5D1
1000000US110010032002002,"Block 2002, Block Group 2, Census Tract 32, District of Columbia, District of Columbia",118,15,86,0,0,0,17,0,118,92,8,84,0,0,0,0,0,26,7,2,0,0,0,17,0,110010032002002,4,409,409,4,psa_41,4D3
1000000US110010104002019,"Block 2019, Block Group 2, Census Tract 104, District of Columbia, District of Columbia",176,4,168,1,0,0,0,3,176,172,4,165,0,0,0,0,3,4,0,3,1,0,0,0,0,110010104002019,7,707,707,7,psa_4,7D2
1000000US110010111003020,"Block 3020, Block Group 3, Census Tract 111, District of Columbia, District of Columbia",0,0,0,0,0,0,0,0,0,0,0,0,0,0,0,0,0,0,0,0,0,0,0,0,0,110010111003020,5,506,506,5,psa_26,5D3
1000000US110010014012001,"Block 2001, Block Group 2, Census Tract 14.01, District of Columbia, District of Columbia",58,55,0,0,1,0,0,2,58,56,53,0,0,1,0,0,2,2,2,0,0,0,0,0,0,110010014012001,2,201,201,2,psa_55,2D1
1000000US110010025011002,"Block 1002, Block Group 1, Census Tract 25.01, District of Columbia, District of Columbia",196,38,104,0,2,0,48,4,196,135,27,101,0,2,0,1,4,61,11,3,0,0,0,47,0,110010025011002,4,404,404,4,psa_48,4D3
1000000US110010011002019,"Block 2019, Block Group 2, Census Tract 11, District of Columbia, District of Columbia",19,18,0,0,0,0,0,1,19,19,18,0,0,0,0,0,1,0,0,0,0,0,0,0,0,110010011002019,2,202,202,2,psa_52,2D1
1000000US110010075022000,"Block 2000, Block Group 2, Census Tract 75.02, District of Columbia, District of Columbia",44,0,42,0,0,0,0,2,44,43,0,41,0,0,0,0,2,1,0,1,0,0,0,0,0,110010075022000,7,702,702,7,psa_6,7D1
1000000US110010078082004,"Block 2004, Block Group 2, Census Tract 78.08, District of Columbia, District of Columbia",57,0,56,0,0,0,0,1,57,57,0,56,0,0,0,0,1,0,0,0,0,0,0,0,0,110010078082004,6,608,608,6,psa_19,6D1
1000000US110010083021018,"Block 1018, Block Group 1, Census Tract 83.02, District of Columbia, District of Columbia",0,0,0,0,0,0,0,0,0,0,0,0,0,0,0,0,0,0,0,0,0,0,0,0,0,110010083021018,1,108,108,1,psa_17,1D2
1000000US110010111003041,"Block 3041, Block Group 3, Census Tract 111, District of Columbia, District of Columbia",44,4,40,0,0,0,0,0,44,44,4,40,0,0,0,0,0,0,0,0,0,0,0,0,0,110010111003041,5,503,503,5,psa_45,5D2
1000000US110010019022006,"Block 2006, Block Group 2, Census Tract 19.02, District of Columbia, District of Columbia",62,9,44,0,1,0,0,8,62,62,9,44,0,1,0,0,8,0,0,0,0,0,0,0,0,110010019022006,4,406,406,4,psa_54,4D2
1000000US110010007014009,"Block 4009, Block Group 4, Census Tract 7.01, District of Columbia, District of Columbia",16,13,0,0,3,0,0,0,16,16,13,0,0,3,0,0,0,0,0,0,0,0,0,0,0,110010007014009,2,204,204,2,psa_44,2D2
1000000US110010062021082,"Block 1082, Block Group 1, Census Tract 62.02, District of Columbia, District of Columbia",0,0,0,0,0,0,0,0,0,0,0,0,0,0,0,0,0,0,0,0,0,0,0,0,0,110010062021082,2,207,207,2,psa_24,2D3
1000000US110010062021101,"Block 1101, Block Group 1, Census Tract 62.02, District of Columbia, District of Columbia",0,0,0,0,0,0,0,0,0,0,0,0,0,0,0,0,0,0,0,0,0,0,0,0,0,110010062021101,1,103,103,1,psa_12,1D1
1000000US110010008021014,"Block 1014, Block Group 1, Census Tract 8.02, District of Columbia, District of Columbia",0,0,0,0,0,0,0,0,0,0,0,0,0,0,0,0,0,0,0,0,0,0,0,0,0,110010008021014,2,205,205,2,psa_46,2D2
1000000US110010072002042,"Block 2042, Block Group 2, Census Tract 72, District of Columbia, District of Columbia",4,4,0,0,0,0,0,0,4,4,4,0,0,0,0,0,0,0,0,0,0,0,0,0,0,110010072002042,1,106,106,1,psa_13,1D3
1000000US110010096011017,"Block 1017, Block Group 1, Census Tract 96.01, District of Columbia, District of Columbia",0,0,0,0,0,0,0,0,0,0,0,0,0,0,0,0,0,0,0,0,0,0,0,0,0,110010096011017,6,601,601,6,psa_30,6D1
1000000US110010104002044,"Block 2044, Block Group 2, Census Tract 104, District of Columbia, District of Columbia",0,0,0,0,0,0,0,0,0,0,0,0,0,0,0,0,0,0,0,0,0,0,0,0,0,110010104002044,7,703,703,7,psa_8,7D1
1000000US110010013023002,"Block 3002, Block Group 3, Census Tract 13.02, District of Columbia, District of Columbia",0,0,0,0,0,0,0,0,0,0,0,0,0,0,0,0,0,0,0,0,0,0,0,0,0,110010013023002,2,203,203,2,psa_50,2D1
1000000US110010099022002,"Block 2002, Block Group 2, Census Tract 99.02, District of Columbia, District of Columbia",147,0,143,4,0,0,0,0,147,146,0,142,4,0,0,0,0,1,0,1,0,0,0,0,0,110010099022002,6,605,605,6,psa_11,6D2
1000000US110010015002012,"Block 2012, Block Group 2, Census Tract 15, District of Columbia, District of Columbia",76,65,3,0,1,0,0,7,76,74,63,3,0,1,0,0,7,2,2,0,0,0,0,0,0,110010015002012,2,201,201,2,psa_55,2D1
1000000US110010089031002,"Block 1002, Block Group 1, Census Tract 89.03, District of Columbia, District of Columbia",129,3,117,2,2,0,4,1,129,123,3,116,1,2,0,0,1,6,0,1,1,0,0,4,0,110010089031002,5,507,507,5,psa_23,5D3
1000000US110010058001021,"Block 1021, Block Group 1, Census Tract 58, District of Columbia, District of Columbia",0,0,0,0,0,0,0,0,0,0,0,0,0,0,0,0,0,0,0,0,0,0,0,0,0,110010058001021,2,207,207,2,psa_24,2D3
1000000US110010101001025,"Block 1025, Block Group 1, Census Tract 101, District of Columbia, District of Columbia",0,0,0,0,0,0,0,0,0,0,0,0,0,0,0,0,0,0,0,0,0,0,0,0,0,110010101001025,2,209,209,2,psa_57,2D3
1000000US110010005011004,"Block 1004, Block Group 1, Census Tract 5.01, District of Columbia, District of Columbia",4,4,0,0,0,0,0,0,4,4,4,0,0,0,0,0,0,0,0,0,0,0,0,0,0,110010005011004,2,204,204,2,psa_44,2D2
1000000US110010025011005,"Block 1005, Block Group 1, Census Tract 25.01, District of Columbia, District of Columbia",0,0,0,0,0,0,0,0,0,0,0,0,0,0,0,0,0,0,0,0,0,0,0,0,0,110010025011005,4,404,404,4,psa_48,4D3
1000000US110010027013000,"Block 3000, Block Group 3, Census Tract 27.01, District of Columbia, District of Columbia",482,372,64,3,18,0,6,19,482,441,343,61,2,18,0,1,16,41,29,3,1,0,0,5,3,110010027013000,3,302,302,3,psa_42,3D1
1000000US110010107001005,"Block 1005, Block Group 1, Census Tract 107, District of Columbia, District of Columbia",0,0,0,0,0,0,0,0,0,0,0,0,0,0,0,0,0,0,0,0,0,0,0,0,0,110010107001005,2,207,207,2,psa_24,2D3
1000000US110010107001031,"Block 1031, Block Group 1, Census Tract 107, District of Columbia, District of Columbia",0,0,0,0,0,0,0,0,0,0,0,0,0,0,0,0,0,0,0,0,0,0,0,0,0,110010107001031,2,207,207,2,psa_24,2D3
1000000US110010014012005,"Block 2005, Block Group 2, Census Tract 14.01, District of Columbia, District of Columbia",81,75,0,1,5,0,0,0,81,75,70,0,0,5,0,0,0,6,5,0,1,0,0,0,0,110010014012005,2,201,201,2,psa_55,2D1
1000000US110010094001014,"Block 1014, Block Group 1, Census Tract 94, District of Columbia, District of Columbia",28,6,22,0,0,0,0,0,28,25,3,22,0,0,0,0,0,3,3,0,0,0,0,0,0,110010094001014,5,503,503,5,psa_45,5D2
1000000US110010013013002,"Block 3002, Block Group 3, Census Tract 13.01, District of Columbia, District of Columbia",736,478,112,2,108,0,16,20,736,668,426,111,2,108,0,4,17,68,52,1,0,0,0,12,3,110010013013002,2,203,203,2,psa_50,2D1
1000000US110010099061006,"Block 1006, Block Group 1, Census Tract 99.06, District of Columbia, District of Columbia",126,0,126,0,0,0,0,0,126,126,0,126,0,0,0,0,0,0,0,0,0,0,0,0,0,110010099061006,6,604,604,6,psa_14,6D3
1000000US110010010012007,"Block 2007, Block Group 2, Census Tract 10.01, District of Columbia, District of Columbia",52,48,1,0,3,0,0,0,52,49,45,1,0,3,0,0,0,3,3,0,0,0,0,0,0,110010010012007,2,202,202,2,psa_52,2D1
1000000US110010026002031,"Block 2031, Block Group 2, Census Tract 26, District of Columbia, District of Columbia",83,43,32,0,4,0,2,2,83,78,40,32,0,4,0,0,2,5,3,0,0,0,0,2,0,110010026002031,4,404,404,4,psa_48,4D3
1000000US110010055003009,"Block 3009, Block Group 3, Census Tract 55, District of Columbia, District of Columbia",121,105,4,0,8,0,2,2,121,106,93,3,0,8,0,0,2,15,12,1,0,0,0,2,0,110010055003009,2,207,207,2,psa_24,2D3
1000000US110010033022005,"Block 2005, Block Group 2, Census Tract 33.02, District of Columbia, District of Columbia",114,37,71,0,1,0,0,5,114,112,37,69,0,1,0,0,5,2,0,2,0,0,0,0,0,110010033022005,3,308,308,3,psa_27,3D2
1000000US110010021024008,"Block 4008, Block Group 4, Census Tract 21.02, District of Columbia, District of Columbia",0,0,0,0,0,0,0,0,0,0,0,0,0,0,0,0,0,0,0,0,0,0,0,0,0,110010021024008,4,403,403,4,psa_51,4D1
1000000US110010079012000,"Block 2000, Block Group 2, Census Tract 79.01, District of Columbia, District of Columbia",175,33,136,0,3,0,1,2,175,174,33,136,0,3,0,0,2,1,0,0,0,0,0,1,0,110010079012000,5,507,507,5,psa_23,5D3
1000000US110010111002010,"Block 2010, Block Group 2, Census Tract 111, District of Columbia, District of Columbia",56,3,53,0,0,0,0,0,56,55,3,52,0,0,0,0,0,1,0,1,0,0,0,0,0,110010111002010,5,503,503,5,psa_45,5D2
1000000US110010094003003,"Block 3003, Block Group 3, Census Tract 94, District of Columbia, District of Columbia",0,0,0,0,0,0,0,0,0,0,0,0,0,0,0,0,0,0,0,0,0,0,0,0,0,110010094003003,5,503,503,5,psa_45,5D2
1000000US110010041003031,"Block 3031, Block Group 3, Census Tract 41, District of Columbia, District of Columbia",46,30,0,0,1,0,15,0,46,29,28,0,0,1,0,0,0,17,2,0,0,0,0,15,0,110010041003031,2,208,208,2,psa_33,2D3
1000000US110010078092000,"Block 2000, Block Group 2, Census Tract 78.09, District of Columbia, District of Columbia",70,2,67,0,0,0,0,1,70,69,1,67,0,0,0,0,1,1,1,0,0,0,0,0,0,110010078092000,6,602,602,6,psa_25,6D1
1000000US110010094002021,"Block 2021, Block Group 2, Census Tract 94, District of Columbia, District of Columbia",0,0,0,0,0,0,0,0,0,0,0,0,0,0,0,0,0,0,0,0,0,0,0,0,0,110010094002021,5,504,504,5,psa_43,5D2
1000000US110010076011007,"Block 1007, Block Group 1, Census Tract 76.01, District of Columbia, District of Columbia",0,0,0,0,0,0,0,0,0,0,0,0,0,0,0,0,0,0,0,0,0,0,0,0,0,110010076011007,6,607,607,6,psa_10,6D2
1000000US110010074071007,"Block 1007, Block Group 1, Census Tract 74.07, District of Columbia, District of Columbia",8,0,8,0,0,0,0,0,8,8,0,8,0,0,0,0,0,0,0,0,0,0,0,0,0,110010074071007,7,703,703,7,psa_8,7D1
1000000US110010107002021,"Block 2021, Block Group 2, Census Tract 107, District of Columbia, District of Columbia",0,0,0,0,0,0,0,0,0,0,0,0,0,0,0,0,0,0,0,0,0,0,0,0,0,110010107002021,2,208,208,2,psa_33,2D3
1000000US110010099021013,"Block 1013, Block Group 1, Census Tract 99.02, District of Columbia, District of Columbia",73,0,73,0,0,0,0,0,73,71,0,71,0,0,0,0,0,2,0,2,0,0,0,0,0,110010099021013,6,605,605,6,psa_11,6D2
1000000US110010104002026,"Block 2026, Block Group 2, Census Tract 104, District of Columbia, District of Columbia",0,0,0,0,0,0,0,0,0,0,0,0,0,0,0,0,0,0,0,0,0,0,0,0,0,110010104002026,7,703,703,7,psa_8,7D1
1000000US110010019013000,"Block 3000, Block Group 3, Census Tract 19.01, District of Columbia, District of Columbia",129,20,82,0,0,0,17,10,129,100,17,76,0,0,0,0,7,29,3,6,0,0,0,17,3,110010019013000,4,402,402,4,psa_53,4D1
1000000US110010062021183,"Block 1183, Block Group 1, Census Tract 62.02, District of Columbia, District of Columbia",0,0,0,0,0,0,0,0,0,0,0,0,0,0,0,0,0,0,0,0,0,0,0,0,0,110010062021183,2,207,207,2,psa_24,2D3
1000000US110010098071006,"Block 1006, Block Group 1, Census Tract 98.07, District of Columbia, District of Columbia",55,0,54,0,0,0,1,0,55,54,0,54,0,0,0,0,0,1,0,0,0,0,0,1,0,110010098071006,7,708,708,7,psa_1,7D3
1000000US110010020011001,"Block 1001, Block Group 1, Census Tract 20.01, District of Columbia, District of Columbia",622,84,296,4,25,0,199,14,622,349,33,286,0,22,0,5,3,273,51,10,4,3,0,194,11,110010020011001,4,403,403,4,psa_51,4D1
1000000US110010049012011,"Block 2011, Block Group 2, Census Tract 49.01, District of Columbia, District of Columbia",123,84,21,0,5,0,5,8,123,103,69,21,0,5,0,1,7,20,15,0,0,0,0,4,1,110010049012011,3,307,307,3,psa_28,3D3
1000000US110010095033011,"Block 3011, Block Group 3, Census Tract 95.03, District of Columbia, District of Columbia",6,0,5,0,0,0,0,1,6,6,0,5,0,0,0,0,1,0,0,0,0,0,0,0,0,110010095033011,5,504,504,5,psa_43,5D2
1000000US110010014011010,"Block 1010, Block Group 1, Census Tract 14.01, District of Columbia, District of Columbia",73,71,0,0,0,0,0,2,73,69,67,0,0,0,0,0,2,4,4,0,0,0,0,0,0,110010014011010,2,201,201,2,psa_55,2D1
1000000US110010055003005,"Block 3005, Block Group 3, Census Tract 55, District of Columbia, District of Columbia",363,304,15,1,33,0,3,7,363,333,277,15,1,33,0,0,7,30,27,0,0,0,0,3,0,110010055003005,2,207,207,2,psa_24,2D3
1000000US110010104002043,"Block 2043, Block Group 2, Census Tract 104, District of Columbia, District of Columbia",109,6,99,0,1,0,0,3,109,109,6,99,0,1,0,0,3,0,0,0,0,0,0,0,0,110010104002043,7,707,707,7,psa_4,7D2
1000000US110010064002016,"Block 2016, Block Group 2, Census Tract 64, District of Columbia, District of Columbia",0,0,0,0,0,0,0,0,0,0,0,0,0,0,0,0,0,0,0,0,0,0,0,0,0,110010064002016,1,105,105,1,psa_22,1D3
1000000US110010105001004,"Block 1004, Block Group 1, Census Tract 105, District of Columbia, District of Columbia",255,0,249,0,5,0,0,1,255,255,0,249,0,5,0,0,1,0,0,0,0,0,0,0,0,110010105001004,1,105,105,1,psa_22,1D3
1000000US110010035002003,"Block 2003, Block Group 2, Census Tract 35, District of Columbia, District of Columbia",2,0,1,0,0,0,0,1,2,1,0,1,0,0,0,0,0,1,0,0,0,0,0,0,1,110010035002003,3,305,305,3,psa_32,3D2
1000000US110010006003004,"Block 3004, Block Group 3, Census Tract 6, District of Columbia, District of Columbia",45,44,0,0,0,0,0,1,45,44,43,0,0,0,0,0,1,1,1,0,0,0,0,0,0,110010006003004,2,204,204,2,psa_44,2D2
1000000US110010077082013,"Block 2013, Block Group 2, Census Tract 77.08, District of Columbia, District of Columbia",0,0,0,0,0,0,0,0,0,0,0,0,0,0,0,0,0,0,0,0,0,0,0,0,0,110010077082013,6,603,603,6,psa_15,6D3
1000000US110010087011008,"Block 1008, Block Group 1, Census Tract 87.01, District of Columbia, District of Columbia",54,10,43,0,0,0,1,0,54,51,8,43,0,0,0,0,0,3,2,0,0,0,0,1,0,110010087011008,5,502,502,5,psa_40,5D1
1000000US110010072002013,"Block 2013, Block Group 2, Census Tract 72, District of Columbia, District of Columbia",3,0,3,0,0,0,0,0,3,3,0,3,0,0,0,0,0,0,0,0,0,0,0,0,0,110010072002013,1,106,106,1,psa_13,1D3
1000000US110010077091021,"Block 1021, Block Group 1, Census Tract 77.09, District of Columbia, District of Columbia",49,0,45,0,0,0,0,4,49,47,0,45,0,0,0,0,2,2,0,0,0,0,0,0,2,110010077091021,6,605,605,6,psa_11,6D2
1000000US110010001003010,"Block 3010, Block Group 3, Census Tract 1, District of Columbia, District of Columbia",72,71,0,0,1,0,0,0,72,66,65,0,0,1,0,0,0,6,6,0,0,0,0,0,0,110010001003010,2,206,206,2,psa_29,2D2
1000000US110010003003000,"Block 3000, Block Group 3, Census Tract 3, District of Columbia, District of Columbia",273,242,8,0,13,0,4,6,273,258,231,8,0,13,0,2,4,15,11,0,0,0,0,2,2,110010003003000,2,204,204,2,psa_44,2D2
1000000US110010089031000,"Block 1000, Block Group 1, Census Tract 89.03, District of Columbia, District of Columbia",75,4,67,0,0,0,0,4,75,69,2,67,0,0,0,0,0,6,2,0,0,0,0,0,4,110010089031000,5,507,507,5,psa_23,5D3
1000000US110010096021014,"Block 1014, Block Group 1, Census Tract 96.02, District of Columbia, District of Columbia",0,0,0,0,0,0,0,0,0,0,0,0,0,0,0,0,0,0,0,0,0,0,0,0,0,110010096021014,6,601,601,6,psa_30,6D1
1000000US110010024002004,"Block 2004, Block Group 2, Census Tract 24, District of Columbia, District of Columbia",110,17,91,0,0,0,0,2,110,110,17,91,0,0,0,0,2,0,0,0,0,0,0,0,0,110010024002004,4,407,407,4,psa_47,4D2
1000000US110010062021250,"Block 1250, Block Group 1, Census Tract 62.02, District of Columbia, District of Columbia",0,0,0,0,0,0,0,0,0,0,0,0,0,0,0,0,0,0,0,0,0,0,0,0,0,110010062021250,2,207,207,2,psa_24,2D3
1000000US110010074011019,"Block 1019, Block Group 1, Census Tract 74.01, District of Columbia, District of Columbia",0,0,0,0,0,0,0,0,0,0,0,0,0,0,0,0,0,0,0,0,0,0,0,0,0,110010074011019,7,703,703,7,psa_8,7D1
1000000US110010080011006,"Block 1006, Block Group 1, Census Tract 80.01, District of Columbia, District of Columbia",41,24,16,0,0,0,0,1,41,40,23,16,0,0,0,0,1,1,1,0,0,0,0,0,0,110010080011006,1,104,104,1,psa_21,1D2
1000000US110010062021098,"Block 1098, Block Group 1, Census Tract 62.02, District of Columbia, District of Columbia",0,0,0,0,0,0,0,0,0,0,0,0,0,0,0,0,0,0,0,0,0,0,0,0,0,110010062021098,2,207,207,2,psa_24,2D3
1000000US110010016004033,"Block 4033, Block Group 4, Census Tract 16, District of Columbia, District of Columbia",0,0,0,0,0,0,0,0,0,0,0,0,0,0,0,0,0,0,0,0,0,0,0,0,0,110010016004033,4,401,401,4,psa_56,4D1
1000000US110010076043009,"Block 3009, Block Group 3, Census Tract 76.04, District of Columbia, District of Columbia",98,1,93,0,3,0,0,1,98,95,0,92,0,3,0,0,0,3,1,1,0,0,0,0,1,110010076043009,6,607,607,6,psa_10,6D2
1000000US110010074071010,"Block 1010, Block Group 1, Census Tract 74.07, District of Columbia, District of Columbia",290,0,287,0,0,0,0,3,290,283,0,281,0,0,0,0,2,7,0,6,0,0,0,0,1,110010074071010,7,702,702,7,psa_6,7D1
1000000US110010103003011,"Block 3011, Block Group 3, Census Tract 103, District of Columbia, District of Columbia",401,71,216,13,7,2,71,21,401,279,45,210,5,7,2,1,9,122,26,6,8,0,0,70,12,110010103003011,4,401,401,4,psa_56,4D1
1000000US110010106003006,"Block 3006, Block Group 3, Census Tract 106, District of Columbia, District of Columbia",131,26,100,0,1,0,0,4,131,127,25,100,0,0,0,0,2,4,1,0,0,1,0,0,2,110010106003006,1,104,104,1,psa_21,1D2
1000000US110010090001000,"Block 1000, Block Group 1, Census Tract 90, District of Columbia, District of Columbia",0,0,0,0,0,0,0,0,0,0,0,0,0,0,0,0,0,0,0,0,0,0,0,0,0,110010090001000,5,503,503,5,psa_45,5D2
1000000US110010044001014,"Block 1014, Block Group 1, Census Tract 44, District of Columbia, District of Columbia",18,9,9,0,0,0,0,0,18,18,9,9,0,0,0,0,0,0,0,0,0,0,0,0,0,110010044001014,3,305,305,3,psa_32,3D2
1000000US110010023021008,"Block 1008, Block Group 1, Census Tract 23.02, District of Columbia, District of Columbia",0,0,0,0,0,0,0,0,0,0,0,0,0,0,0,0,0,0,0,0,0,0,0,0,0,110010023021008,4,405,405,4,psa_49,4D2
1000000US110010102002029,"Block 2029, Block Group 2, Census Tract 102, District of Columbia, District of Columbia",0,0,0,0,0,0,0,0,0,0,0,0,0,0,0,0,0,0,0,0,0,0,0,0,0,110010102002029,1,103,103,1,psa_12,1D1
1000000US110010077082020,"Block 2020, Block Group 2, Census Tract 77.08, District of Columbia, District of Columbia",0,0,0,0,0,0,0,0,0,0,0,0,0,0,0,0,0,0,0,0,0,0,0,0,0,110010077082020,1,107,107,1,psa_16,1D2
1000000US110010010015007,"Block 5007, Block Group 5, Census Tract 10.01, District of Columbia, District of Columbia",48,40,3,0,5,0,0,0,48,48,40,3,0,5,0,0,0,0,0,0,0,0,0,0,0,110010010015007,2,202,202,2,psa_52,2D1
1000000US110010050011000,"Block 1000, Block Group 1, Census Tract 50.01, District of Columbia, District of Columbia",0,0,0,0,0,0,0,0,0,0,0,0,0,0,0,0,0,0,0,0,0,0,0,0,0,110010050011000,3,307,307,3,psa_28,3D3
1000000US110010082002001,"Block 2001, Block Group 2, Census Tract 82, District of Columbia, District of Columbia",108,87,13,0,8,0,0,0,108,106,86,13,0,7,0,0,0,2,1,0,0,1,0,0,0,110010082002001,1,108,108,1,psa_17,1D2
1000000US110010105002021,"Block 2021, Block Group 2, Census Tract 105, District of Columbia, District of Columbia",0,0,0,0,0,0,0,0,0,0,0,0,0,0,0,0,0,0,0,0,0,0,0,0,0,110010105002021,1,103,103,1,psa_12,1D1
1000000US110010001004006,"Block 4006, Block Group 4, Census Tract 1, District of Columbia, District of Columbia",68,63,2,0,2,0,1,0,68,67,63,2,0,2,0,0,0,1,0,0,0,0,0,1,0,110010001004006,2,206,206,2,psa_29,2D2
1000000US110010104001009,"Block 1009, Block Group 1, Census Tract 104, District of Columbia, District of Columbia",62,0,62,0,0,0,0,0,62,62,0,62,0,0,0,0,0,0,0,0,0,0,0,0,0,110010104001009,7,705,705,7,psa_3,7D2
1000000US110010009011000,"Block 1000, Block Group 1, Census Tract 9.01, District of Columbia, District of Columbia",19,18,1,0,0,0,0,0,19,19,18,1,0,0,0,0,0,0,0,0,0,0,0,0,0,110010009011000,2,205,205,2,psa_46,2D2
1000000US110010002024019,"Block 4019, Block Group 4, Census Tract 2.02, District of Columbia, District of Columbia",0,0,0,0,0,0,0,0,0,0,0,0,0,0,0,0,0,0,0,0,0,0,0,0,0,110010002024019,2,206,206,2,psa_29,2D2
1000000US110010036001002,"Block 1002, Block Group 1, Census Tract 36, District of Columbia, District of Columbia",303,206,32,1,20,0,27,17,303,245,185,32,1,20,0,2,5,58,21,0,0,0,0,25,12,110010036001002,3,304,304,3,psa_36,3D1
1000000US110010058001001,"Block 1001, Block Group 1, Census Tract 58, District of Columbia, District of Columbia",0,0,0,0,0,0,0,0,0,0,0,0,0,0,0,0,0,0,0,0,0,0,0,0,0,110010058001001,1,101,101,1,psa_20,1D1
1000000US110010111001024,"Block 1024, Block Group 1, Census Tract 111, District of Columbia, District of Columbia",77,3,72,0,0,0,0,2,77,74,1,72,0,0,0,0,1,3,2,0,0,0,0,0,1,110010111001024,5,503,503,5,psa_45,5D2
1000000US110010096011046,"Block 1046, Block Group 1, Census Tract 96.01, District of Columbia, District of Columbia",0,0,0,0,0,0,0,0,0,0,0,0,0,0,0,0,0,0,0,0,0,0,0,0,0,110010096011046,6,601,601,6,psa_30,6D1
1000000US110010001004003,"Block 4003, Block Group 4, Census Tract 1, District of Columbia, District of Columbia",83,80,1,0,0,0,1,1,83,80,78,1,0,0,0,0,1,3,2,0,0,0,0,1,0,110010001004003,2,206,206,2,psa_29,2D2
1000000US110010019013011,"Block 3011, Block Group 3, Census Tract 19.01, District of Columbia, District of Columbia",90,1,71,3,2,0,13,0,90,77,1,71,3,2,0,0,0,13,0,0,0,0,0,13,0,110010019013011,4,402,402,4,psa_53,4D1
1000000US110010103003006,"Block 3006, Block Group 3, Census Tract 103, District of Columbia, District of Columbia",31,6,25,0,0,0,0,0,31,29,4,25,0,0,0,0,0,2,2,0,0,0,0,0,0,110010103003006,4,401,401,4,psa_56,4D1
1000000US110010065002006,"Block 2006, Block Group 2, Census Tract 65, District of Columbia, District of Columbia",213,183,8,1,17,0,1,3,213,199,171,7,1,17,0,0,3,14,12,1,0,0,0,1,0,110010065002006,1,106,106,1,psa_13,1D3
1000000US110010098031001,"Block 1001, Block Group 1, Census Tract 98.03, District of Columbia, District of Columbia",71,0,71,0,0,0,0,0,71,71,0,71,0,0,0,0,0,0,0,0,0,0,0,0,0,110010098031001,7,707,707,7,psa_4,7D2
1000000US110010016004025,"Block 4025, Block Group 4, Census Tract 16, District of Columbia, District of Columbia",69,21,45,0,0,0,0,3,69,66,19,44,0,0,0,0,3,3,2,1,0,0,0,0,0,110010016004025,4,401,401,4,psa_56,4D1
1000000US110010049022010,"Block 2010, Block Group 2, Census Tract 49.02, District of Columbia, District of Columbia",0,0,0,0,0,0,0,0,0,0,0,0,0,0,0,0,0,0,0,0,0,0,0,0,0,110010049022010,3,307,307,3,psa_28,3D3
1000000US110010049022002,"Block 2002, Block Group 2, Census Tract 49.02, District of Columbia, District of Columbia",82,47,18,0,7,0,10,0,82,69,43,18,0,7,0,1,0,13,4,0,0,0,0,9,0,110010049022002,3,307,307,3,psa_28,3D3
1000000US110010068012005,"Block 2005, Block Group 2, Census Tract 68.01, District of Columbia, District of Columbia",81,55,20,0,2,0,0,4,81,79,55,20,0,2,0,0,2,2,0,0,0,0,0,0,2,110010068012005,1,107,107,1,psa_16,1D2
1000000US110010077071000,"Block 1000, Block Group 1, Census Tract 77.07, District of Columbia, District of Columbia",0,0,0,0,0,0,0,0,0,0,0,0,0,0,0,0,0,0,0,0,0,0,0,0,0,110010077071000,6,604,604,6,psa_14,6D3
1000000US110010096011019,"Block 1019, Block Group 1, Census Tract 96.01, District of Columbia, District of Columbia",75,0,68,3,0,0,0,4,75,75,0,68,3,0,0,0,4,0,0,0,0,0,0,0,0,110010096011019,6,601,601,6,psa_30,6D1
1000000US110010050022002,"Block 2002, Block Group 2, Census Tract 50.02, District of Columbia, District of Columbia",349,279,24,1,23,0,4,18,349,308,251,21,1,23,0,0,12,41,28,3,0,0,0,4,6,110010050022002,3,307,307,3,psa_28,3D3
1000000US110010096011047,"Block 1047, Block Group 1, Census Tract 96.01, District of Columbia, District of Columbia",0,0,0,0,0,0,0,0,0,0,0,0,0,0,0,0,0,0,0,0,0,0,0,0,0,110010096011047,6,601,601,6,psa_30,6D1
1000000US110010058001024,"Block 1024, Block Group 1, Census Tract 58, District of Columbia, District of Columbia",11,10,0,0,0,1,0,0,11,10,9,0,0,0,1,0,0,1,1,0,0,0,0,0,0,110010058001024,1,101,101,1,psa_20,1D1
1000000US110010099022009,"Block 2009, Block Group 2, Census Tract 99.02, District of Columbia, District of Columbia",142,3,138,1,0,0,0,0,142,138,3,135,0,0,0,0,0,4,0,3,1,0,0,0,0,110010099022009,6,605,605,6,psa_11,6D2
1000000US110010070002004,"Block 2004, Block Group 2, Census Tract 70, District of Columbia, District of Columbia",0,0,0,0,0,0,0,0,0,0,0,0,0,0,0,0,0,0,0,0,0,0,0,0,0,110010070002004,1,106,106,1,psa_13,1D3
1000000US110010073011123,"Block 1123, Block Group 1, Census Tract 73.01, District of Columbia, District of Columbia",0,0,0,0,0,0,0,0,0,0,0,0,0,0,0,0,0,0,0,0,0,0,0,0,0,110010073011123,7,708,708,7,psa_1,7D3
1000000US110010087021005,"Block 1005, Block Group 1, Census Tract 87.02, District of Columbia, District of Columbia",274,24,230,1,0,0,10,9,274,262,24,230,1,0,0,0,7,12,0,0,0,0,0,10,2,110010087021005,5,502,502,5,psa_40,5D1
1000000US110010096011001,"Block 1001, Block Group 1, Census Tract 96.01, District of Columbia, District of Columbia",0,0,0,0,0,0,0,0,0,0,0,0,0,0,0,0,0,0,0,0,0,0,0,0,0,110010096011001,5,503,503,5,psa_45,5D2
1000000US110010088031013,"Block 1013, Block Group 1, Census Tract 88.03, District of Columbia, District of Columbia",82,2,71,1,0,0,8,0,82,74,2,71,1,0,0,0,0,8,0,0,0,0,0,8,0,110010088031013,5,506,506,5,psa_26,5D3
1000000US110010020012012,"Block 2012, Block Group 2, Census Tract 20.01, District of Columbia, District of Columbia",103,28,55,0,3,0,13,4,103,89,25,55,0,3,0,3,3,14,3,0,0,0,0,10,1,110010020012012,4,403,403,4,psa_51,4D1
1000000US110010001004039,"Block 4039, Block Group 4, Census Tract 1, District of Columbia, District of Columbia",0,0,0,0,0,0,0,0,0,0,0,0,0,0,0,0,0,0,0,0,0,0,0,0,0,110010001004039,2,206,206,2,psa_29,2D2
1000000US110010018041005,"Block 1005, Block Group 1, Census Tract 18.04, District of Columbia, District of Columbia",116,22,83,0,0,0,5,6,116,88,5,81,0,0,0,0,2,28,17,2,0,0,0,5,4,110010018041005,4,402,402,4,psa_53,4D1
1000000US110010078071014,"Block 1014, Block Group 1, Census Tract 78.07, District of Columbia, District of Columbia",0,0,0,0,0,0,0,0,0,0,0,0,0,0,0,0,0,0,0,0,0,0,0,0,0,110010078071014,6,608,608,6,psa_19,6D1
1000000US110010098011012,"Block 1012, Block Group 1, Census Tract 98.01, District of Columbia, District of Columbia",168,0,163,0,2,0,0,3,168,166,0,163,0,2,0,0,1,2,0,0,0,0,0,0,2,110010098011012,7,706,706,7,psa_2,7D3
1000000US110010089041001,"Block 1001, Block Group 1, Census Tract 89.04, District of Columbia, District of Columbia",311,0,302,2,0,0,4,3,311,306,0,301,2,0,0,0,3,5,0,1,0,0,0,4,0,110010089041001,5,507,507,5,psa_23,5D3
1000000US110010096041010,"Block 1010, Block Group 1, Census Tract 96.04, District of Columbia, District of Columbia",103,6,96,1,0,0,0,0,103,101,4,96,1,0,0,0,0,2,2,0,0,0,0,0,0,110010096041010,6,603,603,6,psa_15,6D3
1000000US110010096032001,"Block 2001, Block Group 2, Census Tract 96.03, District of Columbia, District of Columbia",0,0,0,0,0,0,0,0,0,0,0,0,0,0,0,0,0,0,0,0,0,0,0,0,0,110010096032001,6,603,603,6,psa_15,6D3
1000000US110010019021002,"Block 1002, Block Group 1, Census Tract 19.02, District of Columbia, District of Columbia",71,14,52,0,0,0,0,5,71,69,12,52,0,0,0,0,5,2,2,0,0,0,0,0,0,110010019021002,4,406,406,4,psa_54,4D2
1000000US110010062021232,"Block 1232, Block Group 1, Census Tract 62.02, District of Columbia, District of Columbia",0,0,0,0,0,0,0,0,0,0,0,0,0,0,0,0,0,0,0,0,0,0,0,0,0,110010062021232,2,207,207,2,psa_24,2D3
1000000US110010062021141,"Block 1141, Block Group 1, Census Tract 62.02, District of Columbia, District of Columbia",0,0,0,0,0,0,0,0,0,0,0,0,0,0,0,0,0,0,0,0,0,0,0,0,0,110010062021141,1,103,103,1,psa_12,1D1
1000000US110010106002002,"Block 2002, Block Group 2, Census Tract 106, District of Columbia, District of Columbia",0,0,0,0,0,0,0,0,0,0,0,0,0,0,0,0,0,0,0,0,0,0,0,0,0,110010106002002,5,501,501,5,psa_35,5D1
1000000US110010111001038,"Block 1038, Block Group 1, Census Tract 111, District of Columbia, District of Columbia",0,0,0,0,0,0,0,0,0,0,0,0,0,0,0,0,0,0,0,0,0,0,0,0,0,110010111001038,5,503,503,5,psa_45,5D2
1000000US110010109002043,"Block 2043, Block Group 2, Census Tract 109, District of Columbia, District of Columbia",0,0,0,0,0,0,0,0,0,0,0,0,0,0,0,0,0,0,0,0,0,0,0,0,0,110010109002043,7,708,708,7,psa_1,7D3
1000000US110010040011001,"Block 1001, Block Group 1, Census Tract 40.01, District of Columbia, District of Columbia",323,295,5,0,12,0,0,11,323,300,274,5,0,12,0,0,9,23,21,0,0,0,0,0,2,110010040011001,3,303,303,3,psa_37,3D3
1000000US110010102001002,"Block 1002, Block Group 1, Census Tract 102, District of Columbia, District of Columbia",0,0,0,0,0,0,0,0,0,0,0,0,0,0,0,0,0,0,0,0,0,0,0,0,0,110010102001002,1,103,103,1,psa_12,1D1
1000000US110010004001014,"Block 1014, Block Group 1, Census Tract 4, District of Columbia, District of Columbia",48,42,0,0,6,0,0,0,48,46,40,0,0,6,0,0,0,2,2,0,0,0,0,0,0,110010004001014,2,204,204,2,psa_44,2D2
1000000US110010068022005,"Block 2005, Block Group 2, Census Tract 68.02, District of Columbia, District of Columbia",95,51,41,1,0,0,0,2,95,93,51,40,1,0,0,0,1,2,0,1,0,0,0,0,1,110010068022005,1,107,107,1,psa_16,1D2
1000000US110010062021149,"Block 1149, Block Group 1, Census Tract 62.02, District of Columbia, District of Columbia",0,0,0,0,0,0,0,0,0,0,0,0,0,0,0,0,0,0,0,0,0,0,0,0,0,110010062021149,1,103,103,1,psa_12,1D1
1000000US110010099012021,"Block 2021, Block Group 2, Census Tract 99.01, District of Columbia, District of Columbia",25,0,24,0,0,0,0,1,25,25,0,24,0,0,0,0,1,0,0,0,0,0,0,0,0,110010099012021,6,605,605,6,psa_11,6D2
1000000US110010093014003,"Block 4003, Block Group 4, Census Tract 93.01, District of Columbia, District of Columbia",48,24,20,0,1,0,0,3,48,47,23,20,0,1,0,0,3,1,1,0,0,0,0,0,0,110010093014003,5,504,504,5,psa_43,5D2
1000000US110010014012002,"Block 2002, Block Group 2, Census Tract 14.01, District of Columbia, District of Columbia",14,13,1,0,0,0,0,0,14,14,13,1,0,0,0,0,0,0,0,0,0,0,0,0,0,110010014012002,2,201,201,2,psa_55,2D1
1000000US110010065002013,"Block 2013, Block Group 2, Census Tract 65, District of Columbia, District of Columbia",174,158,13,0,0,0,3,0,174,167,151,13,0,0,0,3,0,7,7,0,0,0,0,0,0,110010065002013,1,106,106,1,psa_13,1D3
1000000US110010035002006,"Block 2006, Block Group 2, Census Tract 35, District of Columbia, District of Columbia",0,0,0,0,0,0,0,0,0,0,0,0,0,0,0,0,0,0,0,0,0,0,0,0,0,110010035002006,3,305,305,3,psa_32,3D2
1000000US110010041002007,"Block 2007, Block Group 2, Census Tract 41, District of Columbia, District of Columbia",0,0,0,0,0,0,0,0,0,0,0,0,0,0,0,0,0,0,0,0,0,0,0,0,0,110010041002007,2,204,204,2,psa_44,2D2
1000000US110010088022010,"Block 2010, Block Group 2, Census Tract 88.02, District of Columbia, District of Columbia",37,3,26,3,1,0,0,4,37,33,3,26,0,1,0,0,3,4,0,0,3,0,0,0,1,110010088022010,5,506,506,5,psa_26,5D3
1000000US110010078082006,"Block 2006, Block Group 2, Census Tract 78.08, District of Columbia, District of Columbia",100,6,91,0,0,0,0,3,100,93,6,87,0,0,0,0,0,7,0,4,0,0,0,0,3,110010078082006,6,608,608,6,psa_19,6D1
1000000US110010111002012,"Block 2012, Block Group 2, Census Tract 111, District of Columbia, District of Columbia",69,1,47,0,0,0,21,0,69,45,1,44,0,0,0,0,0,24,0,3,0,0,0,21,0,110010111002012,5,503,503,5,psa_45,5D2
1000000US110010078043019,"Block 3019, Block Group 3, Census Tract 78.04, District of Columbia, District of Columbia",60,1,59,0,0,0,0,0,60,60,1,59,0,0,0,0,0,0,0,0,0,0,0,0,0,110010078043019,6,608,608,6,psa_19,6D1
1000000US110010016003005,"Block 3005, Block Group 3, Census Tract 16, District of Columbia, District of Columbia",55,14,37,0,0,0,3,1,55,50,14,35,0,0,0,0,1,5,0,2,0,0,0,3,0,110010016003005,4,401,401,4,psa_56,4D1
1000000US110010023011008,"Block 1008, Block Group 1, Census Tract 23.01, District of Columbia, District of Columbia",0,0,0,0,0,0,0,0,0,0,0,0,0,0,0,0,0,0,0,0,0,0,0,0,0,110010023011008,4,407,407,4,psa_47,4D2
1000000US110010010013001,"Block 3001, Block Group 3, Census Tract 10.01, District of Columbia, District of Columbia",71,64,1,0,0,0,0,6,71,67,60,1,0,0,0,0,6,4,4,0,0,0,0,0,0,110010010013001,2,202,202,2,psa_52,2D1
1000000US110010015001013,"Block 1013, Block Group 1, Census Tract 15, District of Columbia, District of Columbia",75,37,27,0,2,0,2,7,75,73,35,27,0,2,0,2,7,2,2,0,0,0,0,0,0,110010015001013,2,201,201,2,psa_55,2D1
1000000US110010039004001,"Block 4001, Block Group 4, Census Tract 39, District of Columbia, District of Columbia",330,233,39,6,12,0,30,10,330,276,214,39,1,12,0,0,10,54,19,0,5,0,0,30,0,110010039004001,3,303,303,3,psa_37,3D3
1000000US110010062021244,"Block 1244, Block Group 1, Census Tract 62.02, District of Columbia, District of Columbia",0,0,0,0,0,0,0,0,0,0,0,0,0,0,0,0,0,0,0,0,0,0,0,0,0,110010062021244,2,207,207,2,psa_24,2D3
1000000US110010078031005,"Block 1005, Block Group 1, Census Tract 78.03, District of Columbia, District of Columbia",0,0,0,0,0,0,0,0,0,0,0,0,0,0,0,0,0,0,0,0,0,0,0,0,0,110010078031005,6,602,602,6,psa_25,6D1
1000000US110010111003029,"Block 3029, Block Group 3, Census Tract 111, District of Columbia, District of Columbia",12,0,12,0,0,0,0,0,12,12,0,12,0,0,0,0,0,0,0,0,0,0,0,0,0,110010111003029,5,503,503,5,psa_45,5D2
1000000US110010012001006,"Block 1006, Block Group 1, Census Tract 12, District of Columbia, District of Columbia",29,26,0,0,3,0,0,0,29,27,24,0,0,3,0,0,0,2,2,0,0,0,0,0,0,110010012001006,2,202,202,2,psa_52,2D1
1000000US110010111001018,"Block 1018, Block Group 1, Census Tract 111, District of Columbia, District of Columbia",0,0,0,0,0,0,0,0,0,0,0,0,0,0,0,0,0,0,0,0,0,0,0,0,0,110010111001018,5,503,503,5,psa_45,5D2
1000000US110010093012014,"Block 2014, Block Group 2, Census Tract 93.01, District of Columbia, District of Columbia",0,0,0,0,0,0,0,0,0,0,0,0,0,0,0,0,0,0,0,0,0,0,0,0,0,110010093012014,5,504,504,5,psa_43,5D2
1000000US110010021011005,"Block 1005, Block Group 1, Census Tract 21.01, District of Columbia, District of Columbia",0,0,0,0,0,0,0,0,0,0,0,0,0,0,0,0,0,0,0,0,0,0,0,0,0,110010021011005,4,403,403,4,psa_51,4D1
1000000US110010073011058,"Block 1058, Block Group 1, Census Tract 73.01, District of Columbia, District of Columbia",0,0,0,0,0,0,0,0,0,0,0,0,0,0,0,0,0,0,0,0,0,0,0,0,0,110010073011058,7,708,708,7,psa_1,7D3
1000000US110010095031002,"Block 1002, Block Group 1, Census Tract 95.03, District of Columbia, District of Columbia",197,0,184,1,1,0,0,11,197,195,0,182,1,1,0,0,11,2,0,2,0,0,0,0,0,110010095031002,4,405,405,4,psa_49,4D2
1000000US110010013011002,"Block 1002, Block Group 1, Census Tract 13.01, District of Columbia, District of Columbia",0,0,0,0,0,0,0,0,0,0,0,0,0,0,0,0,0,0,0,0,0,0,0,0,0,110010013011002,2,203,203,2,psa_50,2D1
1000000US110010048011012,"Block 1012, Block Group 1, Census Tract 48.01, District of Columbia, District of Columbia",93,45,30,0,7,0,4,7,93,86,42,30,0,7,0,0,7,7,3,0,0,0,0,4,0,110010048011012,3,308,308,3,psa_27,3D2
1000000US110010073042001,"Block 2001, Block Group 2, Census Tract 73.04, District of Columbia, District of Columbia",31,0,30,0,0,0,0,1,31,31,0,30,0,0,0,0,1,0,0,0,0,0,0,0,0,110010073042001,7,705,705,7,psa_3,7D2
1000000US110010084101018,"Block 1018, Block Group 1, Census Tract 84.10, District of Columbia, District of Columbia",92,43,46,0,0,2,0,1,92,90,42,46,0,0,2,0,0,2,1,0,0,0,0,0,1,110010084101018,1,104,104,1,psa_21,1D2
1000000US110010095013004,"Block 3004, Block Group 3, Census Tract 95.01, District of Columbia, District of Columbia",65,3,46,0,0,0,12,4,65,50,1,45,0,0,0,0,4,15,2,1,0,0,0,12,0,110010095013004,4,405,405,4,psa_49,4D2
1000000US110010077091004,"Block 1004, Block Group 1, Census Tract 77.09, District of Columbia, District of Columbia",31,0,25,0,0,0,6,0,31,25,0,25,0,0,0,0,0,6,0,0,0,0,0,6,0,110010077091004,6,605,605,6,psa_11,6D2
1000000US110010077092000,"Block 2000, Block Group 2, Census Tract 77.09, District of Columbia, District of Columbia",0,0,0,0,0,0,0,0,0,0,0,0,0,0,0,0,0,0,0,0,0,0,0,0,0,110010077092000,6,605,605,6,psa_11,6D2
1000000US110010041003028,"Block 3028, Block Group 3, Census Tract 41, District of Columbia, District of Columbia",132,113,4,0,3,0,8,4,132,125,113,4,0,3,0,2,3,7,0,0,0,0,0,6,1,110010041003028,2,208,208,2,psa_33,2D3
1000000US110010021021014,"Block 1014, Block Group 1, Census Tract 21.02, District of Columbia, District of Columbia",38,1,35,0,0,0,0,2,38,37,1,34,0,0,0,0,2,1,0,1,0,0,0,0,0,110010021021014,4,402,402,4,psa_53,4D1
1000000US110010111003039,"Block 3039, Block Group 3, Census Tract 111, District of Columbia, District of Columbia",17,0,14,0,0,0,0,3,17,17,0,14,0,0,0,0,3,0,0,0,0,0,0,0,0,110010111003039,5,503,503,5,psa_45,5D2
1000000US110010010014028,"Block 4028, Block Group 4, Census Tract 10.01, District of Columbia, District of Columbia",0,0,0,0,0,0,0,0,0,0,0,0,0,0,0,0,0,0,0,0,0,0,0,0,0,110010010014028,2,202,202,2,psa_52,2D1
1000000US110010078062006,"Block 2006, Block Group 2, Census Tract 78.06, District of Columbia, District of Columbia",21,0,21,0,0,0,0,0,21,21,0,21,0,0,0,0,0,0,0,0,0,0,0,0,0,110010078062006,6,602,602,6,psa_25,6D1
1000000US110010103003008,"Block 3008, Block Group 3, Census Tract 103, District of Columbia, District of Columbia",30,7,23,0,0,0,0,0,30,30,7,23,0,0,0,0,0,0,0,0,0,0,0,0,0,110010103003008,4,401,401,4,psa_56,4D1
1000000US110010064002000,"Block 2000, Block Group 2, Census Tract 64, District of Columbia, District of Columbia",66,14,51,0,0,0,0,1,66,65,14,50,0,0,0,0,1,1,0,1,0,0,0,0,0,110010064002000,1,105,105,1,psa_22,1D3
1000000US110010015002003,"Block 2003, Block Group 2, Census Tract 15, District of Columbia, District of Columbia",71,68,0,0,1,0,1,1,71,68,65,0,0,1,0,1,1,3,3,0,0,0,0,0,0,110010015002003,2,201,201,2,psa_55,2D1
1000000US110010074011008,"Block 1008, Block Group 1, Census Tract 74.01, District of Columbia, District of Columbia",0,0,0,0,0,0,0,0,0,0,0,0,0,0,0,0,0,0,0,0,0,0,0,0,0,110010074011008,7,701,701,7,psa_9,7D1
1000000US110010014011002,"Block 1002, Block Group 1, Census Tract 14.01, District of Columbia, District of Columbia",97,88,3,1,5,0,0,0,97,92,83,3,1,5,0,0,0,5,5,0,0,0,0,0,0,110010014011002,2,201,201,2,psa_55,2D1
1000000US110010074071000,"Block 1000, Block Group 1, Census Tract 74.07, District of Columbia, District of Columbia",0,0,0,0,0,0,0,0,0,0,0,0,0,0,0,0,0,0,0,0,0,0,0,0,0,110010074071000,7,702,702,7,psa_6,7D1
1000000US110010009013007,"Block 3007, Block Group 3, Census Tract 9.01, District of Columbia, District of Columbia",54,49,0,0,0,0,0,5,54,52,48,0,0,0,0,0,4,2,1,0,0,0,0,0,1,110010009013007,2,205,205,2,psa_46,2D2
1000000US110010076053004,"Block 3004, Block Group 3, Census Tract 76.05, District of Columbia, District of Columbia",125,2,116,1,1,0,0,5,125,125,2,116,1,1,0,0,5,0,0,0,0,0,0,0,0,110010076053004,6,607,607,6,psa_10,6D2
1000000US110010078082003,"Block 2003, Block Group 2, Census Tract 78.08, District of Columbia, District of Columbia",28,0,28,0,0,0,0,0,28,28,0,28,0,0,0,0,0,0,0,0,0,0,0,0,0,110010078082003,6,608,608,6,psa_19,6D1
1000000US110010095081012,"Block 1012, Block Group 1, Census Tract 95.08, District of Columbia, District of Columbia",5,0,5,0,0,0,0,0,5,5,0,5,0,0,0,0,0,0,0,0,0,0,0,0,0,110010095081012,4,405,405,4,psa_49,4D2
1000000US110010101001009,"Block 1009, Block Group 1, Census Tract 101, District of Columbia, District of Columbia",0,0,0,0,0,0,0,0,0,0,0,0,0,0,0,0,0,0,0,0,0,0,0,0,0,110010101001009,2,209,209,2,psa_57,2D3
1000000US110010098011014,"Block 1014, Block Group 1, Census Tract 98.01, District of Columbia, District of Columbia",206,0,202,0,0,0,2,2,206,196,0,196,0,0,0,0,0,10,0,6,0,0,0,2,2,110010098011014,7,708,708,7,psa_1,7D3
1000000US110010094001001,"Block 1001, Block Group 1, Census Tract 94, District of Columbia, District of Columbia",0,0,0,0,0,0,0,0,0,0,0,0,0,0,0,0,0,0,0,0,0,0,0,0,0,110010094001001,5,503,503,5,psa_45,5D2
1000000US110010096011033,"Block 1033, Block Group 1, Census Tract 96.01, District of Columbia, District of Columbia",16,1,15,0,0,0,0,0,16,16,1,15,0,0,0,0,0,0,0,0,0,0,0,0,0,110010096011033,6,601,601,6,psa_30,6D1
1000000US110010099012020,"Block 2020, Block Group 2, Census Tract 99.01, District of Columbia, District of Columbia",61,8,51,0,0,0,0,2,61,59,6,51,0,0,0,0,2,2,2,0,0,0,0,0,0,110010099012020,6,605,605,6,psa_11,6D2
1000000US110010111003001,"Block 3001, Block Group 3, Census Tract 111, District of Columbia, District of Columbia",39,0,36,0,0,0,1,2,39,36,0,36,0,0,0,0,0,3,0,0,0,0,0,1,2,110010111003001,5,503,503,5,psa_45,5D2
1000000US110010024002017,"Block 2017, Block Group 2, Census Tract 24, District of Columbia, District of Columbia",42,1,31,0,0,0,9,1,42,26,1,24,0,0,0,0,1,16,0,7,0,0,0,9,0,110010024002017,4,407,407,4,psa_47,4D2
1000000US110010094002004,"Block 2004, Block Group 2, Census Tract 94, District of Columbia, District of Columbia",46,5,41,0,0,0,0,0,46,46,5,41,0,0,0,0,0,0,0,0,0,0,0,0,0,110010094002004,5,503,503,5,psa_45,5D2
1000000US110010048022003,"Block 2003, Block Group 2, Census Tract 48.02, District of Columbia, District of Columbia",130,46,75,1,5,0,0,3,130,122,41,73,1,5,0,0,2,8,5,2,0,0,0,0,1,110010048022003,3,308,308,3,psa_27,3D2
1000000US110010064001003,"Block 1003, Block Group 1, Census Tract 64, District of Columbia, District of Columbia",77,0,72,1,1,0,0,3,77,70,0,65,1,1,0,0,3,7,0,7,0,0,0,0,0,110010064001003,1,105,105,1,psa_22,1D3
1000000US110010062021192,"Block 1192, Block Group 1, Census Tract 62.02, District of Columbia, District of Columbia",0,0,0,0,0,0,0,0,0,0,0,0,0,0,0,0,0,0,0,0,0,0,0,0,0,110010062021192,1,103,103,1,psa_12,1D1
1000000US110010062021056,"Block 1056, Block Group 1, Census Tract 62.02, District of Columbia, District of Columbia",0,0,0,0,0,0,0,0,0,0,0,0,0,0,0,0,0,0,0,0,0,0,0,0,0,110010062021056,2,207,207,2,psa_24,2D3
1000000US110010078062003,"Block 2003, Block Group 2, Census Tract 78.06, District of Columbia, District of Columbia",33,0,33,0,0,0,0,0,33,33,0,33,0,0,0,0,0,0,0,0,0,0,0,0,0,110010078062003,6,602,602,6,psa_25,6D1
1000000US110010012004026,"Block 4026, Block Group 4, Census Tract 12, District of Columbia, District of Columbia",228,154,8,5,30,0,13,18,228,170,120,8,0,30,0,1,11,58,34,0,5,0,0,12,7,110010012004026,2,202,202,2,psa_52,2D1
1000000US110010075031004,"Block 1004, Block Group 1, Census Tract 75.03, District of Columbia, District of Columbia",0,0,0,0,0,0,0,0,0,0,0,0,0,0,0,0,0,0,0,0,0,0,0,0,0,110010075031004,7,701,701,7,psa_9,7D1
1000000US110010005011008,"Block 1008, Block Group 1, Census Tract 5.01, District of Columbia, District of Columbia",0,0,0,0,0,0,0,0,0,0,0,0,0,0,0,0,0,0,0,0,0,0,0,0,0,110010005011008,2,204,204,2,psa_44,2D2
1000000US110010019014004,"Block 4004, Block Group 4, Census Tract 19.01, District of Columbia, District of Columbia",68,18,41,0,0,1,8,0,68,60,18,41,0,0,1,0,0,8,0,0,0,0,0,8,0,110010019014004,4,402,402,4,psa_53,4D1
1000000US110010062021196,"Block 1196, Block Group 1, Census Tract 62.02, District of Columbia, District of Columbia",0,0,0,0,0,0,0,0,0,0,0,0,0,0,0,0,0,0,0,0,0,0,0,0,0,110010062021196,1,103,103,1,psa_12,1D1
1000000US110010056003001,"Block 3001, Block Group 3, Census Tract 56, District of Columbia, District of Columbia",260,73,164,2,5,0,9,7,260,217,50,156,2,5,0,0,4,43,23,8,0,0,0,9,3,110010056003001,2,207,207,2,psa_24,2D3
1000000US110010098031002,"Block 1002, Block Group 1, Census Tract 98.03, District of Columbia, District of Columbia",46,0,46,0,0,0,0,0,46,46,0,46,0,0,0,0,0,0,0,0,0,0,0,0,0,110010098031002,7,707,707,7,psa_4,7D2
1000000US110010055001012,"Block 1012, Block Group 1, Census Tract 55, District of Columbia, District of Columbia",0,0,0,0,0,0,0,0,0,0,0,0,0,0,0,0,0,0,0,0,0,0,0,0,0,110010055001012,2,208,208,2,psa_33,2D3
1000000US110010068041020,"Block 1020, Block Group 1, Census Tract 68.04, District of Columbia, District of Columbia",0,0,0,0,0,0,0,0,0,0,0,0,0,0,0,0,0,0,0,0,0,0,0,0,0,110010068041020,5,507,507,5,psa_23,5D3
1000000US110010072002000,"Block 2000, Block Group 2, Census Tract 72, District of Columbia, District of Columbia",0,0,0,0,0,0,0,0,0,0,0,0,0,0,0,0,0,0,0,0,0,0,0,0,0,110010072002000,1,106,106,1,psa_13,1D3
1000000US110010082002016,"Block 2016, Block Group 2, Census Tract 82, District of Columbia, District of Columbia",43,42,0,0,0,0,0,1,43,43,42,0,0,0,0,0,1,0,0,0,0,0,0,0,0,110010082002016,1,108,108,1,psa_17,1D2
1000000US110010009022022,"Block 2022, Block Group 2, Census Tract 9.02, District of Columbia, District of Columbia",38,38,0,0,0,0,0,0,38,37,37,0,0,0,0,0,0,1,1,0,0,0,0,0,0,110010009022022,2,205,205,2,psa_46,2D2
1000000US110010012002000,"Block 2000, Block Group 2, Census Tract 12, District of Columbia, District of Columbia",318,238,44,1,29,0,1,5,318,307,229,44,0,29,0,0,5,11,9,0,1,0,0,1,0,110010012002000,2,203,203,2,psa_50,2D1
1000000US110010080022020,"Block 2020, Block Group 2, Census Tract 80.02, District of Columbia, District of Columbia",0,0,0,0,0,0,0,0,0,0,0,0,0,0,0,0,0,0,0,0,0,0,0,0,0,110010080022020,1,108,108,1,psa_17,1D2
1000000US110010027023020,"Block 3020, Block Group 3, Census Tract 27.02, District of Columbia, District of Columbia",0,0,0,0,0,0,0,0,0,0,0,0,0,0,0,0,0,0,0,0,0,0,0,0,0,110010027023020,2,204,204,2,psa_44,2D2
1000000US110010077091016,"Block 1016, Block Group 1, Census Tract 77.09, District of Columbia, District of Columbia",0,0,0,0,0,0,0,0,0,0,0,0,0,0,0,0,0,0,0,0,0,0,0,0,0,110010077091016,6,605,605,6,psa_11,6D2
1000000US110010093013007,"Block 3007, Block Group 3, Census Tract 93.01, District of Columbia, District of Columbia",56,15,35,0,0,0,0,6,56,55,14,35,0,0,0,0,6,1,1,0,0,0,0,0,0,110010093013007,5,504,504,5,psa_43,5D2
1000000US110010107001012,"Block 1012, Block Group 1, Census Tract 107, District of Columbia, District of Columbia",0,0,0,0,0,0,0,0,0,0,0,0,0,0,0,0,0,0,0,0,0,0,0,0,0,110010107001012,2,207,207,2,psa_24,2D3
1000000US110010104001023,"Block 1023, Block Group 1, Census Tract 104, District of Columbia, District of Columbia",53,0,52,0,0,0,0,1,53,53,0,52,0,0,0,0,1,0,0,0,0,0,0,0,0,110010104001023,7,707,707,7,psa_4,7D2
1000000US110010062021075,"Block 1075, Block Group 1, Census Tract 62.02, District of Columbia, District of Columbia",0,0,0,0,0,0,0,0,0,0,0,0,0,0,0,0,0,0,0,0,0,0,0,0,0,110010062021075,2,207,207,2,psa_24,2D3
1000000US110010072002027,"Block 2027, Block Group 2, Census Tract 72, District of Columbia, District of Columbia",0,0,0,0,0,0,0,0,0,0,0,0,0,0,0,0,0,0,0,0,0,0,0,0,0,110010072002027,1,106,106,1,psa_13,1D3
1000000US110010009013010,"Block 3010, Block Group 3, Census Tract 9.01, District of Columbia, District of Columbia",0,0,0,0,0,0,0,0,0,0,0,0,0,0,0,0,0,0,0,0,0,0,0,0,0,110010009013010,2,205,205,2,psa_46,2D2
1000000US110010046002020,"Block 2020, Block Group 2, Census Tract 46, District of Columbia, District of Columbia",0,0,0,0,0,0,0,0,0,0,0,0,0,0,0,0,0,0,0,0,0,0,0,0,0,110010046002020,3,308,308,3,psa_27,3D2
1000000US110010083011001,"Block 1001, Block Group 1, Census Tract 83.01, District of Columbia, District of Columbia",90,59,19,0,4,0,2,6,90,87,58,19,0,4,0,0,6,3,1,0,0,0,0,2,0,110010083011001,1,104,104,1,psa_21,1D2
1000000US110010107001009,"Block 1009, Block Group 1, Census Tract 107, District of Columbia, District of Columbia",0,0,0,0,0,0,0,0,0,0,0,0,0,0,0,0,0,0,0,0,0,0,0,0,0,110010107001009,2,207,207,2,psa_24,2D3
1000000US110010027023008,"Block 3008, Block Group 3, Census Tract 27.02, District of Columbia, District of Columbia",259,211,25,0,9,0,3,11,259,219,182,20,0,9,0,0,8,40,29,5,0,0,0,3,3,110010027023008,3,302,302,3,psa_42,3D1
1000000US110010062021171,"Block 1171, Block Group 1, Census Tract 62.02, District of Columbia, District of Columbia",0,0,0,0,0,0,0,0,0,0,0,0,0,0,0,0,0,0,0,0,0,0,0,0,0,110010062021171,2,207,207,2,psa_24,2D3
1000000US110010002024022,"Block 4022, Block Group 4, Census Tract 2.02, District of Columbia, District of Columbia",0,0,0,0,0,0,0,0,0,0,0,0,0,0,0,0,0,0,0,0,0,0,0,0,0,110010002024022,2,206,206,2,psa_29,2D2
1000000US110010062021195,"Block 1195, Block Group 1, Census Tract 62.02, District of Columbia, District of Columbia",0,0,0,0,0,0,0,0,0,0,0,0,0,0,0,0,0,0,0,0,0,0,0,0,0,110010062021195,1,103,103,1,psa_12,1D1
1000000US110010111002001,"Block 2001, Block Group 2, Census Tract 111, District of Columbia, District of Columbia",109,3,103,0,0,0,0,3,109,109,3,103,0,0,0,0,3,0,0,0,0,0,0,0,0,110010111002001,5,503,503,5,psa_45,5D2
1000000US110010014012000,"Block 2000, Block Group 2, Census Tract 14.01, District of Columbia, District of Columbia",38,37,0,0,0,0,0,1,38,37,37,0,0,0,0,0,0,1,0,0,0,0,0,0,1,110010014012000,2,201,201,2,psa_55,2D1
1000000US110010064001005,"Block 1005, Block Group 1, Census Tract 64, District of Columbia, District of Columbia",0,0,0,0,0,0,0,0,0,0,0,0,0,0,0,0,0,0,0,0,0,0,0,0,0,110010064001005,1,105,105,1,psa_22,1D3
1000000US110010011002021,"Block 2021, Block Group 2, Census Tract 11, District of Columbia, District of Columbia",57,46,4,0,6,0,1,0,57,51,40,4,0,6,0,1,0,6,6,0,0,0,0,0,0,110010011002021,2,202,202,2,psa_52,2D1
1000000US110010007021004,"Block 1004, Block Group 1, Census Tract 7.02, District of Columbia, District of Columbia",0,0,0,0,0,0,0,0,0,0,0,0,0,0,0,0,0,0,0,0,0,0,0,0,0,110010007021004,2,204,204,2,psa_44,2D2
1000000US110010025022001,"Block 2001, Block Group 2, Census Tract 25.02, District of Columbia, District of Columbia",139,24,65,0,3,0,43,4,139,82,20,58,0,3,0,0,1,57,4,7,0,0,0,43,3,110010025022001,4,404,404,4,psa_48,4D3
1000000US110010096021006,"Block 1006, Block Group 1, Census Tract 96.02, District of Columbia, District of Columbia",0,0,0,0,0,0,0,0,0,0,0,0,0,0,0,0,0,0,0,0,0,0,0,0,0,110010096021006,6,601,601,6,psa_30,6D1
1000000US110010076033001,"Block 3001, Block Group 3, Census Tract 76.03, District of Columbia, District of Columbia",79,1,78,0,0,0,0,0,79,78,1,77,0,0,0,0,0,1,0,1,0,0,0,0,0,110010076033001,6,606,606,6,psa_7,6D2
1000000US110010039002005,"Block 2005, Block Group 2, Census Tract 39, District of Columbia, District of Columbia",0,0,0,0,0,0,0,0,0,0,0,0,0,0,0,0,0,0,0,0,0,0,0,0,0,110010039002005,2,204,204,2,psa_44,2D2
1000000US110010014012004,"Block 2004, Block Group 2, Census Tract 14.01, District of Columbia, District of Columbia",51,43,6,0,0,0,0,2,51,50,42,6,0,0,0,0,2,1,1,0,0,0,0,0,0,110010014012004,2,201,201,2,psa_55,2D1
1000000US110010019011002,"Block 1002, Block Group 1, Census Tract 19.01, District of Columbia, District of Columbia",31,2,29,0,0,0,0,0,31,31,2,29,0,0,0,0,0,0,0,0,0,0,0,0,0,110010019011002,4,402,402,4,psa_53,4D1
1000000US110010062021240,"Block 1240, Block Group 1, Census Tract 62.02, District of Columbia, District of Columbia",0,0,0,0,0,0,0,0,0,0,0,0,0,0,0,0,0,0,0,0,0,0,0,0,0,110010062021240,2,207,207,2,psa_24,2D3
1000000US110010012004013,"Block 4013, Block Group 4, Census Tract 12, District of Columbia, District of Columbia",89,78,4,0,3,0,0,4,89,86,75,4,0,3,0,0,4,3,3,0,0,0,0,0,0,110010012004013,2,202,202,2,psa_52,2D1
1000000US110010073011046,"Block 1046, Block Group 1, Census Tract 73.01, District of Columbia, District of Columbia",0,0,0,0,0,0,0,0,0,0,0,0,0,0,0,0,0,0,0,0,0,0,0,0,0,110010073011046,7,708,708,7,psa_1,7D3
1000000US110010106001007,"Block 1007, Block Group 1, Census Tract 106, District of Columbia, District of Columbia",38,20,13,0,4,0,0,1,38,36,18,13,0,4,0,0,1,2,2,0,0,0,0,0,0,110010106001007,5,501,501,5,psa_35,5D1
1000000US110010078071002,"Block 1002, Block Group 1, Census Tract 78.07, District of Columbia, District of Columbia",60,0,58,0,2,0,0,0,60,59,0,57,0,2,0,0,0,1,0,1,0,0,0,0,0,110010078071002,6,608,608,6,psa_19,6D1
1000000US110010016001010,"Block 1010, Block Group 1, Census Tract 16, District of Columbia, District of Columbia",61,6,45,0,3,0,0,7,61,61,6,45,0,3,0,0,7,0,0,0,0,0,0,0,0,110010016001010,4,401,401,4,psa_56,4D1
1000000US110010070001000,"Block 1000, Block Group 1, Census Tract 70, District of Columbia, District of Columbia",181,155,11,0,6,0,4,5,181,167,148,11,0,6,0,1,1,14,7,0,0,0,0,3,4,110010070001000,1,107,107,1,psa_16,1D2
1000000US110010070001014,"Block 1014, Block Group 1, Census Tract 70, District of Columbia, District of Columbia",0,0,0,0,0,0,0,0,0,0,0,0,0,0,0,0,0,0,0,0,0,0,0,0,0,110010070001014,1,106,106,1,psa_13,1D3
1000000US110010062021253,"Block 1253, Block Group 1, Census Tract 62.02, District of Columbia, District of Columbia",0,0,0,0,0,0,0,0,0,0,0,0,0,0,0,0,0,0,0,0,0,0,0,0,0,110010062021253,2,209,209,2,psa_57,2D3
1000000US110010095081011,"Block 1011, Block Group 1, Census Tract 95.08, District of Columbia, District of Columbia",92,24,63,0,3,0,0,2,92,91,24,62,0,3,0,0,2,1,0,1,0,0,0,0,0,110010095081011,4,406,406,4,psa_54,4D2
1000000US110010022022006,"Block 2006, Block Group 2, Census Tract 22.02, District of Columbia, District of Columbia",206,18,171,0,3,0,8,6,206,188,9,169,0,3,0,1,6,18,9,2,0,0,0,7,0,110010022022006,4,407,407,4,psa_47,4D2
1000000US110010052012004,"Block 2004, Block Group 2, Census Tract 52.01, District of Columbia, District of Columbia",92,76,2,0,10,0,2,2,92,87,73,2,0,10,0,0,2,5,3,0,0,0,0,2,0,110010052012004,2,208,208,2,psa_33,2D3
1000000US110010012001008,"Block 1008, Block Group 1, Census Tract 12, District of Columbia, District of Columbia",57,52,0,1,3,0,0,1,57,57,52,0,1,3,0,0,1,0,0,0,0,0,0,0,0,110010012001008,2,202,202,2,psa_52,2D1
1000000US110010074041002,"Block 1002, Block Group 1, Census Tract 74.04, District of Columbia, District of Columbia",8,0,8,0,0,0,0,0,8,8,0,8,0,0,0,0,0,0,0,0,0,0,0,0,0,110010074041002,7,704,704,7,psa_5,7D2
1000000US110010024004008,"Block 4008, Block Group 4, Census Tract 24, District of Columbia, District of Columbia",124,14,107,0,0,0,2,1,124,117,14,103,0,0,0,0,0,7,0,4,0,0,0,2,1,110010024004008,4,407,407,4,psa_47,4D2
1000000US110010081001001,"Block 1001, Block Group 1, Census Tract 81, District of Columbia, District of Columbia",52,16,33,0,0,0,0,3,52,52,16,33,0,0,0,0,3,0,0,0,0,0,0,0,0,110010081001001,1,104,104,1,psa_21,1D2
1000000US110010110004000,"Block 4000, Block Group 4, Census Tract 110, District of Columbia, District of Columbia",303,127,136,3,17,0,5,15,303,287,121,133,3,17,0,1,12,16,6,3,0,0,0,4,3,110010110004000,1,105,105,1,psa_22,1D3
1000000US110010087012011,"Block 2011, Block Group 2, Census Tract 87.01, District of Columbia, District of Columbia",106,13,90,0,0,0,2,1,106,105,12,90,0,0,0,2,1,1,1,0,0,0,0,0,0,110010087012011,5,502,502,5,psa_40,5D1
1000000US110010018032004,"Block 2004, Block Group 2, Census Tract 18.03, District of Columbia, District of Columbia",157,3,142,0,4,0,8,0,157,148,2,142,0,4,0,0,0,9,1,0,0,0,0,8,0,110010018032004,4,402,402,4,psa_53,4D1
1000000US110010065002005,"Block 2005, Block Group 2, Census Tract 65, District of Columbia, District of Columbia",0,0,0,0,0,0,0,0,0,0,0,0,0,0,0,0,0,0,0,0,0,0,0,0,0,110010065002005,1,106,106,1,psa_13,1D3
1000000US110010027011001,"Block 1001, Block Group 1, Census Tract 27.01, District of Columbia, District of Columbia",77,29,21,0,12,0,11,4,77,56,22,19,0,12,0,0,3,21,7,2,0,0,0,11,1,110010027011001,3,302,302,3,psa_42,3D1
1000000US110010056002022,"Block 2022, Block Group 2, Census Tract 56, District of Columbia, District of Columbia",0,0,0,0,0,0,0,0,0,0,0,0,0,0,0,0,0,0,0,0,0,0,0,0,0,110010056002022,2,207,207,2,psa_24,2D3
1000000US110010094002007,"Block 2007, Block Group 2, Census Tract 94, District of Columbia, District of Columbia",56,8,48,0,0,0,0,0,56,51,3,48,0,0,0,0,0,5,5,0,0,0,0,0,0,110010094002007,5,503,503,5,psa_45,5D2
1000000US110010006001000,"Block 1000, Block Group 1, Census Tract 6, District of Columbia, District of Columbia",312,281,8,0,22,0,0,1,312,309,278,8,0,22,0,0,1,3,3,0,0,0,0,0,0,110010006001000,2,203,203,2,psa_50,2D1
1000000US110010099031003,"Block 1003, Block Group 1, Census Tract 99.03, District of Columbia, District of Columbia",183,0,178,0,2,0,0,3,183,182,0,177,0,2,0,0,3,1,0,1,0,0,0,0,0,110010099031003,6,604,604,6,psa_14,6D3
1000000US110010002024000,"Block 4000, Block Group 4, Census Tract 2.02, District of Columbia, District of Columbia",163,156,0,0,5,0,0,2,163,158,151,0,0,5,0,0,2,5,5,0,0,0,0,0,0,110010002024000,2,206,206,2,psa_29,2D2
1000000US110010008022019,"Block 2019, Block Group 2, Census Tract 8.02, District of Columbia, District of Columbia",59,56,0,0,1,0,1,1,59,56,54,0,0,1,0,0,1,3,2,0,0,0,0,1,0,110010008022019,2,205,205,2,psa_46,2D2
1000000US110010031001010,"Block 1010, Block Group 1, Census Tract 31, District of Columbia, District of Columbia",233,124,55,0,5,0,38,11,233,140,80,53,0,5,0,0,2,93,44,2,0,0,0,38,9,110010031001010,3,302,302,3,psa_42,3D1
1000000US110010088022009,"Block 2009, Block Group 2, Census Tract 88.02, District of Columbia, District of Columbia",32,0,32,0,0,0,0,0,32,32,0,32,0,0,0,0,0,0,0,0,0,0,0,0,0,110010088022009,5,506,506,5,psa_26,5D3
1000000US110010001004016,"Block 4016, Block Group 4, Census Tract 1, District of Columbia, District of Columbia",0,0,0,0,0,0,0,0,0,0,0,0,0,0,0,0,0,0,0,0,0,0,0,0,0,110010001004016,2,206,206,2,psa_29,2D2
1000000US110010012001005,"Block 1005, Block Group 1, Census Tract 12, District of Columbia, District of Columbia",28,24,0,0,4,0,0,0,28,25,21,0,0,4,0,0,0,3,3,0,0,0,0,0,0,110010012001005,2,203,203,2,psa_50,2D1
1000000US110010084022009,"Block 2009, Block Group 2, Census Tract 84.02, District of Columbia, District of Columbia",17,14,0,0,3,0,0,0,17,17,14,0,0,3,0,0,0,0,0,0,0,0,0,0,0,110010084022009,1,108,108,1,psa_17,1D2
1000000US110010007021001,"Block 1001, Block Group 1, Census Tract 7.02, District of Columbia, District of Columbia",0,0,0,0,0,0,0,0,0,0,0,0,0,0,0,0,0,0,0,0,0,0,0,0,0,110010007021001,2,204,204,2,psa_44,2D2
1000000US110010071001004,"Block 1004, Block Group 1, Census Tract 71, District of Columbia, District of Columbia",0,0,0,0,0,0,0,0,0,0,0,0,0,0,0,0,0,0,0,0,0,0,0,0,0,110010071001004,1,106,106,1,psa_13,1D3
1000000US110010012004018,"Block 4018, Block Group 4, Census Tract 12, District of Columbia, District of Columbia",16,12,4,0,0,0,0,0,16,14,10,4,0,0,0,0,0,2,2,0,0,0,0,0,0,110010012004018,2,202,202,2,psa_52,2D1
1000000US110010010015016,"Block 5016, Block Group 5, Census Tract 10.01, District of Columbia, District of Columbia",18,18,0,0,0,0,0,0,18,18,18,0,0,0,0,0,0,0,0,0,0,0,0,0,0,110010010015016,2,202,202,2,psa_52,2D1
1000000US110010077033003,"Block 3003, Block Group 3, Census Tract 77.03, District of Columbia, District of Columbia",650,3,624,2,0,1,0,20,650,643,3,619,2,0,1,0,18,7,0,5,0,0,0,0,2,110010077033003,6,603,603,6,psa_15,6D3
1000000US110010087011007,"Block 1007, Block Group 1, Census Tract 87.01, District of Columbia, District of Columbia",171,43,117,1,4,0,2,4,171,166,42,117,1,4,0,0,2,5,1,0,0,0,0,2,2,110010087011007,5,502,502,5,psa_40,5D1
1000000US110010099051002,"Block 1002, Block Group 1, Census Tract 99.05, District of Columbia, District of Columbia",99,1,98,0,0,0,0,0,99,99,1,98,0,0,0,0,0,0,0,0,0,0,0,0,0,110010099051002,6,604,604,6,psa_14,6D3
1000000US110010106002023,"Block 2023, Block Group 2, Census Tract 106, District of Columbia, District of Columbia",0,0,0,0,0,0,0,0,0,0,0,0,0,0,0,0,0,0,0,0,0,0,0,0,0,110010106002023,5,501,501,5,psa_35,5D1
1000000US110010023012002,"Block 2002, Block Group 2, Census Tract 23.01, District of Columbia, District of Columbia",117,4,105,0,0,0,6,2,117,111,4,105,0,0,0,0,2,6,0,0,0,0,0,6,0,110010023012002,4,407,407,4,psa_47,4D2
1000000US110010058001035,"Block 1035, Block Group 1, Census Tract 58, District of Columbia, District of Columbia",0,0,0,0,0,0,0,0,0,0,0,0,0,0,0,0,0,0,0,0,0,0,0,0,0,110010058001035,2,209,209,2,psa_57,2D3
1000000US110010077082014,"Block 2014, Block Group 2, Census Tract 77.08, District of Columbia, District of Columbia",100,0,99,0,0,0,0,1,100,100,0,99,0,0,0,0,1,0,0,0,0,0,0,0,0,110010077082014,6,603,603,6,psa_15,6D3
1000000US110010046002001,"Block 2001, Block Group 2, Census Tract 46, District of Columbia, District of Columbia",105,47,47,0,4,0,2,5,105,76,27,41,0,4,0,0,4,29,20,6,0,0,0,2,1,110010046002001,3,308,308,3,psa_27,3D2
1000000US110010019022007,"Block 2007, Block Group 2, Census Tract 19.02, District of Columbia, District of Columbia",65,6,55,0,0,0,2,2,65,63,6,55,0,0,0,0,2,2,0,0,0,0,0,2,0,110010019022007,4,406,406,4,psa_54,4D2
1000000US110010026001009,"Block 1009, Block Group 1, Census Tract 26, District of Columbia, District of Columbia",0,0,0,0,0,0,0,0,0,0,0,0,0,0,0,0,0,0,0,0,0,0,0,0,0,110010026001009,4,404,404,4,psa_48,4D3
1000000US110010083012004,"Block 2004, Block Group 2, Census Tract 83.01, District of Columbia, District of Columbia",139,134,0,0,2,0,1,2,139,131,127,0,0,2,0,0,2,8,7,0,0,0,0,1,0,110010083012004,1,108,108,1,psa_17,1D2
1000000US110010020023006,"Block 3006, Block Group 3, Census Tract 20.02, District of Columbia, District of Columbia",123,34,80,0,1,0,0,8,123,120,33,79,0,1,0,0,7,3,1,1,0,0,0,0,1,110010020023006,4,403,403,4,psa_51,4D1
1000000US110010075031011,"Block 1011, Block Group 1, Census Tract 75.03, District of Columbia, District of Columbia",96,0,96,0,0,0,0,0,96,96,0,96,0,0,0,0,0,0,0,0,0,0,0,0,0,110010075031011,7,701,701,7,psa_9,7D1
1000000US110010010014022,"Block 4022, Block Group 4, Census Tract 10.01, District of Columbia, District of Columbia",81,66,3,0,6,0,0,6,81,75,60,3,0,6,0,0,6,6,6,0,0,0,0,0,0,110010010014022,2,202,202,2,psa_52,2D1
1000000US110010019014005,"Block 4005, Block Group 4, Census Tract 19.01, District of Columbia, District of Columbia",0,0,0,0,0,0,0,0,0,0,0,0,0,0,0,0,0,0,0,0,0,0,0,0,0,110010019014005,4,402,402,4,psa_53,4D1
1000000US110010049012008,"Block 2008, Block Group 2, Census Tract 49.01, District of Columbia, District of Columbia",0,0,0,0,0,0,0,0,0,0,0,0,0,0,0,0,0,0,0,0,0,0,0,0,0,110010049012008,3,307,307,3,psa_28,3D3
1000000US110010088024001,"Block 4001, Block Group 4, Census Tract 88.02, District of Columbia, District of Columbia",168,7,145,2,4,0,0,10,168,147,3,138,1,4,0,0,1,21,4,7,1,0,0,0,9,110010088024001,5,506,506,5,psa_26,5D3
1000000US110010014011006,"Block 1006, Block Group 1, Census Tract 14.01, District of Columbia, District of Columbia",15,15,0,0,0,0,0,0,15,11,11,0,0,0,0,0,0,4,4,0,0,0,0,0,0,110010014011006,2,201,201,2,psa_55,2D1
1000000US110010001001005,"Block 1005, Block Group 1, Census Tract 1, District of Columbia, District of Columbia",31,29,0,0,2,0,0,0,31,30,28,0,0,2,0,0,0,1,1,0,0,0,0,0,0,110010001001005,2,206,206,2,psa_29,2D2
1000000US110010069001003,"Block 1003, Block Group 1, Census Tract 69, District of Columbia, District of Columbia",17,17,0,0,0,0,0,0,17,17,17,0,0,0,0,0,0,0,0,0,0,0,0,0,0,110010069001003,1,107,107,1,psa_16,1D2
1000000US110010105001008,"Block 1008, Block Group 1, Census Tract 105, District of Columbia, District of Columbia",0,0,0,0,0,0,0,0,0,0,0,0,0,0,0,0,0,0,0,0,0,0,0,0,0,110010105001008,1,105,105,1,psa_22,1D3
1000000US110010102002014,"Block 2014, Block Group 2, Census Tract 102, District of Columbia, District of Columbia",0,0,0,0,0,0,0,0,0,0,0,0,0,0,0,0,0,0,0,0,0,0,0,0,0,110010102002014,1,103,103,1,psa_12,1D1
1000000US110010096011034,"Block 1034, Block Group 1, Census Tract 96.01, District of Columbia, District of Columbia",0,0,0,0,0,0,0,0,0,0,0,0,0,0,0,0,0,0,0,0,0,0,0,0,0,110010096011034,6,601,601,6,psa_30,6D1
1000000US110010111003040,"Block 3040, Block Group 3, Census Tract 111, District of Columbia, District of Columbia",26,1,25,0,0,0,0,0,26,25,0,25,0,0,0,0,0,1,1,0,0,0,0,0,0,110010111003040,5,503,503,5,psa_45,5D2
1000000US110010088042007,"Block 2007, Block Group 2, Census Tract 88.04, District of Columbia, District of Columbia",142,0,139,0,0,0,0,3,142,142,0,139,0,0,0,0,3,0,0,0,0,0,0,0,0,110010088042007,5,506,506,5,psa_26,5D3
1000000US110010003002006,"Block 2006, Block Group 2, Census Tract 3, District of Columbia, District of Columbia",146,136,0,0,7,0,3,0,146,136,129,0,0,7,0,0,0,10,7,0,0,0,0,3,0,110010003002006,2,204,204,2,psa_44,2D2
1000000US110010095042016,"Block 2016, Block Group 2, Census Tract 95.04, District of Columbia, District of Columbia",45,10,30,0,1,0,4,0,45,35,4,30,0,1,0,0,0,10,6,0,0,0,0,4,0,110010095042016,4,405,405,4,psa_49,4D2
1000000US110010062021008,"Block 1008, Block Group 1, Census Tract 62.02, District of Columbia, District of Columbia",5,0,5,0,0,0,0,0,5,5,0,5,0,0,0,0,0,0,0,0,0,0,0,0,0,110010062021008,1,102,102,1,psa_18,1D1
1000000US110010068021006,"Block 1006, Block Group 1, Census Tract 68.02, District of Columbia, District of Columbia",138,56,78,0,1,0,1,2,138,137,56,78,0,1,0,0,2,1,0,0,0,0,0,1,0,110010068021006,1,107,107,1,psa_16,1D2
1000000US110010078031000,"Block 1000, Block Group 1, Census Tract 78.03, District of Columbia, District of Columbia",81,0,80,0,0,0,0,1,81,78,0,77,0,0,0,0,1,3,0,3,0,0,0,0,0,110010078031000,6,602,602,6,psa_25,6D1
1000000US110010093012006,"Block 2006, Block Group 2, Census Tract 93.01, District of Columbia, District of Columbia",0,0,0,0,0,0,0,0,0,0,0,0,0,0,0,0,0,0,0,0,0,0,0,0,0,110010093012006,5,504,504,5,psa_43,5D2
1000000US110010088031003,"Block 1003, Block Group 1, Census Tract 88.03, District of Columbia, District of Columbia",0,0,0,0,0,0,0,0,0,0,0,0,0,0,0,0,0,0,0,0,0,0,0,0,0,110010088031003,5,506,506,5,psa_26,5D3
1000000US110010074042011,"Block 2011, Block Group 2, Census Tract 74.04, District of Columbia, District of Columbia",4,0,4,0,0,0,0,0,4,4,0,4,0,0,0,0,0,0,0,0,0,0,0,0,0,110010074042011,7,704,704,7,psa_5,7D2
1000000US110010089032000,"Block 2000, Block Group 2, Census Tract 89.03, District of Columbia, District of Columbia",162,1,152,0,2,0,3,4,162,154,1,149,0,2,0,0,2,8,0,3,0,0,0,3,2,110010089032000,5,507,507,5,psa_23,5D3
1000000US110010095083002,"Block 3002, Block Group 3, Census Tract 95.08, District of Columbia, District of Columbia",119,5,114,0,0,0,0,0,119,111,0,111,0,0,0,0,0,8,5,3,0,0,0,0,0,110010095083002,4,406,406,4,psa_54,4D2
1000000US110010041002001,"Block 2001, Block Group 2, Census Tract 41, District of Columbia, District of Columbia",12,4,6,0,0,0,2,0,12,8,2,6,0,0,0,0,0,4,2,0,0,0,0,2,0,110010041002001,2,208,208,2,psa_33,2D3
1000000US110010068011010,"Block 1010, Block Group 1, Census Tract 68.01, District of Columbia, District of Columbia",0,0,0,0,0,0,0,0,0,0,0,0,0,0,0,0,0,0,0,0,0,0,0,0,0,110010068011010,1,107,107,1,psa_16,1D2
1000000US110010099021010,"Block 1010, Block Group 1, Census Tract 99.02, District of Columbia, District of Columbia",94,0,94,0,0,0,0,0,94,94,0,94,0,0,0,0,0,0,0,0,0,0,0,0,0,110010099021010,6,605,605,6,psa_11,6D2
1000000US110010099012019,"Block 2019, Block Group 2, Census Tract 99.01, District of Columbia, District of Columbia",167,10,156,0,0,0,0,1,167,166,9,156,0,0,0,0,1,1,1,0,0,0,0,0,0,110010099012019,6,605,605,6,psa_11,6D2
1000000US110010004001011,"Block 1011, Block Group 1, Census Tract 4, District of Columbia, District of Columbia",14,13,0,0,1,0,0,0,14,12,11,0,0,1,0,0,0,2,2,0,0,0,0,0,0,110010004001011,2,204,204,2,psa_44,2D2
1000000US110010104002010,"Block 2010, Block Group 2, Census Tract 104, District of Columbia, District of Columbia",0,0,0,0,0,0,0,0,0,0,0,0,0,0,0,0,0,0,0,0,0,0,0,0,0,110010104002010,7,703,703,7,psa_8,7D1
1000000US110010011001010,"Block 1010, Block Group 1, Census Tract 11, District of Columbia, District of Columbia",294,225,25,0,35,1,0,8,294,285,220,25,0,34,1,0,5,9,5,0,0,1,0,0,3,110010011001010,2,201,201,2,psa_55,2D1
1000000US110010062021237,"Block 1237, Block Group 1, Census Tract 62.02, District of Columbia, District of Columbia",0,0,0,0,0,0,0,0,0,0,0,0,0,0,0,0,0,0,0,0,0,0,0,0,0,110010062021237,2,207,207,2,psa_24,2D3
1000000US110010062021218,"Block 1218, Block Group 1, Census Tract 62.02, District of Columbia, District of Columbia",0,0,0,0,0,0,0,0,0,0,0,0,0,0,0,0,0,0,0,0,0,0,0,0,0,110010062021218,1,103,103,1,psa_12,1D1
1000000US110010032001003,"Block 1003, Block Group 1, Census Tract 32, District of Columbia, District of Columbia",174,65,89,0,0,0,14,6,174,130,46,79,0,0,0,0,5,44,19,10,0,0,0,14,1,110010032001003,4,409,409,4,psa_41,4D3
1000000US110010083011006,"Block 1006, Block Group 1, Census Tract 83.01, District of Columbia, District of Columbia",164,122,28,0,7,1,0,6,164,163,122,28,0,6,1,0,6,1,0,0,0,1,0,0,0,110010083011006,1,104,104,1,psa_21,1D2
1000000US110010074093000,"Block 3000, Block Group 3, Census Tract 74.09, District of Columbia, District of Columbia",153,0,153,0,0,0,0,0,153,151,0,151,0,0,0,0,0,2,0,2,0,0,0,0,0,110010074093000,7,704,704,7,psa_5,7D2
1000000US110010075031018,"Block 1018, Block Group 1, Census Tract 75.03, District of Columbia, District of Columbia",81,0,80,0,0,0,1,0,81,78,0,78,0,0,0,0,0,3,0,2,0,0,0,1,0,110010075031018,7,701,701,7,psa_9,7D1
1000000US110010099051000,"Block 1000, Block Group 1, Census Tract 99.05, District of Columbia, District of Columbia",0,0,0,0,0,0,0,0,0,0,0,0,0,0,0,0,0,0,0,0,0,0,0,0,0,110010099051000,6,604,604,6,psa_14,6D3
1000000US110010016001019,"Block 1019, Block Group 1, Census Tract 16, District of Columbia, District of Columbia",17,5,7,0,0,0,3,2,17,17,5,7,0,0,0,3,2,0,0,0,0,0,0,0,0,110010016001019,4,401,401,4,psa_56,4D1
1000000US110010078072007,"Block 2007, Block Group 2, Census Tract 78.07, District of Columbia, District of Columbia",51,2,45,0,0,0,0,4,51,49,2,45,0,0,0,0,2,2,0,0,0,0,0,0,2,110010078072007,6,608,608,6,psa_19,6D1
1000000US110010098071011,"Block 1011, Block Group 1, Census Tract 98.07, District of Columbia, District of Columbia",54,0,54,0,0,0,0,0,54,53,0,53,0,0,0,0,0,1,0,1,0,0,0,0,0,110010098071011,7,708,708,7,psa_1,7D3
1000000US110010014012010,"Block 2010, Block Group 2, Census Tract 14.01, District of Columbia, District of Columbia",0,0,0,0,0,0,0,0,0,0,0,0,0,0,0,0,0,0,0,0,0,0,0,0,0,110010014012010,2,201,201,2,psa_55,2D1
1000000US110010029002001,"Block 2001, Block Group 2, Census Tract 29, District of Columbia, District of Columbia",133,27,48,0,2,0,40,16,133,77,24,48,0,2,0,0,3,56,3,0,0,0,0,40,13,110010029002001,4,408,408,4,psa_39,4D3
1000000US110010078043005,"Block 3005, Block Group 3, Census Tract 78.04, District of Columbia, District of Columbia",11,0,10,0,0,0,0,1,11,11,0,10,0,0,0,0,1,0,0,0,0,0,0,0,0,110010078043005,6,602,602,6,psa_25,6D1
1000000US110010015004000,"Block 4000, Block Group 4, Census Tract 15, District of Columbia, District of Columbia",77,56,12,0,8,0,0,1,77,74,53,12,0,8,0,0,1,3,3,0,0,0,0,0,0,110010015004000,2,201,201,2,psa_55,2D1
1000000US110010028011001,"Block 1001, Block Group 1, Census Tract 28.01, District of Columbia, District of Columbia",234,62,104,4,6,0,47,11,234,164,52,98,4,6,0,2,2,70,10,6,0,0,0,45,9,110010028011001,4,408,408,4,psa_39,4D3
1000000US110010062021227,"Block 1227, Block Group 1, Census Tract 62.02, District of Columbia, District of Columbia",0,0,0,0,0,0,0,0,0,0,0,0,0,0,0,0,0,0,0,0,0,0,0,0,0,110010062021227,1,103,103,1,psa_12,1D1
1000000US110010080011005,"Block 1005, Block Group 1, Census Tract 80.01, District of Columbia, District of Columbia",124,61,55,0,0,0,1,7,124,119,58,54,0,0,0,0,7,5,3,1,0,0,0,1,0,110010080011005,1,104,104,1,psa_21,1D2
1000000US110010095071004,"Block 1004, Block Group 1, Census Tract 95.07, District of Columbia, District of Columbia",111,11,95,0,0,0,0,5,111,103,4,95,0,0,0,0,4,8,7,0,0,0,0,0,1,110010095071004,4,406,406,4,psa_54,4D2
1000000US110010107001013,"Block 1013, Block Group 1, Census Tract 107, District of Columbia, District of Columbia",0,0,0,0,0,0,0,0,0,0,0,0,0,0,0,0,0,0,0,0,0,0,0,0,0,110010107001013,2,207,207,2,psa_24,2D3
1000000US110010009012000,"Block 2000, Block Group 2, Census Tract 9.01, District of Columbia, District of Columbia",0,0,0,0,0,0,0,0,0,0,0,0,0,0,0,0,0,0,0,0,0,0,0,0,0,110010009012000,2,205,205,2,psa_46,2D2
1000000US110010095033008,"Block 3008, Block Group 3, Census Tract 95.03, District of Columbia, District of Columbia",82,16,59,0,0,0,5,2,82,71,14,55,0,0,0,0,2,11,2,4,0,0,0,5,0,110010095033008,5,504,504,5,psa_43,5D2
1000000US110010109002013,"Block 2013, Block Group 2, Census Tract 109, District of Columbia, District of Columbia",0,0,0,0,0,0,0,0,0,0,0,0,0,0,0,0,0,0,0,0,0,0,0,0,0,110010109002013,7,708,708,7,psa_1,7D3
1000000US110010095013003,"Block 3003, Block Group 3, Census Tract 95.01, District of Columbia, District of Columbia",59,0,48,5,1,2,3,0,59,54,0,48,5,1,0,0,0,5,0,0,0,0,2,3,0,110010095013003,4,405,405,4,psa_49,4D2
1000000US110010027021005,"Block 1005, Block Group 1, Census Tract 27.02, District of Columbia, District of Columbia",97,82,11,0,2,0,0,2,97,79,65,10,0,2,0,0,2,18,17,1,0,0,0,0,0,110010027021005,3,302,302,3,psa_42,3D1
1000000US110010076051008,"Block 1008, Block Group 1, Census Tract 76.05, District of Columbia, District of Columbia",114,2,111,1,0,0,0,0,114,114,2,111,1,0,0,0,0,0,0,0,0,0,0,0,0,110010076051008,6,607,607,6,psa_10,6D2
1000000US110010013022008,"Block 2008, Block Group 2, Census Tract 13.02, District of Columbia, District of Columbia",192,175,3,0,13,0,0,1,192,179,162,3,0,13,0,0,1,13,13,0,0,0,0,0,0,110010013022008,2,203,203,2,psa_50,2D1
1000000US110010014011003,"Block 1003, Block Group 1, Census Tract 14.01, District of Columbia, District of Columbia",58,53,1,0,0,0,0,4,58,51,46,1,0,0,0,0,4,7,7,0,0,0,0,0,0,110010014011003,2,201,201,2,psa_55,2D1
1000000US110010104001022,"Block 1022, Block Group 1, Census Tract 104, District of Columbia, District of Columbia",63,0,55,0,0,0,0,8,63,63,0,55,0,0,0,0,8,0,0,0,0,0,0,0,0,110010104001022,7,707,707,7,psa_4,7D2
1000000US110010062021089,"Block 1089, Block Group 1, Census Tract 62.02, District of Columbia, District of Columbia",0,0,0,0,0,0,0,0,0,0,0,0,0,0,0,0,0,0,0,0,0,0,0,0,0,110010062021089,2,207,207,2,psa_24,2D3
1000000US110010104002014,"Block 2014, Block Group 2, Census Tract 104, District of Columbia, District of Columbia",163,5,152,0,0,0,0,6,163,160,3,151,0,0,0,0,6,3,2,1,0,0,0,0,0,110010104002014,7,707,707,7,psa_4,7D2
1000000US110010002024025,"Block 4025, Block Group 4, Census Tract 2.02, District of Columbia, District of Columbia",22,21,0,0,1,0,0,0,22,21,20,0,0,1,0,0,0,1,1,0,0,0,0,0,0,110010002024025,2,206,206,2,psa_29,2D2
1000000US110010077033004,"Block 3004, Block Group 3, Census Tract 77.03, District of Columbia, District of Columbia",183,1,181,0,0,0,1,0,183,180,1,178,0,0,0,1,0,3,0,3,0,0,0,0,0,110010077033004,6,603,603,6,psa_15,6D3
1000000US110010058001002,"Block 1002, Block Group 1, Census Tract 58, District of Columbia, District of Columbia",0,0,0,0,0,0,0,0,0,0,0,0,0,0,0,0,0,0,0,0,0,0,0,0,0,110010058001002,1,101,101,1,psa_20,1D1
1000000US110010041003005,"Block 3005, Block Group 3, Census Tract 41, District of Columbia, District of Columbia",0,0,0,0,0,0,0,0,0,0,0,0,0,0,0,0,0,0,0,0,0,0,0,0,0,110010041003005,2,208,208,2,psa_33,2D3
1000000US110010095013010,"Block 3010, Block Group 3, Census Tract 95.01, District of Columbia, District of Columbia",1890,1693,44,3,73,1,21,55,1890,1750,1590,39,3,69,1,3,45,140,103,5,0,4,0,18,10,110010095013010,4,405,405,4,psa_49,4D2
1000000US110010010016004,"Block 6004, Block Group 6, Census Tract 10.01, District of Columbia, District of Columbia",46,44,1,0,0,0,0,1,46,43,41,1,0,0,0,0,1,3,3,0,0,0,0,0,0,110010010016004,2,202,202,2,psa_52,2D1
1000000US110010021023001,"Block 3001, Block Group 3, Census Tract 21.02, District of Columbia, District of Columbia",30,0,29,0,1,0,0,0,30,30,0,29,0,1,0,0,0,0,0,0,0,0,0,0,0,110010021023001,4,406,406,4,psa_54,4D2
1000000US110010101001013,"Block 1013, Block Group 1, Census Tract 101, District of Columbia, District of Columbia",0,0,0,0,0,0,0,0,0,0,0,0,0,0,0,0,0,0,0,0,0,0,0,0,0,110010101001013,2,209,209,2,psa_57,2D3
1000000US110010095082006,"Block 2006, Block Group 2, Census Tract 95.08, District of Columbia, District of Columbia",361,7,336,0,2,0,10,6,361,348,7,335,0,2,0,0,4,13,0,1,0,0,0,10,2,110010095082006,4,406,406,4,psa_54,4D2
1000000US110010008013026,"Block 3026, Block Group 3, Census Tract 8.01, District of Columbia, District of Columbia",69,68,0,0,0,0,0,1,69,66,65,0,0,0,0,0,1,3,3,0,0,0,0,0,0,110010008013026,2,205,205,2,psa_46,2D2
1000000US110010041003016,"Block 3016, Block Group 3, Census Tract 41, District of Columbia, District of Columbia",35,33,0,0,1,0,1,0,35,32,31,0,0,1,0,0,0,3,2,0,0,0,0,1,0,110010041003016,2,208,208,2,psa_33,2D3
1000000US110010076012003,"Block 2003, Block Group 2, Census Tract 76.01, District of Columbia, District of Columbia",48,0,48,0,0,0,0,0,48,48,0,48,0,0,0,0,0,0,0,0,0,0,0,0,0,110010076012003,6,607,607,6,psa_10,6D2
1000000US110010091022000,"Block 2000, Block Group 2, Census Tract 91.02, District of Columbia, District of Columbia",530,2,527,0,0,0,0,1,530,530,2,527,0,0,0,0,1,0,0,0,0,0,0,0,0,110010091022000,5,505,505,5,psa_34,5D2
1000000US110010079031016,"Block 1016, Block Group 1, Census Tract 79.03, District of Columbia, District of Columbia",125,8,113,1,0,0,1,2,125,124,8,113,1,0,0,0,2,1,0,0,0,0,0,1,0,110010079031016,5,507,507,5,psa_23,5D3
1000000US110010095033007,"Block 3007, Block Group 3, Census Tract 95.03, District of Columbia, District of Columbia",0,0,0,0,0,0,0,0,0,0,0,0,0,0,0,0,0,0,0,0,0,0,0,0,0,110010095033007,4,405,405,4,psa_49,4D2
1000000US110010033021003,"Block 1003, Block Group 1, Census Tract 33.02, District of Columbia, District of Columbia",278,79,161,0,8,0,22,8,278,243,72,156,0,8,0,0,7,35,7,5,0,0,0,22,1,110010033021003,3,308,308,3,psa_27,3D2
1000000US110010047021003,"Block 1003, Block Group 1, Census Tract 47.02, District of Columbia, District of Columbia",202,29,146,0,9,0,6,12,202,182,26,146,0,9,0,0,1,20,3,0,0,0,0,6,11,110010047021003,1,101,101,1,psa_20,1D1
1000000US110010058002015,"Block 2015, Block Group 2, Census Tract 58, District of Columbia, District of Columbia",0,0,0,0,0,0,0,0,0,0,0,0,0,0,0,0,0,0,0,0,0,0,0,0,0,110010058002015,1,102,102,1,psa_18,1D1
1000000US110010065001009,"Block 1009, Block Group 1, Census Tract 65, District of Columbia, District of Columbia",73,65,0,0,6,0,0,2,73,69,64,0,0,5,0,0,0,4,1,0,0,1,0,0,2,110010065001009,1,107,107,1,psa_16,1D2
1000000US110010022011006,"Block 1006, Block Group 1, Census Tract 22.01, District of Columbia, District of Columbia",116,26,69,0,0,0,18,3,116,92,22,69,0,0,0,0,1,24,4,0,0,0,0,18,2,110010022011006,4,407,407,4,psa_47,4D2
1000000US110010047012008,"Block 2008, Block Group 2, Census Tract 47.01, District of Columbia, District of Columbia",0,0,0,0,0,0,0,0,0,0,0,0,0,0,0,0,0,0,0,0,0,0,0,0,0,110010047012008,1,101,101,1,psa_20,1D1
1000000US110010079011005,"Block 1005, Block Group 1, Census Tract 79.01, District of Columbia, District of Columbia",108,12,88,0,2,0,0,6,108,105,11,88,0,2,0,0,4,3,1,0,0,0,0,0,2,110010079011005,5,507,507,5,psa_23,5D3
1000000US110010026002024,"Block 2024, Block Group 2, Census Tract 26, District of Columbia, District of Columbia",62,19,29,3,11,0,0,0,62,62,19,29,3,11,0,0,0,0,0,0,0,0,0,0,0,110010026002024,4,404,404,4,psa_48,4D3
1000000US110010047021022,"Block 1022, Block Group 1, Census Tract 47.02, District of Columbia, District of Columbia",0,0,0,0,0,0,0,0,0,0,0,0,0,0,0,0,0,0,0,0,0,0,0,0,0,110010047021022,1,102,102,1,psa_18,1D1
1000000US110010095013011,"Block 3011, Block Group 3, Census Tract 95.01, District of Columbia, District of Columbia",0,0,0,0,0,0,0,0,0,0,0,0,0,0,0,0,0,0,0,0,0,0,0,0,0,110010095013011,4,405,405,4,psa_49,4D2
1000000US110010023021022,"Block 1022, Block Group 1, Census Tract 23.02, District of Columbia, District of Columbia",0,0,0,0,0,0,0,0,0,0,0,0,0,0,0,0,0,0,0,0,0,0,0,0,0,110010023021022,4,405,405,4,psa_49,4D2
1000000US110010067002007,"Block 2007, Block Group 2, Census Tract 67, District of Columbia, District of Columbia",139,127,6,0,4,0,0,2,139,139,127,6,0,4,0,0,2,0,0,0,0,0,0,0,0,110010067002007,1,107,107,1,psa_16,1D2
1000000US110010068021003,"Block 1003, Block Group 1, Census Tract 68.02, District of Columbia, District of Columbia",110,52,50,0,2,0,4,2,110,102,46,50,0,2,0,3,1,8,6,0,0,0,0,1,1,110010068021003,1,107,107,1,psa_16,1D2
1000000US110010074042007,"Block 2007, Block Group 2, Census Tract 74.04, District of Columbia, District of Columbia",153,8,130,0,1,0,0,14,153,145,2,130,0,1,0,0,12,8,6,0,0,0,0,0,2,110010074042007,7,704,704,7,psa_5,7D2
1000000US110010095042005,"Block 2005, Block Group 2, Census Tract 95.04, District of Columbia, District of Columbia",53,0,42,1,0,0,5,5,53,48,0,42,1,0,0,0,5,5,0,0,0,0,0,5,0,110010095042005,4,405,405,4,psa_49,4D2
1000000US110010021011003,"Block 1003, Block Group 1, Census Tract 21.01, District of Columbia, District of Columbia",4,2,1,1,0,0,0,0,4,1,0,1,0,0,0,0,0,3,2,0,1,0,0,0,0,110010021011003,4,403,403,4,psa_51,4D1
1000000US110010092041005,"Block 1005, Block Group 1, Census Tract 92.04, District of Columbia, District of Columbia",0,0,0,0,0,0,0,0,0,0,0,0,0,0,0,0,0,0,0,0,0,0,0,0,0,110010092041005,5,502,502,5,psa_40,5D1
1000000US110010097001016,"Block 1016, Block Group 1, Census Tract 97, District of Columbia, District of Columbia",232,3,225,0,0,0,0,4,232,231,3,224,0,0,0,0,4,1,0,1,0,0,0,0,0,110010097001016,7,706,706,7,psa_2,7D3
1000000US110010106002014,"Block 2014, Block Group 2, Census Tract 106, District of Columbia, District of Columbia",179,75,94,1,2,0,1,6,179,170,69,94,0,2,0,1,4,9,6,0,1,0,0,0,2,110010106002014,5,501,501,5,psa_35,5D1
1000000US110010019013001,"Block 3001, Block Group 3, Census Tract 19.01, District of Columbia, District of Columbia",102,5,72,0,0,0,23,2,102,79,5,72,0,0,0,0,2,23,0,0,0,0,0,23,0,110010019013001,4,402,402,4,psa_53,4D1
1000000US110010046002002,"Block 2002, Block Group 2, Census Tract 46, District of Columbia, District of Columbia",55,10,40,0,3,0,0,2,55,52,10,37,0,3,0,0,2,3,0,3,0,0,0,0,0,110010046002002,3,308,308,3,psa_27,3D2
1000000US110010091022024,"Block 2024, Block Group 2, Census Tract 91.02, District of Columbia, District of Columbia",0,0,0,0,0,0,0,0,0,0,0,0,0,0,0,0,0,0,0,0,0,0,0,0,0,110010091022024,5,505,505,5,psa_34,5D2
1000000US110010076015025,"Block 5025, Block Group 5, Census Tract 76.01, District of Columbia, District of Columbia",0,0,0,0,0,0,0,0,0,0,0,0,0,0,0,0,0,0,0,0,0,0,0,0,0,110010076015025,7,701,701,7,psa_9,7D1
1000000US110010009022021,"Block 2021, Block Group 2, Census Tract 9.02, District of Columbia, District of Columbia",48,38,0,0,4,0,0,6,48,46,38,0,0,4,0,0,4,2,0,0,0,0,0,0,2,110010009022021,2,205,205,2,psa_46,2D2
1000000US110010059001014,"Block 1014, Block Group 1, Census Tract 59, District of Columbia, District of Columbia",0,0,0,0,0,0,0,0,0,0,0,0,0,0,0,0,0,0,0,0,0,0,0,0,0,110010059001014,1,101,101,1,psa_20,1D1
1000000US110010106002059,"Block 2059, Block Group 2, Census Tract 106, District of Columbia, District of Columbia",0,0,0,0,0,0,0,0,0,0,0,0,0,0,0,0,0,0,0,0,0,0,0,0,0,110010106002059,1,102,102,1,psa_18,1D1
1000000US110010013011011,"Block 1011, Block Group 1, Census Tract 13.01, District of Columbia, District of Columbia",0,0,0,0,0,0,0,0,0,0,0,0,0,0,0,0,0,0,0,0,0,0,0,0,0,110010013011011,2,203,203,2,psa_50,2D1
1000000US110010075021001,"Block 1001, Block Group 1, Census Tract 75.02, District of Columbia, District of Columbia",36,0,36,0,0,0,0,0,36,36,0,36,0,0,0,0,0,0,0,0,0,0,0,0,0,110010075021001,7,702,702,7,psa_6,7D1
1000000US110010013011004,"Block 1004, Block Group 1, Census Tract 13.01, District of Columbia, District of Columbia",0,0,0,0,0,0,0,0,0,0,0,0,0,0,0,0,0,0,0,0,0,0,0,0,0,110010013011004,2,203,203,2,psa_50,2D1
1000000US110010017022022,"Block 2022, Block Group 2, Census Tract 17.02, District of Columbia, District of Columbia",41,10,26,0,0,0,0,5,41,41,10,26,0,0,0,0,5,0,0,0,0,0,0,0,0,110010017022022,4,401,401,4,psa_56,4D1
1000000US110010078061004,"Block 1004, Block Group 1, Census Tract 78.06, District of Columbia, District of Columbia",142,7,133,1,0,0,0,1,142,129,2,126,0,0,0,0,1,13,5,7,1,0,0,0,0,110010078061004,6,602,602,6,psa_25,6D1
1000000US110010071001005,"Block 1005, Block Group 1, Census Tract 71, District of Columbia, District of Columbia",0,0,0,0,0,0,0,0,0,0,0,0,0,0,0,0,0,0,0,0,0,0,0,0,0,110010071001005,1,106,106,1,psa_13,1D3
1000000US110010095042013,"Block 2013, Block Group 2, Census Tract 95.04, District of Columbia, District of Columbia",0,0,0,0,0,0,0,0,0,0,0,0,0,0,0,0,0,0,0,0,0,0,0,0,0,110010095042013,4,405,405,4,psa_49,4D2
1000000US110010012004014,"Block 4014, Block Group 4, Census Tract 12, District of Columbia, District of Columbia",82,77,0,0,5,0,0,0,82,80,75,0,0,5,0,0,0,2,2,0,0,0,0,0,0,110010012004014,2,202,202,2,psa_52,2D1
1000000US110010021012002,"Block 2002, Block Group 2, Census Tract 21.01, District of Columbia, District of Columbia",114,30,60,0,3,0,21,0,114,78,15,60,0,3,0,0,0,36,15,0,0,0,0,21,0,110010021012002,4,403,403,4,psa_51,4D1
1000000US110010076013009,"Block 3009, Block Group 3, Census Tract 76.01, District of Columbia, District of Columbia",111,7,104,0,0,0,0,0,111,110,7,103,0,0,0,0,0,1,0,1,0,0,0,0,0,110010076013009,6,607,607,6,psa_10,6D2
1000000US110010088022006,"Block 2006, Block Group 2, Census Tract 88.02, District of Columbia, District of Columbia",77,3,71,0,0,0,0,3,77,76,3,71,0,0,0,0,2,1,0,0,0,0,0,0,1,110010088022006,5,506,506,5,psa_26,5D3
1000000US110010008012001,"Block 2001, Block Group 2, Census Tract 8.01, District of Columbia, District of Columbia",27,24,0,0,1,0,0,2,27,26,23,0,0,1,0,0,2,1,1,0,0,0,0,0,0,110010008012001,2,205,205,2,psa_46,2D2
1000000US110010009012026,"Block 2026, Block Group 2, Census Tract 9.01, District of Columbia, District of Columbia",54,54,0,0,0,0,0,0,54,53,53,0,0,0,0,0,0,1,1,0,0,0,0,0,0,110010009012026,2,205,205,2,psa_46,2D2
1000000US110010073011116,"Block 1116, Block Group 1, Census Tract 73.01, District of Columbia, District of Columbia",0,0,0,0,0,0,0,0,0,0,0,0,0,0,0,0,0,0,0,0,0,0,0,0,0,110010073011116,7,708,708,7,psa_1,7D3
1000000US110010095031009,"Block 1009, Block Group 1, Census Tract 95.03, District of Columbia, District of Columbia",132,12,116,0,0,0,4,0,132,128,12,116,0,0,0,0,0,4,0,0,0,0,0,4,0,110010095031009,4,405,405,4,psa_49,4D2
1000000US110010099052003,"Block 2003, Block Group 2, Census Tract 99.05, District of Columbia, District of Columbia",127,0,126,0,0,0,0,1,127,127,0,126,0,0,0,0,1,0,0,0,0,0,0,0,0,110010099052003,6,604,604,6,psa_14,6D3
1000000US110010016004017,"Block 4017, Block Group 4, Census Tract 16, District of Columbia, District of Columbia",74,26,44,0,0,0,0,4,74,70,24,42,0,0,0,0,4,4,2,2,0,0,0,0,0,110010016004017,4,401,401,4,psa_56,4D1
1000000US110010096022001,"Block 2001, Block Group 2, Census Tract 96.02, District of Columbia, District of Columbia",0,0,0,0,0,0,0,0,0,0,0,0,0,0,0,0,0,0,0,0,0,0,0,0,0,110010096022001,6,601,601,6,psa_30,6D1
1000000US110010014022005,"Block 2005, Block Group 2, Census Tract 14.02, District of Columbia, District of Columbia",36,33,1,0,0,0,2,0,36,33,32,1,0,0,0,0,0,3,1,0,0,0,0,2,0,110010014022005,2,201,201,2,psa_55,2D1
1000000US110010022011007,"Block 1007, Block Group 1, Census Tract 22.01, District of Columbia, District of Columbia",94,12,80,0,1,0,1,0,94,91,10,80,0,1,0,0,0,3,2,0,0,0,0,1,0,110010022011007,4,407,407,4,psa_47,4D2
1000000US110010068041017,"Block 1017, Block Group 1, Census Tract 68.04, District of Columbia, District of Columbia",0,0,0,0,0,0,0,0,0,0,0,0,0,0,0,0,0,0,0,0,0,0,0,0,0,110010068041017,1,107,107,1,psa_16,1D2
1000000US110010025012012,"Block 2012, Block Group 2, Census Tract 25.01, District of Columbia, District of Columbia",198,79,88,0,0,0,26,5,198,154,62,87,0,0,0,0,5,44,17,1,0,0,0,26,0,110010025012012,4,404,404,4,psa_48,4D3
1000000US110010023012017,"Block 2017, Block Group 2, Census Tract 23.01, District of Columbia, District of Columbia",0,0,0,0,0,0,0,0,0,0,0,0,0,0,0,0,0,0,0,0,0,0,0,0,0,110010023012017,4,407,407,4,psa_47,4D2
1000000US110010099051009,"Block 1009, Block Group 1, Census Tract 99.05, District of Columbia, District of Columbia",56,4,52,0,0,0,0,0,56,52,0,52,0,0,0,0,0,4,4,0,0,0,0,0,0,110010099051009,6,604,604,6,psa_14,6D3
1000000US110010015004011,"Block 4011, Block Group 4, Census Tract 15, District of Columbia, District of Columbia",53,35,16,0,2,0,0,0,53,50,32,16,0,2,0,0,0,3,3,0,0,0,0,0,0,110010015004011,2,201,201,2,psa_55,2D1
1000000US110010027023013,"Block 3013, Block Group 3, Census Tract 27.02, District of Columbia, District of Columbia",0,0,0,0,0,0,0,0,0,0,0,0,0,0,0,0,0,0,0,0,0,0,0,0,0,110010027023013,3,302,302,3,psa_42,3D1
1000000US110010009011012,"Block 1012, Block Group 1, Census Tract 9.01, District of Columbia, District of Columbia",112,104,0,0,3,0,1,4,112,110,103,0,0,3,0,0,4,2,1,0,0,0,0,1,0,110010009011012,2,205,205,2,psa_46,2D2
1000000US110010111003054,"Block 3054, Block Group 3, Census Tract 111, District of Columbia, District of Columbia",0,0,0,0,0,0,0,0,0,0,0,0,0,0,0,0,0,0,0,0,0,0,0,0,0,110010111003054,5,503,503,5,psa_45,5D2
1000000US110010005012000,"Block 2000, Block Group 2, Census Tract 5.01, District of Columbia, District of Columbia",1559,1315,38,0,137,0,9,60,1559,1447,1239,38,0,135,0,1,34,112,76,0,0,2,0,8,26,110010005012000,2,204,204,2,psa_44,2D2
1000000US110010008021010,"Block 1010, Block Group 1, Census Tract 8.02, District of Columbia, District of Columbia",46,45,0,0,1,0,0,0,46,37,36,0,0,1,0,0,0,9,9,0,0,0,0,0,0,110010008021010,2,205,205,2,psa_46,2D2
1000000US110010108003002,"Block 3002, Block Group 3, Census Tract 108.00, District of Columbia, District of Columbia",215,175,9,0,25,0,3,3,215,212,175,9,0,25,0,0,3,3,0,0,0,0,0,3,0,110010108003002,2,207,207,2,psa_24,2D3
1000000US110010002024001,"Block 4001, Block Group 4, Census Tract 2.02, District of Columbia, District of Columbia",123,75,11,1,21,0,7,8,123,109,73,10,1,20,0,1,4,14,2,1,0,1,0,6,4,110010002024001,2,206,206,2,psa_29,2D2
1000000US110010074011004,"Block 1004, Block Group 1, Census Tract 74.01, District of Columbia, District of Columbia",0,0,0,0,0,0,0,0,0,0,0,0,0,0,0,0,0,0,0,0,0,0,0,0,0,110010074011004,7,701,701,7,psa_9,7D1
1000000US110010096011048,"Block 1048, Block Group 1, Census Tract 96.01, District of Columbia, District of Columbia",0,0,0,0,0,0,0,0,0,0,0,0,0,0,0,0,0,0,0,0,0,0,0,0,0,110010096011048,6,602,602,6,psa_25,6D1
1000000US110010058001041,"Block 1041, Block Group 1, Census Tract 58, District of Columbia, District of Columbia",0,0,0,0,0,0,0,0,0,0,0,0,0,0,0,0,0,0,0,0,0,0,0,0,0,110010058001041,2,209,209,2,psa_57,2D3
1000000US110010072002012,"Block 2012, Block Group 2, Census Tract 72, District of Columbia, District of Columbia",10,8,0,0,2,0,0,0,10,10,8,0,0,2,0,0,0,0,0,0,0,0,0,0,0,110010072002012,1,106,106,1,psa_13,1D3
1000000US110010078083004,"Block 3004, Block Group 3, Census Tract 78.08, District of Columbia, District of Columbia",0,0,0,0,0,0,0,0,0,0,0,0,0,0,0,0,0,0,0,0,0,0,0,0,0,110010078083004,6,608,608,6,psa_19,6D1
1000000US110010009013011,"Block 3011, Block Group 3, Census Tract 9.01, District of Columbia, District of Columbia",3169,2535,134,14,304,3,49,130,3169,2961,2399,131,11,300,3,11,106,208,136,3,3,4,0,38,24,110010009013011,2,205,205,2,psa_46,2D2
1000000US110010037001000,"Block 1000, Block Group 1, Census Tract 37, District of Columbia, District of Columbia",396,140,106,1,20,0,100,29,396,240,124,85,1,20,0,0,10,156,16,21,0,0,0,100,19,110010037001000,3,304,304,3,psa_36,3D1
1000000US110010062021061,"Block 1061, Block Group 1, Census Tract 62.02, District of Columbia, District of Columbia",0,0,0,0,0,0,0,0,0,0,0,0,0,0,0,0,0,0,0,0,0,0,0,0,0,110010062021061,2,207,207,2,psa_24,2D3
1000000US110010020021022,"Block 1022, Block Group 1, Census Tract 20.02, District of Columbia, District of Columbia",18,5,11,0,1,0,1,0,18,17,4,11,0,1,0,1,0,1,1,0,0,0,0,0,0,110010020021022,4,404,404,4,psa_48,4D3
1000000US110010062021127,"Block 1127, Block Group 1, Census Tract 62.02, District of Columbia, District of Columbia",0,0,0,0,0,0,0,0,0,0,0,0,0,0,0,0,0,0,0,0,0,0,0,0,0,110010062021127,1,102,102,1,psa_18,1D1
1000000US110010005021012,"Block 1012, Block Group 1, Census Tract 5.02, District of Columbia, District of Columbia",18,13,0,0,3,0,2,0,18,18,13,0,0,3,0,2,0,0,0,0,0,0,0,0,0,110010005021012,2,204,204,2,psa_44,2D2
1000000US110010021026007,"Block 6007, Block Group 6, Census Tract 21.02, District of Columbia, District of Columbia",0,0,0,0,0,0,0,0,0,0,0,0,0,0,0,0,0,0,0,0,0,0,0,0,0,110010021026007,4,403,403,4,psa_51,4D1
1000000US110010110003000,"Block 3000, Block Group 3, Census Tract 110, District of Columbia, District of Columbia",278,173,86,0,9,0,2,8,278,264,165,85,0,9,0,0,5,14,8,1,0,0,0,2,3,110010110003000,1,103,103,1,psa_12,1D1
1000000US110010001001000,"Block 1000, Block Group 1, Census Tract 1, District of Columbia, District of Columbia",324,270,7,2,23,0,10,12,324,279,239,7,2,23,0,0,8,45,31,0,0,0,0,10,4,110010001001000,2,206,206,2,psa_29,2D2
1000000US110010071002012,"Block 2012, Block Group 2, Census Tract 71, District of Columbia, District of Columbia",46,23,18,0,4,0,0,1,46,45,23,17,0,4,0,0,1,1,0,1,0,0,0,0,0,110010071002012,1,106,106,1,psa_13,1D3
1000000US110010094001008,"Block 1008, Block Group 1, Census Tract 94, District of Columbia, District of Columbia",31,0,29,0,1,0,0,1,31,31,0,29,0,1,0,0,1,0,0,0,0,0,0,0,0,110010094001008,5,503,503,5,psa_45,5D2
1000000US110010073041001,"Block 1001, Block Group 1, Census Tract 73.04, District of Columbia, District of Columbia",0,0,0,0,0,0,0,0,0,0,0,0,0,0,0,0,0,0,0,0,0,0,0,0,0,110010073041001,7,704,704,7,psa_5,7D2
1000000US110010019022018,"Block 2018, Block Group 2, Census Tract 19.02, District of Columbia, District of Columbia",0,0,0,0,0,0,0,0,0,0,0,0,0,0,0,0,0,0,0,0,0,0,0,0,0,110010019022018,4,406,406,4,psa_54,4D2
1000000US110010078034003,"Block 4003, Block Group 4, Census Tract 78.03, District of Columbia, District of Columbia",122,7,112,0,0,0,3,0,122,113,1,112,0,0,0,0,0,9,6,0,0,0,0,3,0,110010078034003,6,602,602,6,psa_25,6D1
1000000US110010089031013,"Block 1013, Block Group 1, Census Tract 89.03, District of Columbia, District of Columbia",149,4,127,0,0,0,18,0,149,130,4,126,0,0,0,0,0,19,0,1,0,0,0,18,0,110010089031013,5,507,507,5,psa_23,5D3
1000000US110010002022004,"Block 2004, Block Group 2, Census Tract 2.02, District of Columbia, District of Columbia",120,109,0,0,6,0,1,4,120,111,103,0,0,6,0,0,2,9,6,0,0,0,0,1,2,110010002022004,2,206,206,2,psa_29,2D2
1000000US110010040012002,"Block 2002, Block Group 2, Census Tract 40.01, District of Columbia, District of Columbia",116,102,2,0,6,0,0,6,116,106,95,2,0,6,0,0,3,10,7,0,0,0,0,0,3,110010040012002,3,303,303,3,psa_37,3D3
1000000US110010007022000,"Block 2000, Block Group 2, Census Tract 7.02, District of Columbia, District of Columbia",1063,764,98,4,127,0,33,37,1063,926,678,93,2,121,0,3,29,137,86,5,2,6,0,30,8,110010007022000,2,204,204,2,psa_44,2D2
1000000US110010096021018,"Block 1018, Block Group 1, Census Tract 96.02, District of Columbia, District of Columbia",110,0,107,0,1,0,0,2,110,107,0,104,0,1,0,0,2,3,0,3,0,0,0,0,0,110010096021018,6,601,601,6,psa_30,6D1
1000000US110010099053004,"Block 3004, Block Group 3, Census Tract 99.05, District of Columbia, District of Columbia",227,0,218,0,0,0,0,9,227,225,0,216,0,0,0,0,9,2,0,2,0,0,0,0,0,110010099053004,6,604,604,6,psa_14,6D3
1000000US110010017021005,"Block 1005, Block Group 1, Census Tract 17.02, District of Columbia, District of Columbia",30,14,15,0,0,0,1,0,30,28,13,15,0,0,0,0,0,2,1,0,0,0,0,1,0,110010017021005,4,401,401,4,psa_56,4D1
1000000US110010094002019,"Block 2019, Block Group 2, Census Tract 94, District of Columbia, District of Columbia",27,0,27,0,0,0,0,0,27,27,0,27,0,0,0,0,0,0,0,0,0,0,0,0,0,110010094002019,5,503,503,5,psa_45,5D2
1000000US110010096011035,"Block 1035, Block Group 1, Census Tract 96.01, District of Columbia, District of Columbia",11,0,11,0,0,0,0,0,11,11,0,11,0,0,0,0,0,0,0,0,0,0,0,0,0,110010096011035,6,601,601,6,psa_30,6D1
1000000US110010001004021,"Block 4021, Block Group 4, Census Tract 1, District of Columbia, District of Columbia",0,0,0,0,0,0,0,0,0,0,0,0,0,0,0,0,0,0,0,0,0,0,0,0,0,110010001004021,2,206,206,2,psa_29,2D2
1000000US110010059001032,"Block 1032, Block Group 1, Census Tract 59, District of Columbia, District of Columbia",0,0,0,0,0,0,0,0,0,0,0,0,0,0,0,0,0,0,0,0,0,0,0,0,0,110010059001032,1,102,102,1,psa_18,1D1
1000000US110010098071009,"Block 1009, Block Group 1, Census Tract 98.07, District of Columbia, District of Columbia",33,0,32,0,0,0,1,0,33,31,0,31,0,0,0,0,0,2,0,1,0,0,0,1,0,110010098071009,7,708,708,7,psa_1,7D3
1000000US110010012004006,"Block 4006, Block Group 4, Census Tract 12, District of Columbia, District of Columbia",0,0,0,0,0,0,0,0,0,0,0,0,0,0,0,0,0,0,0,0,0,0,0,0,0,110010012004006,2,202,202,2,psa_52,2D1
1000000US110010021014004,"Block 4004, Block Group 4, Census Tract 21.01, District of Columbia, District of Columbia",0,0,0,0,0,0,0,0,0,0,0,0,0,0,0,0,0,0,0,0,0,0,0,0,0,110010021014004,4,403,403,4,psa_51,4D1
1000000US110010058001040,"Block 1040, Block Group 1, Census Tract 58, District of Columbia, District of Columbia",84,69,4,0,3,0,3,5,84,77,65,4,0,3,0,0,5,7,4,0,0,0,0,3,0,110010058001040,1,102,102,1,psa_18,1D1
1000000US110010023012016,"Block 2016, Block Group 2, Census Tract 23.01, District of Columbia, District of Columbia",114,22,70,1,0,0,17,4,114,89,16,69,1,0,0,0,3,25,6,1,0,0,0,17,1,110010023012016,4,407,407,4,psa_47,4D2
1000000US110010109002023,"Block 2023, Block Group 2, Census Tract 109, District of Columbia, District of Columbia",0,0,0,0,0,0,0,0,0,0,0,0,0,0,0,0,0,0,0,0,0,0,0,0,0,110010109002023,7,708,708,7,psa_1,7D3
1000000US110010111001003,"Block 1003, Block Group 1, Census Tract 111, District of Columbia, District of Columbia",54,1,48,0,0,0,0,5,54,50,1,45,0,0,0,0,4,4,0,3,0,0,0,0,1,110010111001003,5,503,503,5,psa_45,5D2
1000000US110010016003014,"Block 3014, Block Group 3, Census Tract 16, District of Columbia, District of Columbia",131,29,94,0,8,0,0,0,131,130,29,93,0,8,0,0,0,1,0,1,0,0,0,0,0,110010016003014,4,401,401,4,psa_56,4D1
1000000US110010078082016,"Block 2016, Block Group 2, Census Tract 78.08, District of Columbia, District of Columbia",0,0,0,0,0,0,0,0,0,0,0,0,0,0,0,0,0,0,0,0,0,0,0,0,0,110010078082016,6,608,608,6,psa_19,6D1
1000000US110010078072001,"Block 2001, Block Group 2, Census Tract 78.07, District of Columbia, District of Columbia",91,0,91,0,0,0,0,0,91,89,0,89,0,0,0,0,0,2,0,2,0,0,0,0,0,110010078072001,6,608,608,6,psa_19,6D1
1000000US110010105002000,"Block 2000, Block Group 2, Census Tract 105, District of Columbia, District of Columbia",2,1,1,0,0,0,0,0,2,1,1,0,0,0,0,0,0,1,0,1,0,0,0,0,0,110010105002000,1,103,103,1,psa_12,1D1
1000000US110010008021016,"Block 1016, Block Group 1, Census Tract 8.02, District of Columbia, District of Columbia",0,0,0,0,0,0,0,0,0,0,0,0,0,0,0,0,0,0,0,0,0,0,0,0,0,110010008021016,2,205,205,2,psa_46,2D2
1000000US110010095052020,"Block 2020, Block Group 2, Census Tract 95.05, District of Columbia, District of Columbia",12,0,12,0,0,0,0,0,12,12,0,12,0,0,0,0,0,0,0,0,0,0,0,0,0,110010095052020,4,406,406,4,psa_54,4D2
1000000US110010072002010,"Block 2010, Block Group 2, Census Tract 72, District of Columbia, District of Columbia",0,0,0,0,0,0,0,0,0,0,0,0,0,0,0,0,0,0,0,0,0,0,0,0,0,110010072002010,1,106,106,1,psa_13,1D3
1000000US110010024003003,"Block 3003, Block Group 3, Census Tract 24, District of Columbia, District of Columbia",47,12,29,0,0,0,6,0,47,34,6,28,0,0,0,0,0,13,6,1,0,0,0,6,0,110010024003003,4,407,407,4,psa_47,4D2
1000000US110010016001005,"Block 1005, Block Group 1, Census Tract 16, District of Columbia, District of Columbia",61,8,46,0,2,0,0,5,61,57,4,46,0,2,0,0,5,4,4,0,0,0,0,0,0,110010016001005,4,401,401,4,psa_56,4D1
1000000US110010105002009,"Block 2009, Block Group 2, Census Tract 105, District of Columbia, District of Columbia",0,0,0,0,0,0,0,0,0,0,0,0,0,0,0,0,0,0,0,0,0,0,0,0,0,110010105002009,1,103,103,1,psa_12,1D1
1000000US110010019012006,"Block 2006, Block Group 2, Census Tract 19.01, District of Columbia, District of Columbia",100,5,91,0,0,0,0,4,100,97,5,90,0,0,0,0,2,3,0,1,0,0,0,0,2,110010019012006,4,402,402,4,psa_53,4D1
1000000US110010050012006,"Block 2006, Block Group 2, Census Tract 50.01, District of Columbia, District of Columbia",0,0,0,0,0,0,0,0,0,0,0,0,0,0,0,0,0,0,0,0,0,0,0,0,0,110010050012006,3,307,307,3,psa_28,3D3
1000000US110010062021123,"Block 1123, Block Group 1, Census Tract 62.02, District of Columbia, District of Columbia",0,0,0,0,0,0,0,0,0,0,0,0,0,0,0,0,0,0,0,0,0,0,0,0,0,110010062021123,1,102,102,1,psa_18,1D1
1000000US110010005022005,"Block 2005, Block Group 2, Census Tract 5.02, District of Columbia, District of Columbia",69,56,5,1,4,0,0,3,69,66,53,5,1,4,0,0,3,3,3,0,0,0,0,0,0,110010005022005,2,204,204,2,psa_44,2D2
1000000US110010078032003,"Block 2003, Block Group 2, Census Tract 78.03, District of Columbia, District of Columbia",85,1,84,0,0,0,0,0,85,85,1,84,0,0,0,0,0,0,0,0,0,0,0,0,0,110010078032003,6,602,602,6,psa_25,6D1
1000000US110010029001007,"Block 1007, Block Group 1, Census Tract 29, District of Columbia, District of Columbia",162,104,29,1,4,0,14,10,162,138,95,29,1,4,0,0,9,24,9,0,0,0,0,14,1,110010029001007,3,302,302,3,psa_42,3D1
1000000US110010047021017,"Block 1017, Block Group 1, Census Tract 47.02, District of Columbia, District of Columbia",0,0,0,0,0,0,0,0,0,0,0,0,0,0,0,0,0,0,0,0,0,0,0,0,0,110010047021017,1,101,101,1,psa_20,1D1
1000000US110010076043001,"Block 3001, Block Group 3, Census Tract 76.04, District of Columbia, District of Columbia",47,5,40,0,0,0,0,2,47,47,5,40,0,0,0,0,2,0,0,0,0,0,0,0,0,110010076043001,6,607,607,6,psa_10,6D2
1000000US110010078031012,"Block 1012, Block Group 1, Census Tract 78.03, District of Columbia, District of Columbia",0,0,0,0,0,0,0,0,0,0,0,0,0,0,0,0,0,0,0,0,0,0,0,0,0,110010078031012,6,602,602,6,psa_25,6D1
1000000US110010062021235,"Block 1235, Block Group 1, Census Tract 62.02, District of Columbia, District of Columbia",0,0,0,0,0,0,0,0,0,0,0,0,0,0,0,0,0,0,0,0,0,0,0,0,0,110010062021235,2,207,207,2,psa_24,2D3
1000000US110010023021003,"Block 1003, Block Group 1, Census Tract 23.02, District of Columbia, District of Columbia",0,0,0,0,0,0,0,0,0,0,0,0,0,0,0,0,0,0,0,0,0,0,0,0,0,110010023021003,4,405,405,4,psa_49,4D2
1000000US110010077082009,"Block 2009, Block Group 2, Census Tract 77.08, District of Columbia, District of Columbia",143,0,138,1,0,0,0,4,143,142,0,137,1,0,0,0,4,1,0,1,0,0,0,0,0,110010077082009,6,603,603,6,psa_15,6D3
1000000US110010068011009,"Block 1009, Block Group 1, Census Tract 68.01, District of Columbia, District of Columbia",38,5,33,0,0,0,0,0,38,36,5,31,0,0,0,0,0,2,0,2,0,0,0,0,0,110010068011009,1,107,107,1,psa_16,1D2
1000000US110010010012013,"Block 2013, Block Group 2, Census Tract 10.01, District of Columbia, District of Columbia",124,103,3,0,3,0,7,8,124,112,99,3,0,3,0,0,7,12,4,0,0,0,0,7,1,110010010012013,2,202,202,2,psa_52,2D1
1000000US110010019014003,"Block 4003, Block Group 4, Census Tract 19.01, District of Columbia, District of Columbia",46,13,33,0,0,0,0,0,46,44,11,33,0,0,0,0,0,2,2,0,0,0,0,0,0,110010019014003,4,402,402,4,psa_53,4D1
1000000US110010008022007,"Block 2007, Block Group 2, Census Tract 8.02, District of Columbia, District of Columbia",0,0,0,0,0,0,0,0,0,0,0,0,0,0,0,0,0,0,0,0,0,0,0,0,0,110010008022007,2,205,205,2,psa_46,2D2
1000000US110010096032000,"Block 2000, Block Group 2, Census Tract 96.03, District of Columbia, District of Columbia",0,0,0,0,0,0,0,0,0,0,0,0,0,0,0,0,0,0,0,0,0,0,0,0,0,110010096032000,6,603,603,6,psa_15,6D3
1000000US110010042012001,"Block 2001, Block Group 2, Census Tract 42.01, District of Columbia, District of Columbia",138,101,22,0,7,0,0,8,138,131,98,22,0,7,0,0,4,7,3,0,0,0,0,0,4,110010042012001,3,301,301,3,psa_31,3D3
1000000US110010093021015,"Block 1015, Block Group 1, Census Tract 93.02, District of Columbia, District of Columbia",0,0,0,0,0,0,0,0,0,0,0,0,0,0,0,0,0,0,0,0,0,0,0,0,0,110010093021015,5,504,504,5,psa_43,5D2
1000000US110010052014003,"Block 4003, Block Group 4, Census Tract 52.01, District of Columbia, District of Columbia",222,184,15,0,11,0,4,8,222,204,174,15,0,11,0,0,4,18,10,0,0,0,0,4,4,110010052014003,3,301,301,3,psa_31,3D3
1000000US110010010011011,"Block 1011, Block Group 1, Census Tract 10.01, District of Columbia, District of Columbia",67,58,0,1,1,0,0,7,67,62,54,0,0,1,0,0,7,5,4,0,1,0,0,0,0,110010010011011,2,202,202,2,psa_52,2D1
1000000US110010091022004,"Block 2004, Block Group 2, Census Tract 91.02, District of Columbia, District of Columbia",80,8,59,0,0,0,11,2,80,61,1,58,0,0,0,0,2,19,7,1,0,0,0,11,0,110010091022004,5,505,505,5,psa_34,5D2
1000000US110010102002023,"Block 2023, Block Group 2, Census Tract 102, District of Columbia, District of Columbia",41,29,9,0,2,1,0,0,41,39,27,9,0,2,1,0,0,2,2,0,0,0,0,0,0,110010102002023,1,103,103,1,psa_12,1D1
1000000US110010014021009,"Block 1009, Block Group 1, Census Tract 14.02, District of Columbia, District of Columbia",79,71,6,0,0,0,1,1,79,77,69,6,0,0,0,1,1,2,2,0,0,0,0,0,0,110010014021009,2,201,201,2,psa_55,2D1
1000000US110010042011000,"Block 1000, Block Group 1, Census Tract 42.01, District of Columbia, District of Columbia",238,165,51,0,10,0,5,7,238,227,160,49,0,10,0,1,7,11,5,2,0,0,0,4,0,110010042011000,3,301,301,3,psa_31,3D3
1000000US110010091021010,"Block 1010, Block Group 1, Census Tract 91.02, District of Columbia, District of Columbia",54,3,50,0,0,0,0,1,54,54,3,50,0,0,0,0,1,0,0,0,0,0,0,0,0,110010091021010,5,505,505,5,psa_34,5D2
1000000US110010093012008,"Block 2008, Block Group 2, Census Tract 93.01, District of Columbia, District of Columbia",27,5,12,0,0,0,9,1,27,17,5,12,0,0,0,0,0,10,0,0,0,0,0,9,1,110010093012008,5,504,504,5,psa_43,5D2
1000000US110010095093004,"Block 3004, Block Group 3, Census Tract 95.09, District of Columbia, District of Columbia",445,26,383,0,14,0,8,14,445,425,21,379,0,14,0,1,10,20,5,4,0,0,0,7,4,110010095093004,4,405,405,4,psa_49,4D2
1000000US110010015002013,"Block 2013, Block Group 2, Census Tract 15, District of Columbia, District of Columbia",64,64,0,0,0,0,0,0,64,61,61,0,0,0,0,0,0,3,3,0,0,0,0,0,0,110010015002013,2,201,201,2,psa_55,2D1
1000000US110010093012026,"Block 2026, Block Group 2, Census Tract 93.01, District of Columbia, District of Columbia",57,11,43,0,1,0,0,2,57,57,11,43,0,1,0,0,2,0,0,0,0,0,0,0,0,110010093012026,5,504,504,5,psa_43,5D2
1000000US110010102001006,"Block 1006, Block Group 1, Census Tract 102, District of Columbia, District of Columbia",0,0,0,0,0,0,0,0,0,0,0,0,0,0,0,0,0,0,0,0,0,0,0,0,0,110010102001006,1,103,103,1,psa_12,1D1
1000000US110010109002028,"Block 2028, Block Group 2, Census Tract 109, District of Columbia, District of Columbia",0,0,0,0,0,0,0,0,0,0,0,0,0,0,0,0,0,0,0,0,0,0,0,0,0,110010109002028,7,708,708,7,psa_1,7D3
1000000US110010001004018,"Block 4018, Block Group 4, Census Tract 1, District of Columbia, District of Columbia",0,0,0,0,0,0,0,0,0,0,0,0,0,0,0,0,0,0,0,0,0,0,0,0,0,110010001004018,2,206,206,2,psa_29,2D2
1000000US110010076013004,"Block 3004, Block Group 3, Census Tract 76.01, District of Columbia, District of Columbia",40,0,40,0,0,0,0,0,40,40,0,40,0,0,0,0,0,0,0,0,0,0,0,0,0,110010076013004,6,607,607,6,psa_10,6D2
1000000US110010019013007,"Block 3007, Block Group 3, Census Tract 19.01, District of Columbia, District of Columbia",166,11,103,0,5,0,47,0,166,105,9,96,0,0,0,0,0,61,2,7,0,5,0,47,0,110010019013007,4,402,402,4,psa_53,4D1
1000000US110010038001003,"Block 1003, Block Group 1, Census Tract 38, District of Columbia, District of Columbia",312,238,10,2,32,0,7,23,312,222,170,8,1,32,0,0,11,90,68,2,1,0,0,7,12,110010038001003,3,303,303,3,psa_37,3D3
1000000US110010091021015,"Block 1015, Block Group 1, Census Tract 91.02, District of Columbia, District of Columbia",0,0,0,0,0,0,0,0,0,0,0,0,0,0,0,0,0,0,0,0,0,0,0,0,0,110010091021015,5,505,505,5,psa_34,5D2
1000000US110010077092007,"Block 2007, Block Group 2, Census Tract 77.09, District of Columbia, District of Columbia",16,2,14,0,0,0,0,0,16,16,2,14,0,0,0,0,0,0,0,0,0,0,0,0,0,110010077092007,6,605,605,6,psa_11,6D2
1000000US110010104001000,"Block 1000, Block Group 1, Census Tract 104, District of Columbia, District of Columbia",0,0,0,0,0,0,0,0,0,0,0,0,0,0,0,0,0,0,0,0,0,0,0,0,0,110010104001000,7,703,703,7,psa_8,7D1
1000000US110010013013000,"Block 3000, Block Group 3, Census Tract 13.01, District of Columbia, District of Columbia",40,25,10,0,5,0,0,0,40,36,21,10,0,5,0,0,0,4,4,0,0,0,0,0,0,110010013013000,2,203,203,2,psa_50,2D1
1000000US110010078081014,"Block 1014, Block Group 1, Census Tract 78.08, District of Columbia, District of Columbia",55,0,55,0,0,0,0,0,55,55,0,55,0,0,0,0,0,0,0,0,0,0,0,0,0,110010078081014,6,608,608,6,psa_19,6D1
1000000US110010005012003,"Block 2003, Block Group 2, Census Tract 5.01, District of Columbia, District of Columbia",4,2,1,0,0,0,1,0,4,3,2,1,0,0,0,0,0,1,0,0,0,0,0,1,0,110010005012003,2,204,204,2,psa_44,2D2
1000000US110010094004016,"Block 4016, Block Group 4, Census Tract 94, District of Columbia, District of Columbia",84,11,63,1,0,0,9,0,84,73,11,61,1,0,0,0,0,11,0,2,0,0,0,9,0,110010094004016,5,503,503,5,psa_45,5D2
1000000US110010099021006,"Block 1006, Block Group 1, Census Tract 99.02, District of Columbia, District of Columbia",0,0,0,0,0,0,0,0,0,0,0,0,0,0,0,0,0,0,0,0,0,0,0,0,0,110010099021006,6,605,605,6,psa_11,6D2
1000000US110010011001001,"Block 1001, Block Group 1, Census Tract 11, District of Columbia, District of Columbia",16,15,1,0,0,0,0,0,16,14,13,1,0,0,0,0,0,2,2,0,0,0,0,0,0,110010011001001,2,201,201,2,psa_55,2D1
1000000US110010059001038,"Block 1038, Block Group 1, Census Tract 59, District of Columbia, District of Columbia",0,0,0,0,0,0,0,0,0,0,0,0,0,0,0,0,0,0,0,0,0,0,0,0,0,110010059001038,1,102,102,1,psa_18,1D1
1000000US110010067003013,"Block 3013, Block Group 3, Census Tract 67, District of Columbia, District of Columbia",133,120,4,0,5,0,2,2,133,128,115,4,0,5,0,2,2,5,5,0,0,0,0,0,0,110010067003013,1,107,107,1,psa_16,1D2
1000000US110010076042029,"Block 2029, Block Group 2, Census Tract 76.04, District of Columbia, District of Columbia",75,6,66,1,0,0,0,2,75,72,3,66,1,0,0,0,2,3,3,0,0,0,0,0,0,110010076042029,6,606,606,6,psa_7,6D2
1000000US110010101001002,"Block 1002, Block Group 1, Census Tract 101, District of Columbia, District of Columbia",0,0,0,0,0,0,0,0,0,0,0,0,0,0,0,0,0,0,0,0,0,0,0,0,0,110010101001002,2,209,209,2,psa_57,2D3
1000000US110010032004002,"Block 4002, Block Group 4, Census Tract 32, District of Columbia, District of Columbia",176,64,88,0,6,0,11,7,176,157,58,87,0,6,0,0,6,19,6,1,0,0,0,11,1,110010032004002,4,409,409,4,psa_41,4D3
1000000US110010076032008,"Block 2008, Block Group 2, Census Tract 76.03, District of Columbia, District of Columbia",21,4,17,0,0,0,0,0,21,21,4,17,0,0,0,0,0,0,0,0,0,0,0,0,0,110010076032008,6,606,606,6,psa_7,6D2
1000000US110010102002001,"Block 2001, Block Group 2, Census Tract 102, District of Columbia, District of Columbia",0,0,0,0,0,0,0,0,0,0,0,0,0,0,0,0,0,0,0,0,0,0,0,0,0,110010102002001,1,103,103,1,psa_12,1D1
1000000US110010062021085,"Block 1085, Block Group 1, Census Tract 62.02, District of Columbia, District of Columbia",0,0,0,0,0,0,0,0,0,0,0,0,0,0,0,0,0,0,0,0,0,0,0,0,0,110010062021085,2,207,207,2,psa_24,2D3
1000000US110010073011023,"Block 1023, Block Group 1, Census Tract 73.01, District of Columbia, District of Columbia",0,0,0,0,0,0,0,0,0,0,0,0,0,0,0,0,0,0,0,0,0,0,0,0,0,110010073011023,7,703,703,7,psa_8,7D1
1000000US110010009013003,"Block 3003, Block Group 3, Census Tract 9.01, District of Columbia, District of Columbia",22,22,0,0,0,0,0,0,22,19,19,0,0,0,0,0,0,3,3,0,0,0,0,0,0,110010009013003,2,205,205,2,psa_46,2D2
1000000US110010024002000,"Block 2000, Block Group 2, Census Tract 24, District of Columbia, District of Columbia",140,15,100,1,8,0,8,8,140,128,14,100,1,8,0,0,5,12,1,0,0,0,0,8,3,110010024002000,4,407,407,4,psa_47,4D2
1000000US110010047021002,"Block 1002, Block Group 1, Census Tract 47.02, District of Columbia, District of Columbia",0,0,0,0,0,0,0,0,0,0,0,0,0,0,0,0,0,0,0,0,0,0,0,0,0,110010047021002,1,101,101,1,psa_20,1D1
1000000US110010094002018,"Block 2018, Block Group 2, Census Tract 94, District of Columbia, District of Columbia",240,20,174,1,2,0,21,22,240,196,12,171,1,2,0,0,10,44,8,3,0,0,0,21,12,110010094002018,5,504,504,5,psa_43,5D2
1000000US110010106001005,"Block 1005, Block Group 1, Census Tract 106, District of Columbia, District of Columbia",175,80,85,0,1,0,1,8,175,171,79,84,0,1,0,0,7,4,1,1,0,0,0,1,1,110010106001005,5,501,501,5,psa_35,5D1
1000000US110010010016006,"Block 6006, Block Group 6, Census Tract 10.01, District of Columbia, District of Columbia",0,0,0,0,0,0,0,0,0,0,0,0,0,0,0,0,0,0,0,0,0,0,0,0,0,110010010016006,2,202,202,2,psa_52,2D1
1000000US110010020012014,"Block 2014, Block Group 2, Census Tract 20.01, District of Columbia, District of Columbia",159,63,52,2,3,0,31,8,159,112,51,51,2,3,0,2,3,47,12,1,0,0,0,29,5,110010020012014,4,403,403,4,psa_51,4D1
1000000US110010110003001,"Block 3001, Block Group 3, Census Tract 110, District of Columbia, District of Columbia",289,173,86,5,15,0,2,8,289,276,166,83,5,14,0,1,7,13,7,3,0,1,0,1,1,110010110003001,1,103,103,1,psa_12,1D1
1000000US110010111002003,"Block 2003, Block Group 2, Census Tract 111, District of Columbia, District of Columbia",129,11,110,0,0,1,0,7,129,123,11,110,0,0,1,0,1,6,0,0,0,0,0,0,6,110010111002003,5,503,503,5,psa_45,5D2
1000000US110010018042004,"Block 2004, Block Group 2, Census Tract 18.04, District of Columbia, District of Columbia",21,0,21,0,0,0,0,0,21,21,0,21,0,0,0,0,0,0,0,0,0,0,0,0,0,110010018042004,4,402,402,4,psa_53,4D1
1000000US110010062021248,"Block 1248, Block Group 1, Census Tract 62.02, District of Columbia, District of Columbia",0,0,0,0,0,0,0,0,0,0,0,0,0,0,0,0,0,0,0,0,0,0,0,0,0,110010062021248,1,103,103,1,psa_12,1D1
1000000US110010076042017,"Block 2017, Block Group 2, Census Tract 76.04, District of Columbia, District of Columbia",0,0,0,0,0,0,0,0,0,0,0,0,0,0,0,0,0,0,0,0,0,0,0,0,0,110010076042017,6,606,606,6,psa_7,6D2
1000000US110010001003009,"Block 3009, Block Group 3, Census Tract 1, District of Columbia, District of Columbia",44,40,0,0,0,0,4,0,44,37,37,0,0,0,0,0,0,7,3,0,0,0,0,4,0,110010001003009,2,206,206,2,psa_29,2D2
1000000US110010001004037,"Block 4037, Block Group 4, Census Tract 1, District of Columbia, District of Columbia",138,113,2,0,15,0,4,4,138,131,106,2,0,15,0,4,4,7,7,0,0,0,0,0,0,110010001004037,2,206,206,2,psa_29,2D2
1000000US110010073043003,"Block 3003, Block Group 3, Census Tract 73.04, District of Columbia, District of Columbia",254,3,243,1,0,0,0,7,254,250,3,240,1,0,0,0,6,4,0,3,0,0,0,0,1,110010073043003,7,705,705,7,psa_3,7D2
1000000US110010077071003,"Block 1003, Block Group 1, Census Tract 77.07, District of Columbia, District of Columbia",95,4,91,0,0,0,0,0,95,95,4,91,0,0,0,0,0,0,0,0,0,0,0,0,0,110010077071003,6,604,604,6,psa_14,6D3
1000000US110010048011022,"Block 1022, Block Group 1, Census Tract 48.01, District of Columbia, District of Columbia",68,18,48,0,2,0,0,0,68,68,18,48,0,2,0,0,0,0,0,0,0,0,0,0,0,110010048011022,3,308,308,3,psa_27,3D2
1000000US110010093012023,"Block 2023, Block Group 2, Census Tract 93.01, District of Columbia, District of Columbia",94,20,69,0,1,0,0,4,94,90,19,66,0,1,0,0,4,4,1,3,0,0,0,0,0,110010093012023,5,504,504,5,psa_43,5D2
1000000US110010021022002,"Block 2002, Block Group 2, Census Tract 21.02, District of Columbia, District of Columbia",105,0,81,1,0,0,15,8,105,89,0,81,1,0,0,1,6,16,0,0,0,0,0,14,2,110010021022002,4,406,406,4,psa_54,4D2
1000000US110010088023002,"Block 3002, Block Group 3, Census Tract 88.02, District of Columbia, District of Columbia",206,18,181,5,0,0,0,2,206,200,18,176,4,0,0,0,2,6,0,5,1,0,0,0,0,110010088023002,5,506,506,5,psa_26,5D3
1000000US110010012001004,"Block 1004, Block Group 1, Census Tract 12, District of Columbia, District of Columbia",285,244,16,0,14,0,5,6,285,266,232,14,0,14,0,0,6,19,12,2,0,0,0,5,0,110010012001004,2,203,203,2,psa_50,2D1
1000000US110010105002008,"Block 2008, Block Group 2, Census Tract 105, District of Columbia, District of Columbia",0,0,0,0,0,0,0,0,0,0,0,0,0,0,0,0,0,0,0,0,0,0,0,0,0,110010105002008,1,103,103,1,psa_12,1D1
1000000US110010009022039,"Block 2039, Block Group 2, Census Tract 9.02, District of Columbia, District of Columbia",20,20,0,0,0,0,0,0,20,20,20,0,0,0,0,0,0,0,0,0,0,0,0,0,0,110010009022039,2,205,205,2,psa_46,2D2
1000000US110010016004020,"Block 4020, Block Group 4, Census Tract 16, District of Columbia, District of Columbia",24,4,20,0,0,0,0,0,24,23,3,20,0,0,0,0,0,1,1,0,0,0,0,0,0,110010016004020,4,401,401,4,psa_56,4D1
1000000US110010102002038,"Block 2038, Block Group 2, Census Tract 102, District of Columbia, District of Columbia",607,249,284,2,23,0,10,39,607,574,236,280,1,23,0,2,32,33,13,4,1,0,0,8,7,110010102002038,1,103,103,1,psa_12,1D1
1000000US110010071001033,"Block 1033, Block Group 1, Census Tract 71, District of Columbia, District of Columbia",0,0,0,0,0,0,0,0,0,0,0,0,0,0,0,0,0,0,0,0,0,0,0,0,0,110010071001033,1,106,106,1,psa_13,1D3
1000000US110010074092004,"Block 2004, Block Group 2, Census Tract 74.09, District of Columbia, District of Columbia",177,2,169,0,0,0,4,2,177,168,2,165,0,0,0,0,1,9,0,4,0,0,0,4,1,110010074092004,7,704,704,7,psa_5,7D2
1000000US110010095041013,"Block 1013, Block Group 1, Census Tract 95.04, District of Columbia, District of Columbia",0,0,0,0,0,0,0,0,0,0,0,0,0,0,0,0,0,0,0,0,0,0,0,0,0,110010095041013,5,504,504,5,psa_43,5D2
1000000US110010073011125,"Block 1125, Block Group 1, Census Tract 73.01, District of Columbia, District of Columbia",0,0,0,0,0,0,0,0,0,0,0,0,0,0,0,0,0,0,0,0,0,0,0,0,0,110010073011125,7,703,703,7,psa_8,7D1
1000000US110010074011024,"Block 1024, Block Group 1, Census Tract 74.01, District of Columbia, District of Columbia",0,0,0,0,0,0,0,0,0,0,0,0,0,0,0,0,0,0,0,0,0,0,0,0,0,110010074011024,7,703,703,7,psa_8,7D1
1000000US110010093011005,"Block 1005, Block Group 1, Census Tract 93.01, District of Columbia, District of Columbia",59,1,56,0,1,0,0,1,59,59,1,56,0,1,0,0,1,0,0,0,0,0,0,0,0,110010093011005,5,504,504,5,psa_43,5D2
1000000US110010034002018,"Block 2018, Block Group 2, Census Tract 34, District of Columbia, District of Columbia",46,17,25,0,1,0,1,2,46,43,16,25,0,0,0,0,2,3,1,0,0,1,0,1,0,110010034002018,3,306,306,3,psa_38,3D2
1000000US110010068021005,"Block 1005, Block Group 1, Census Tract 68.02, District of Columbia, District of Columbia",131,83,43,0,2,0,1,2,131,125,79,42,0,2,0,0,2,6,4,1,0,0,0,1,0,110010068021005,1,107,107,1,psa_16,1D2
1000000US110010077081000,"Block 1000, Block Group 1, Census Tract 77.08, District of Columbia, District of Columbia",346,0,336,0,0,0,6,4,346,337,0,332,0,0,0,1,4,9,0,4,0,0,0,5,0,110010077081000,6,603,603,6,psa_15,6D3
1000000US110010090001008,"Block 1008, Block Group 1, Census Tract 90, District of Columbia, District of Columbia",0,0,0,0,0,0,0,0,0,0,0,0,0,0,0,0,0,0,0,0,0,0,0,0,0,110010090001008,5,503,503,5,psa_45,5D2
1000000US110010031001011,"Block 1011, Block Group 1, Census Tract 31, District of Columbia, District of Columbia",178,22,121,0,10,0,25,0,178,144,13,121,0,10,0,0,0,34,9,0,0,0,0,25,0,110010031001011,4,409,409,4,psa_41,4D3
1000000US110010056003000,"Block 3000, Block Group 3, Census Tract 56, District of Columbia, District of Columbia",695,583,43,2,25,0,0,42,695,693,582,43,1,25,0,0,42,2,1,0,1,0,0,0,0,110010056003000,2,207,207,2,psa_24,2D3
1000000US110010023011001,"Block 1001, Block Group 1, Census Tract 23.01, District of Columbia, District of Columbia",0,0,0,0,0,0,0,0,0,0,0,0,0,0,0,0,0,0,0,0,0,0,0,0,0,110010023011001,4,407,407,4,psa_47,4D2
1000000US110010023012015,"Block 2015, Block Group 2, Census Tract 23.01, District of Columbia, District of Columbia",72,14,57,0,0,0,1,0,72,63,6,57,0,0,0,0,0,9,8,0,0,0,0,1,0,110010023012015,4,407,407,4,psa_47,4D2
1000000US110010074012000,"Block 2000, Block Group 2, Census Tract 74.01, District of Columbia, District of Columbia",0,0,0,0,0,0,0,0,0,0,0,0,0,0,0,0,0,0,0,0,0,0,0,0,0,110010074012000,7,703,703,7,psa_8,7D1
1000000US110010076043007,"Block 3007, Block Group 3, Census Tract 76.04, District of Columbia, District of Columbia",65,0,65,0,0,0,0,0,65,64,0,64,0,0,0,0,0,1,0,1,0,0,0,0,0,110010076043007,6,607,607,6,psa_10,6D2
1000000US110010006004010,"Block 4010, Block Group 4, Census Tract 6, District of Columbia, District of Columbia",82,73,0,0,3,0,0,6,82,79,71,0,0,3,0,0,5,3,2,0,0,0,0,0,1,110010006004010,2,203,203,2,psa_50,2D1
1000000US110010016002002,"Block 2002, Block Group 2, Census Tract 16, District of Columbia, District of Columbia",51,20,28,0,0,0,0,3,51,49,18,28,0,0,0,0,3,2,2,0,0,0,0,0,0,110010016002002,4,401,401,4,psa_56,4D1
1000000US110010066001023,"Block 1023, Block Group 1, Census Tract 66, District of Columbia, District of Columbia",0,0,0,0,0,0,0,0,0,0,0,0,0,0,0,0,0,0,0,0,0,0,0,0,0,110010066001023,1,107,107,1,psa_16,1D2
1000000US110010106002025,"Block 2025, Block Group 2, Census Tract 106, District of Columbia, District of Columbia",0,0,0,0,0,0,0,0,0,0,0,0,0,0,0,0,0,0,0,0,0,0,0,0,0,110010106002025,5,501,501,5,psa_35,5D1
1000000US110010006004020,"Block 4020, Block Group 4, Census Tract 6, District of Columbia, District of Columbia",0,0,0,0,0,0,0,0,0,0,0,0,0,0,0,0,0,0,0,0,0,0,0,0,0,110010006004020,2,203,203,2,psa_50,2D1
1000000US110010010014020,"Block 4020, Block Group 4, Census Tract 10.01, District of Columbia, District of Columbia",0,0,0,0,0,0,0,0,0,0,0,0,0,0,0,0,0,0,0,0,0,0,0,0,0,110010010014020,2,202,202,2,psa_52,2D1
1000000US110010076015024,"Block 5024, Block Group 5, Census Tract 76.01, District of Columbia, District of Columbia",0,0,0,0,0,0,0,0,0,0,0,0,0,0,0,0,0,0,0,0,0,0,0,0,0,110010076015024,7,701,701,7,psa_9,7D1
1000000US110010062021236,"Block 1236, Block Group 1, Census Tract 62.02, District of Columbia, District of Columbia",0,0,0,0,0,0,0,0,0,0,0,0,0,0,0,0,0,0,0,0,0,0,0,0,0,110010062021236,2,207,207,2,psa_24,2D3
1000000US110010090002004,"Block 2004, Block Group 2, Census Tract 90, District of Columbia, District of Columbia",552,14,515,1,0,0,5,17,552,537,9,513,1,0,0,0,14,15,5,2,0,0,0,5,3,110010090002004,5,503,503,5,psa_45,5D2
1000000US110010096021012,"Block 1012, Block Group 1, Census Tract 96.02, District of Columbia, District of Columbia",0,0,0,0,0,0,0,0,0,0,0,0,0,0,0,0,0,0,0,0,0,0,0,0,0,110010096021012,6,601,601,6,psa_30,6D1
1000000US110010008013005,"Block 3005, Block Group 3, Census Tract 8.01, District of Columbia, District of Columbia",5,3,0,0,0,0,0,2,5,5,3,0,0,0,0,0,2,0,0,0,0,0,0,0,0,110010008013005,2,205,205,2,psa_46,2D2
1000000US110010018042008,"Block 2008, Block Group 2, Census Tract 18.04, District of Columbia, District of Columbia",40,13,9,0,0,0,16,2,40,11,4,6,0,0,0,1,0,29,9,3,0,0,0,15,2,110010018042008,4,402,402,4,psa_53,4D1
1000000US110010075031014,"Block 1014, Block Group 1, Census Tract 75.03, District of Columbia, District of Columbia",81,0,79,0,0,0,0,2,81,81,0,79,0,0,0,0,2,0,0,0,0,0,0,0,0,110010075031014,7,701,701,7,psa_9,7D1
1000000US110010011003005,"Block 3005, Block Group 3, Census Tract 11, District of Columbia, District of Columbia",0,0,0,0,0,0,0,0,0,0,0,0,0,0,0,0,0,0,0,0,0,0,0,0,0,110010011003005,2,201,201,2,psa_55,2D1
1000000US110010023021009,"Block 1009, Block Group 1, Census Tract 23.02, District of Columbia, District of Columbia",3,3,0,0,0,0,0,0,3,3,3,0,0,0,0,0,0,0,0,0,0,0,0,0,0,110010023021009,4,405,405,4,psa_49,4D2
1000000US110010037002004,"Block 2004, Block Group 2, Census Tract 37, District of Columbia, District of Columbia",1086,222,738,4,25,0,69,28,1086,953,178,725,2,24,0,4,20,133,44,13,2,1,0,65,8,110010037002004,3,304,304,3,psa_36,3D1
1000000US110010102002032,"Block 2032, Block Group 2, Census Tract 102, District of Columbia, District of Columbia",0,0,0,0,0,0,0,0,0,0,0,0,0,0,0,0,0,0,0,0,0,0,0,0,0,110010102002032,1,103,103,1,psa_12,1D1
1000000US110010002024016,"Block 4016, Block Group 4, Census Tract 2.02, District of Columbia, District of Columbia",0,0,0,0,0,0,0,0,0,0,0,0,0,0,0,0,0,0,0,0,0,0,0,0,0,110010002024016,2,206,206,2,psa_29,2D2
1000000US110010092032000,"Block 2000, Block Group 2, Census Tract 92.03, District of Columbia, District of Columbia",119,9,99,0,0,0,5,6,119,109,8,98,0,0,0,2,1,10,1,1,0,0,0,3,5,110010092032000,5,502,502,5,psa_40,5D1
1000000US110010071002009,"Block 2009, Block Group 2, Census Tract 71, District of Columbia, District of Columbia",41,25,14,0,2,0,0,0,41,38,23,14,0,1,0,0,0,3,2,0,0,1,0,0,0,110010071002009,1,106,106,1,psa_13,1D3
1000000US110010077091032,"Block 1032, Block Group 1, Census Tract 77.09, District of Columbia, District of Columbia",0,0,0,0,0,0,0,0,0,0,0,0,0,0,0,0,0,0,0,0,0,0,0,0,0,110010077091032,6,605,605,6,psa_11,6D2
1000000US110010093013019,"Block 3019, Block Group 3, Census Tract 93.01, District of Columbia, District of Columbia",0,0,0,0,0,0,0,0,0,0,0,0,0,0,0,0,0,0,0,0,0,0,0,0,0,110010093013019,5,504,504,5,psa_43,5D2
1000000US110010078071004,"Block 1004, Block Group 1, Census Tract 78.07, District of Columbia, District of Columbia",37,0,37,0,0,0,0,0,37,37,0,37,0,0,0,0,0,0,0,0,0,0,0,0,0,110010078071004,6,608,608,6,psa_19,6D1
1000000US110010032004009,"Block 4009, Block Group 4, Census Tract 32, District of Columbia, District of Columbia",0,0,0,0,0,0,0,0,0,0,0,0,0,0,0,0,0,0,0,0,0,0,0,0,0,110010032004009,3,306,306,3,psa_38,3D2
1000000US110010071001000,"Block 1000, Block Group 1, Census Tract 71, District of Columbia, District of Columbia",0,0,0,0,0,0,0,0,0,0,0,0,0,0,0,0,0,0,0,0,0,0,0,0,0,110010071001000,1,106,106,1,psa_13,1D3
1000000US110010044002007,"Block 2007, Block Group 2, Census Tract 44, District of Columbia, District of Columbia",53,40,7,0,3,0,1,2,53,50,38,7,0,3,0,0,2,3,2,0,0,0,0,1,0,110010044002007,3,305,305,3,psa_32,3D2
1000000US110010071001015,"Block 1015, Block Group 1, Census Tract 71, District of Columbia, District of Columbia",0,0,0,0,0,0,0,0,0,0,0,0,0,0,0,0,0,0,0,0,0,0,0,0,0,110010071001015,1,106,106,1,psa_13,1D3
1000000US110010072002008,"Block 2008, Block Group 2, Census Tract 72, District of Columbia, District of Columbia",0,0,0,0,0,0,0,0,0,0,0,0,0,0,0,0,0,0,0,0,0,0,0,0,0,110010072002008,1,106,106,1,psa_13,1D3
1000000US110010077082005,"Block 2005, Block Group 2, Census Tract 77.08, District of Columbia, District of Columbia",0,0,0,0,0,0,0,0,0,0,0,0,0,0,0,0,0,0,0,0,0,0,0,0,0,110010077082005,6,603,603,6,psa_15,6D3
1000000US110010002023005,"Block 3005, Block Group 3, Census Tract 2.02, District of Columbia, District of Columbia",87,83,0,0,3,0,1,0,87,83,80,0,0,3,0,0,0,4,3,0,0,0,0,1,0,110010002023005,2,206,206,2,psa_29,2D2
1000000US110010076015001,"Block 5001, Block Group 5, Census Tract 76.01, District of Columbia, District of Columbia",0,0,0,0,0,0,0,0,0,0,0,0,0,0,0,0,0,0,0,0,0,0,0,0,0,110010076015001,6,607,607,6,psa_10,6D2
1000000US110010096022000,"Block 2000, Block Group 2, Census Tract 96.02, District of Columbia, District of Columbia",0,0,0,0,0,0,0,0,0,0,0,0,0,0,0,0,0,0,0,0,0,0,0,0,0,110010096022000,6,601,601,6,psa_30,6D1
1000000US110010078092005,"Block 2005, Block Group 2, Census Tract 78.09, District of Columbia, District of Columbia",55,1,51,0,0,0,0,3,55,55,1,51,0,0,0,0,3,0,0,0,0,0,0,0,0,110010078092005,6,602,602,6,psa_25,6D1
1000000US110010106002041,"Block 2041, Block Group 2, Census Tract 106, District of Columbia, District of Columbia",0,0,0,0,0,0,0,0,0,0,0,0,0,0,0,0,0,0,0,0,0,0,0,0,0,110010106002041,1,102,102,1,psa_18,1D1
1000000US110010011003006,"Block 3006, Block Group 3, Census Tract 11, District of Columbia, District of Columbia",33,33,0,0,0,0,0,0,33,32,32,0,0,0,0,0,0,1,1,0,0,0,0,0,0,110010011003006,2,201,201,2,psa_55,2D1
1000000US110010048011023,"Block 1023, Block Group 1, Census Tract 48.01, District of Columbia, District of Columbia",67,30,32,0,0,0,0,5,67,65,29,31,0,0,0,0,5,2,1,1,0,0,0,0,0,110010048011023,3,308,308,3,psa_27,3D2
1000000US110010053012003,"Block 2003, Block Group 2, Census Tract 53.01, District of Columbia, District of Columbia",0,0,0,0,0,0,0,0,0,0,0,0,0,0,0,0,0,0,0,0,0,0,0,0,0,110010053012003,2,208,208,2,psa_33,2D3
1000000US110010072002065,"Block 2065, Block Group 2, Census Tract 72, District of Columbia, District of Columbia",0,0,0,0,0,0,0,0,0,0,0,0,0,0,0,0,0,0,0,0,0,0,0,0,0,110010072002065,1,106,106,1,psa_13,1D3
1000000US110010047012007,"Block 2007, Block Group 2, Census Tract 47.01, District of Columbia, District of Columbia",3,3,0,0,0,0,0,0,3,1,1,0,0,0,0,0,0,2,2,0,0,0,0,0,0,110010047012007,1,101,101,1,psa_20,1D1
1000000US110010013012007,"Block 2007, Block Group 2, Census Tract 13.01, District of Columbia, District of Columbia",36,29,0,0,2,0,0,5,36,31,24,0,0,2,0,0,5,5,5,0,0,0,0,0,0,110010013012007,2,203,203,2,psa_50,2D1
1000000US110010018043001,"Block 3001, Block Group 3, Census Tract 18.04, District of Columbia, District of Columbia",192,31,152,0,0,0,0,9,192,179,27,148,0,0,0,0,4,13,4,4,0,0,0,0,5,110010018043001,4,402,402,4,psa_53,4D1
1000000US110010098102002,"Block 2002, Block Group 2, Census Tract 98.10, District of Columbia, District of Columbia",363,0,358,1,1,0,0,3,363,361,0,356,1,1,0,0,3,2,0,2,0,0,0,0,0,110010098102002,7,708,708,7,psa_1,7D3
1000000US110010014011018,"Block 1018, Block Group 1, Census Tract 14.01, District of Columbia, District of Columbia",548,344,79,2,87,0,20,16,548,499,315,77,0,87,0,5,15,49,29,2,2,0,0,15,1,110010014011018,2,201,201,2,psa_55,2D1
1000000US110010072002040,"Block 2040, Block Group 2, Census Tract 72, District of Columbia, District of Columbia",14,9,3,0,2,0,0,0,14,13,8,3,0,2,0,0,0,1,1,0,0,0,0,0,0,110010072002040,1,106,106,1,psa_13,1D3
1000000US110010001004033,"Block 4033, Block Group 4, Census Tract 1, District of Columbia, District of Columbia",0,0,0,0,0,0,0,0,0,0,0,0,0,0,0,0,0,0,0,0,0,0,0,0,0,110010001004033,2,206,206,2,psa_29,2D2
1000000US110010077072018,"Block 2018, Block Group 2, Census Tract 77.07, District of Columbia, District of Columbia",36,0,36,0,0,0,0,0,36,36,0,36,0,0,0,0,0,0,0,0,0,0,0,0,0,110010077072018,6,604,604,6,psa_14,6D3
1000000US110010019021009,"Block 1009, Block Group 1, Census Tract 19.02, District of Columbia, District of Columbia",49,3,44,0,0,0,0,2,49,49,3,44,0,0,0,0,2,0,0,0,0,0,0,0,0,110010019021009,4,406,406,4,psa_54,4D2
1000000US110010106002037,"Block 2037, Block Group 2, Census Tract 106, District of Columbia, District of Columbia",0,0,0,0,0,0,0,0,0,0,0,0,0,0,0,0,0,0,0,0,0,0,0,0,0,110010106002037,5,501,501,5,psa_35,5D1
1000000US110010009022034,"Block 2034, Block Group 2, Census Tract 9.02, District of Columbia, District of Columbia",45,39,0,0,1,0,2,3,45,43,39,0,0,1,0,0,3,2,0,0,0,0,0,2,0,110010009022034,2,205,205,2,psa_46,2D2
1000000US110010096031003,"Block 1003, Block Group 1, Census Tract 96.03, District of Columbia, District of Columbia",50,1,47,0,0,0,0,2,50,50,1,47,0,0,0,0,2,0,0,0,0,0,0,0,0,110010096031003,6,603,603,6,psa_15,6D3
1000000US110010071001023,"Block 1023, Block Group 1, Census Tract 71, District of Columbia, District of Columbia",0,0,0,0,0,0,0,0,0,0,0,0,0,0,0,0,0,0,0,0,0,0,0,0,0,110010071001023,1,106,106,1,psa_13,1D3
1000000US110010028022002,"Block 2002, Block Group 2, Census Tract 28.02, District of Columbia, District of Columbia",303,122,123,0,15,1,15,27,303,243,91,119,0,15,0,0,18,60,31,4,0,0,1,15,9,110010028022002,3,302,302,3,psa_42,3D1
1000000US110010071002000,"Block 2000, Block Group 2, Census Tract 71, District of Columbia, District of Columbia",76,32,41,0,0,0,2,1,76,69,32,36,0,0,0,0,1,7,0,5,0,0,0,2,0,110010071002000,1,106,106,1,psa_13,1D3
1000000US110010072002017,"Block 2017, Block Group 2, Census Tract 72, District of Columbia, District of Columbia",0,0,0,0,0,0,0,0,0,0,0,0,0,0,0,0,0,0,0,0,0,0,0,0,0,110010072002017,1,106,106,1,psa_13,1D3
1000000US110010084101009,"Block 1009, Block Group 1, Census Tract 84.10, District of Columbia, District of Columbia",49,23,22,0,0,0,4,0,49,43,21,22,0,0,0,0,0,6,2,0,0,0,0,4,0,110010084101009,1,104,104,1,psa_21,1D2
1000000US110010001004023,"Block 4023, Block Group 4, Census Tract 1, District of Columbia, District of Columbia",52,47,1,0,4,0,0,0,52,49,44,1,0,4,0,0,0,3,3,0,0,0,0,0,0,110010001004023,2,206,206,2,psa_29,2D2
1000000US110010002023003,"Block 3003, Block Group 3, Census Tract 2.02, District of Columbia, District of Columbia",111,106,1,0,4,0,0,0,111,109,104,1,0,4,0,0,0,2,2,0,0,0,0,0,0,110010002023003,2,206,206,2,psa_29,2D2
1000000US110010070002015,"Block 2015, Block Group 2, Census Tract 70, District of Columbia, District of Columbia",14,12,2,0,0,0,0,0,14,14,12,2,0,0,0,0,0,0,0,0,0,0,0,0,0,110010070002015,1,106,106,1,psa_13,1D3
1000000US110010099032002,"Block 2002, Block Group 2, Census Tract 99.03, District of Columbia, District of Columbia",150,3,142,0,0,0,0,5,150,150,3,142,0,0,0,0,5,0,0,0,0,0,0,0,0,110010099032002,6,604,604,6,psa_14,6D3
1000000US110010016001001,"Block 1001, Block Group 1, Census Tract 16, District of Columbia, District of Columbia",34,7,27,0,0,0,0,0,34,34,7,27,0,0,0,0,0,0,0,0,0,0,0,0,0,110010016001001,4,401,401,4,psa_56,4D1
1000000US110010020022002,"Block 2002, Block Group 2, Census Tract 20.02, District of Columbia, District of Columbia",198,19,149,0,0,0,23,7,198,161,13,143,0,0,0,0,5,37,6,6,0,0,0,23,2,110010020022002,4,403,403,4,psa_51,4D1
1000000US110010056003003,"Block 3003, Block Group 3, Census Tract 56, District of Columbia, District of Columbia",0,0,0,0,0,0,0,0,0,0,0,0,0,0,0,0,0,0,0,0,0,0,0,0,0,110010056003003,2,207,207,2,psa_24,2D3
1000000US110010076013014,"Block 3014, Block Group 3, Census Tract 76.01, District of Columbia, District of Columbia",26,0,26,0,0,0,0,0,26,26,0,26,0,0,0,0,0,0,0,0,0,0,0,0,0,110010076013014,6,607,607,6,psa_10,6D2
1000000US110010033021005,"Block 1005, Block Group 1, Census Tract 33.02, District of Columbia, District of Columbia",161,43,105,1,0,0,0,12,161,158,43,102,1,0,0,0,12,3,0,3,0,0,0,0,0,110010033021005,3,308,308,3,psa_27,3D2
1000000US110010062021034,"Block 1034, Block Group 1, Census Tract 62.02, District of Columbia, District of Columbia",0,0,0,0,0,0,0,0,0,0,0,0,0,0,0,0,0,0,0,0,0,0,0,0,0,110010062021034,2,207,207,2,psa_24,2D3
1000000US110010020012015,"Block 2015, Block Group 2, Census Tract 20.01, District of Columbia, District of Columbia",0,0,0,0,0,0,0,0,0,0,0,0,0,0,0,0,0,0,0,0,0,0,0,0,0,110010020012015,4,403,403,4,psa_51,4D1
1000000US110010022012010,"Block 2010, Block Group 2, Census Tract 22.01, District of Columbia, District of Columbia",74,11,53,2,0,0,2,6,74,67,11,49,2,0,0,0,5,7,0,4,0,0,0,2,1,110010022012010,4,407,407,4,psa_47,4D2
1000000US110010073011112,"Block 1112, Block Group 1, Census Tract 73.01, District of Columbia, District of Columbia",0,0,0,0,0,0,0,0,0,0,0,0,0,0,0,0,0,0,0,0,0,0,0,0,0,110010073011112,7,708,708,7,psa_1,7D3
1000000US110010009011011,"Block 1011, Block Group 1, Census Tract 9.01, District of Columbia, District of Columbia",75,63,5,0,6,0,0,1,75,63,56,0,0,6,0,0,1,12,7,5,0,0,0,0,0,110010009011011,2,205,205,2,psa_46,2D2
1000000US110010055003004,"Block 3004, Block Group 3, Census Tract 55, District of Columbia, District of Columbia",180,138,11,1,23,0,0,7,180,170,130,11,1,23,0,0,5,10,8,0,0,0,0,0,2,110010055003004,2,207,207,2,psa_24,2D3
1000000US110010062021024,"Block 1024, Block Group 1, Census Tract 62.02, District of Columbia, District of Columbia",0,0,0,0,0,0,0,0,0,0,0,0,0,0,0,0,0,0,0,0,0,0,0,0,0,110010062021024,2,209,209,2,psa_57,2D3
1000000US110010073042006,"Block 2006, Block Group 2, Census Tract 73.04, District of Columbia, District of Columbia",133,1,128,1,0,0,0,3,133,132,1,128,0,0,0,0,3,1,0,0,1,0,0,0,0,110010073042006,7,705,705,7,psa_3,7D2
1000000US110010076015007,"Block 5007, Block Group 5, Census Tract 76.01, District of Columbia, District of Columbia",0,0,0,0,0,0,0,0,0,0,0,0,0,0,0,0,0,0,0,0,0,0,0,0,0,110010076015007,6,607,607,6,psa_10,6D2
1000000US110010018031005,"Block 1005, Block Group 1, Census Tract 18.03, District of Columbia, District of Columbia",347,41,248,1,4,7,37,9,347,274,12,246,1,4,7,0,4,73,29,2,0,0,0,37,5,110010018031005,4,402,402,4,psa_53,4D1
1000000US110010001004038,"Block 4038, Block Group 4, Census Tract 1, District of Columbia, District of Columbia",0,0,0,0,0,0,0,0,0,0,0,0,0,0,0,0,0,0,0,0,0,0,0,0,0,110010001004038,2,206,206,2,psa_29,2D2
1000000US110010010011009,"Block 1009, Block Group 1, Census Tract 10.01, District of Columbia, District of Columbia",25,20,3,0,1,0,0,1,25,24,20,3,0,1,0,0,0,1,0,0,0,0,0,0,1,110010010011009,2,202,202,2,psa_52,2D1
1000000US110010062021247,"Block 1247, Block Group 1, Census Tract 62.02, District of Columbia, District of Columbia",0,0,0,0,0,0,0,0,0,0,0,0,0,0,0,0,0,0,0,0,0,0,0,0,0,110010062021247,1,103,103,1,psa_12,1D1
1000000US110010082002006,"Block 2006, Block Group 2, Census Tract 82, District of Columbia, District of Columbia",0,0,0,0,0,0,0,0,0,0,0,0,0,0,0,0,0,0,0,0,0,0,0,0,0,110010082002006,1,102,102,1,psa_18,1D1
1000000US110010017022002,"Block 2002, Block Group 2, Census Tract 17.02, District of Columbia, District of Columbia",31,16,11,0,0,1,1,2,31,27,14,11,0,0,1,0,1,4,2,0,0,0,0,1,1,110010017022002,4,401,401,4,psa_56,4D1
1000000US110010093021007,"Block 1007, Block Group 1, Census Tract 93.02, District of Columbia, District of Columbia",70,10,48,3,0,0,5,4,70,59,8,48,0,0,0,0,3,11,2,0,3,0,0,5,1,110010093021007,5,504,504,5,psa_43,5D2
1000000US110010008013011,"Block 3011, Block Group 3, Census Tract 8.01, District of Columbia, District of Columbia",77,69,5,0,0,0,2,1,77,74,67,4,0,0,0,2,1,3,2,1,0,0,0,0,0,110010008013011,2,205,205,2,psa_46,2D2
1000000US110010095012001,"Block 2001, Block Group 2, Census Tract 95.01, District of Columbia, District of Columbia",0,0,0,0,0,0,0,0,0,0,0,0,0,0,0,0,0,0,0,0,0,0,0,0,0,110010095012001,4,405,405,4,psa_49,4D2
1000000US110010003001007,"Block 1007, Block Group 1, Census Tract 3, District of Columbia, District of Columbia",141,115,7,0,15,0,0,4,141,139,113,7,0,15,0,0,4,2,2,0,0,0,0,0,0,110010003001007,2,206,206,2,psa_29,2D2
1000000US110010062021165,"Block 1165, Block Group 1, Census Tract 62.02, District of Columbia, District of Columbia",0,0,0,0,0,0,0,0,0,0,0,0,0,0,0,0,0,0,0,0,0,0,0,0,0,110010062021165,1,103,103,1,psa_12,1D1
1000000US110010078043020,"Block 3020, Block Group 3, Census Tract 78.04, District of Columbia, District of Columbia",0,0,0,0,0,0,0,0,0,0,0,0,0,0,0,0,0,0,0,0,0,0,0,0,0,110010078043020,6,608,608,6,psa_19,6D1
1000000US110010001004007,"Block 4007, Block Group 4, Census Tract 1, District of Columbia, District of Columbia",52,51,0,0,1,0,0,0,52,51,50,0,0,1,0,0,0,1,1,0,0,0,0,0,0,110010001004007,2,206,206,2,psa_29,2D2
1000000US110010079014005,"Block 4005, Block Group 4, Census Tract 79.01, District of Columbia, District of Columbia",149,17,126,0,1,0,0,5,149,144,14,124,0,1,0,0,5,5,3,2,0,0,0,0,0,110010079014005,5,507,507,5,psa_23,5D3
1000000US110010095042001,"Block 2001, Block Group 2, Census Tract 95.04, District of Columbia, District of Columbia",546,82,445,0,11,0,1,7,546,541,80,444,0,11,0,0,6,5,2,1,0,0,0,1,1,110010095042001,4,405,405,4,psa_49,4D2
1000000US110010095091009,"Block 1009, Block Group 1, Census Tract 95.09, District of Columbia, District of Columbia",0,0,0,0,0,0,0,0,0,0,0,0,0,0,0,0,0,0,0,0,0,0,0,0,0,110010095091009,4,405,405,4,psa_49,4D2
1000000US110010025012005,"Block 2005, Block Group 2, Census Tract 25.01, District of Columbia, District of Columbia",104,39,54,0,0,0,9,2,104,89,31,54,0,0,0,4,0,15,8,0,0,0,0,5,2,110010025012005,4,404,404,4,psa_48,4D3
1000000US110010055004000,"Block 4000, Block Group 4, Census Tract 55, District of Columbia, District of Columbia",614,380,181,0,31,0,7,15,614,556,334,178,0,31,0,1,12,58,46,3,0,0,0,6,3,110010055004000,2,208,208,2,psa_33,2D3
1000000US110010021014009,"Block 4009, Block Group 4, Census Tract 21.01, District of Columbia, District of Columbia",117,21,75,2,0,0,18,1,117,75,4,69,2,0,0,0,0,42,17,6,0,0,0,18,1,110010021014009,4,403,403,4,psa_51,4D1
1000000US110010078062000,"Block 2000, Block Group 2, Census Tract 78.06, District of Columbia, District of Columbia",75,3,71,1,0,0,0,0,75,70,3,66,1,0,0,0,0,5,0,5,0,0,0,0,0,110010078062000,6,602,602,6,psa_25,6D1
1000000US110010078041005,"Block 1005, Block Group 1, Census Tract 78.04, District of Columbia, District of Columbia",32,0,32,0,0,0,0,0,32,32,0,32,0,0,0,0,0,0,0,0,0,0,0,0,0,110010078041005,6,602,602,6,psa_25,6D1
1000000US110010022021006,"Block 1006, Block Group 1, Census Tract 22.02, District of Columbia, District of Columbia",156,16,112,1,3,0,20,4,156,136,16,112,1,3,0,0,4,20,0,0,0,0,0,20,0,110010022021006,4,407,407,4,psa_47,4D2
1000000US110010095081005,"Block 1005, Block Group 1, Census Tract 95.08, District of Columbia, District of Columbia",79,0,77,0,0,0,0,2,79,79,0,77,0,0,0,0,2,0,0,0,0,0,0,0,0,110010095081005,4,406,406,4,psa_54,4D2
1000000US110010049022003,"Block 2003, Block Group 2, Census Tract 49.02, District of Columbia, District of Columbia",0,0,0,0,0,0,0,0,0,0,0,0,0,0,0,0,0,0,0,0,0,0,0,0,0,110010049022003,3,307,307,3,psa_28,3D3
1000000US110010023021020,"Block 1020, Block Group 1, Census Tract 23.02, District of Columbia, District of Columbia",0,0,0,0,0,0,0,0,0,0,0,0,0,0,0,0,0,0,0,0,0,0,0,0,0,110010023021020,4,405,405,4,psa_49,4D2
1000000US110010011002006,"Block 2006, Block Group 2, Census Tract 11, District of Columbia, District of Columbia",51,45,5,1,0,0,0,0,51,43,38,5,0,0,0,0,0,8,7,0,1,0,0,0,0,110010011002006,2,202,202,2,psa_52,2D1
1000000US110010064002001,"Block 2001, Block Group 2, Census Tract 64, District of Columbia, District of Columbia",50,20,27,0,0,0,1,2,50,47,18,26,0,0,0,1,2,3,2,1,0,0,0,0,0,110010064002001,1,105,105,1,psa_22,1D3
1000000US110010104002018,"Block 2018, Block Group 2, Census Tract 104, District of Columbia, District of Columbia",313,6,295,0,5,0,0,7,313,305,4,289,0,5,0,0,7,8,2,6,0,0,0,0,0,110010104002018,7,707,707,7,psa_4,7D2
1000000US110010078061011,"Block 1011, Block Group 1, Census Tract 78.06, District of Columbia, District of Columbia",71,0,69,0,2,0,0,0,71,71,0,69,0,2,0,0,0,0,0,0,0,0,0,0,0,110010078061011,6,602,602,6,psa_25,6D1
1000000US110010012002008,"Block 2008, Block Group 2, Census Tract 12, District of Columbia, District of Columbia",335,274,11,2,33,0,4,11,335,303,246,11,2,33,0,0,11,32,28,0,0,0,0,4,0,110010012002008,2,203,203,2,psa_50,2D1
1000000US110010020021006,"Block 1006, Block Group 1, Census Tract 20.02, District of Columbia, District of Columbia",2,2,0,0,0,0,0,0,2,2,2,0,0,0,0,0,0,0,0,0,0,0,0,0,0,110010020021006,4,404,404,4,psa_48,4D3
1000000US110010028021006,"Block 1006, Block Group 1, Census Tract 28.02, District of Columbia, District of Columbia",0,0,0,0,0,0,0,0,0,0,0,0,0,0,0,0,0,0,0,0,0,0,0,0,0,110010028021006,3,302,302,3,psa_42,3D1
1000000US110010039002006,"Block 2006, Block Group 2, Census Tract 39, District of Columbia, District of Columbia",0,0,0,0,0,0,0,0,0,0,0,0,0,0,0,0,0,0,0,0,0,0,0,0,0,110010039002006,3,303,303,3,psa_37,3D3
1000000US110010011004022,"Block 4022, Block Group 4, Census Tract 11, District of Columbia, District of Columbia",0,0,0,0,0,0,0,0,0,0,0,0,0,0,0,0,0,0,0,0,0,0,0,0,0,110010011004022,2,202,202,2,psa_52,2D1
1000000US110010035002005,"Block 2005, Block Group 2, Census Tract 35, District of Columbia, District of Columbia",767,20,670,3,45,0,4,25,767,750,17,659,3,45,0,3,23,17,3,11,0,0,0,1,2,110010035002005,3,305,305,3,psa_32,3D2
1000000US110010062021241,"Block 1241, Block Group 1, Census Tract 62.02, District of Columbia, District of Columbia",0,0,0,0,0,0,0,0,0,0,0,0,0,0,0,0,0,0,0,0,0,0,0,0,0,110010062021241,2,207,207,2,psa_24,2D3
1000000US110010021024002,"Block 4002, Block Group 4, Census Tract 21.02, District of Columbia, District of Columbia",0,0,0,0,0,0,0,0,0,0,0,0,0,0,0,0,0,0,0,0,0,0,0,0,0,110010021024002,4,403,403,4,psa_51,4D1
1000000US110010079012004,"Block 2004, Block Group 2, Census Tract 79.01, District of Columbia, District of Columbia",125,25,89,3,4,0,0,4,125,122,25,89,0,4,0,0,4,3,0,0,3,0,0,0,0,110010079012004,5,507,507,5,psa_23,5D3
1000000US110010026002019,"Block 2019, Block Group 2, Census Tract 26, District of Columbia, District of Columbia",4,0,4,0,0,0,0,0,4,4,0,4,0,0,0,0,0,0,0,0,0,0,0,0,0,110010026002019,4,404,404,4,psa_48,4D3
1000000US110010098072001,"Block 2001, Block Group 2, Census Tract 98.07, District of Columbia, District of Columbia",252,7,234,1,3,0,3,4,252,245,7,232,0,3,0,0,3,7,0,2,1,0,0,3,1,110010098072001,7,708,708,7,psa_1,7D3
1000000US110010030002003,"Block 2003, Block Group 2, Census Tract 30, District of Columbia, District of Columbia",397,209,132,0,11,0,25,20,397,347,192,131,0,10,0,1,13,50,17,1,0,1,0,24,7,110010030002003,3,302,302,3,psa_42,3D1
1000000US110010062021155,"Block 1155, Block Group 1, Census Tract 62.02, District of Columbia, District of Columbia",4,4,0,0,0,0,0,0,4,4,4,0,0,0,0,0,0,0,0,0,0,0,0,0,0,110010062021155,1,103,103,1,psa_12,1D1
1000000US110010081002003,"Block 2003, Block Group 2, Census Tract 81, District of Columbia, District of Columbia",140,93,21,0,5,0,18,3,140,121,93,21,0,4,0,0,3,19,0,0,0,1,0,18,0,110010081002003,1,108,108,1,psa_17,1D2
1000000US110010099012008,"Block 2008, Block Group 2, Census Tract 99.01, District of Columbia, District of Columbia",82,4,77,0,0,0,0,1,82,82,4,77,0,0,0,0,1,0,0,0,0,0,0,0,0,110010099012008,6,605,605,6,psa_11,6D2
1000000US110010106002006,"Block 2006, Block Group 2, Census Tract 106, District of Columbia, District of Columbia",0,0,0,0,0,0,0,0,0,0,0,0,0,0,0,0,0,0,0,0,0,0,0,0,0,110010106002006,5,501,501,5,psa_35,5D1
1000000US110010106002043,"Block 2043, Block Group 2, Census Tract 106, District of Columbia, District of Columbia",63,25,36,0,1,0,0,1,63,62,24,36,0,1,0,0,1,1,1,0,0,0,0,0,0,110010106002043,5,501,501,5,psa_35,5D1
1000000US110010010011012,"Block 1012, Block Group 1, Census Tract 10.01, District of Columbia, District of Columbia",32,31,0,0,1,0,0,0,32,31,30,0,0,1,0,0,0,1,1,0,0,0,0,0,0,110010010011012,2,202,202,2,psa_52,2D1
1000000US110010026002029,"Block 2029, Block Group 2, Census Tract 26, District of Columbia, District of Columbia",70,36,29,0,0,0,1,4,70,67,35,29,0,0,0,0,3,3,1,0,0,0,0,1,1,110010026002029,4,404,404,4,psa_48,4D3
1000000US110010077072013,"Block 2013, Block Group 2, Census Tract 77.07, District of Columbia, District of Columbia",73,1,67,0,0,0,0,5,73,72,1,67,0,0,0,0,4,1,0,0,0,0,0,0,1,110010077072013,6,605,605,6,psa_11,6D2
1000000US110010021013000,"Block 3000, Block Group 3, Census Tract 21.01, District of Columbia, District of Columbia",200,17,149,0,0,0,20,14,200,157,11,140,0,0,0,0,6,43,6,9,0,0,0,20,8,110010021013000,4,403,403,4,psa_51,4D1
1000000US110010094001018,"Block 1018, Block Group 1, Census Tract 94, District of Columbia, District of Columbia",41,0,40,0,1,0,0,0,41,41,0,40,0,1,0,0,0,0,0,0,0,0,0,0,0,110010094001018,5,503,503,5,psa_45,5D2
1000000US110010019021007,"Block 1007, Block Group 1, Census Tract 19.02, District of Columbia, District of Columbia",67,16,42,0,0,0,8,1,67,56,13,42,0,0,0,0,1,11,3,0,0,0,0,8,0,110010019021007,4,406,406,4,psa_54,4D2
1000000US110010088023000,"Block 3000, Block Group 3, Census Tract 88.02, District of Columbia, District of Columbia",260,29,217,1,2,0,0,11,260,258,28,217,0,2,0,0,11,2,1,0,1,0,0,0,0,110010088023000,5,506,506,5,psa_26,5D3
1000000US110010095051003,"Block 1003, Block Group 1, Census Tract 95.05, District of Columbia, District of Columbia",71,14,57,0,0,0,0,0,71,64,8,56,0,0,0,0,0,7,6,1,0,0,0,0,0,110010095051003,4,406,406,4,psa_54,4D2
1000000US110010010014025,"Block 4025, Block Group 4, Census Tract 10.01, District of Columbia, District of Columbia",33,29,2,0,0,0,0,2,33,29,25,2,0,0,0,0,2,4,4,0,0,0,0,0,0,110010010014025,2,202,202,2,psa_52,2D1
1000000US110010007011003,"Block 1003, Block Group 1, Census Tract 7.01, District of Columbia, District of Columbia",52,45,0,0,0,0,0,7,52,44,41,0,0,0,0,0,3,8,4,0,0,0,0,0,4,110010007011003,2,204,204,2,psa_44,2D2
1000000US110010034002025,"Block 2025, Block Group 2, Census Tract 34, District of Columbia, District of Columbia",102,10,77,8,0,0,1,6,102,91,9,75,1,0,0,0,6,11,1,2,7,0,0,1,0,110010034002025,3,306,306,3,psa_38,3D2
1000000US110010018042003,"Block 2003, Block Group 2, Census Tract 18.04, District of Columbia, District of Columbia",84,16,61,0,0,0,0,7,84,76,10,59,0,0,0,0,7,8,6,2,0,0,0,0,0,110010018042003,4,402,402,4,psa_53,4D1
1000000US110010058001000,"Block 1000, Block Group 1, Census Tract 58, District of Columbia, District of Columbia",0,0,0,0,0,0,0,0,0,0,0,0,0,0,0,0,0,0,0,0,0,0,0,0,0,110010058001000,1,101,101,1,psa_20,1D1
1000000US110010110002003,"Block 2003, Block Group 2, Census Tract 110, District of Columbia, District of Columbia",0,0,0,0,0,0,0,0,0,0,0,0,0,0,0,0,0,0,0,0,0,0,0,0,0,110010110002003,1,105,105,1,psa_22,1D3
1000000US110010062021095,"Block 1095, Block Group 1, Census Tract 62.02, District of Columbia, District of Columbia",0,0,0,0,0,0,0,0,0,0,0,0,0,0,0,0,0,0,0,0,0,0,0,0,0,110010062021095,2,207,207,2,psa_24,2D3
1000000US110010068041000,"Block 1000, Block Group 1, Census Tract 68.04, District of Columbia, District of Columbia",0,0,0,0,0,0,0,0,0,0,0,0,0,0,0,0,0,0,0,0,0,0,0,0,0,110010068041000,5,507,507,5,psa_23,5D3
1000000US110010109002029,"Block 2029, Block Group 2, Census Tract 109, District of Columbia, District of Columbia",0,0,0,0,0,0,0,0,0,0,0,0,0,0,0,0,0,0,0,0,0,0,0,0,0,110010109002029,7,708,708,7,psa_1,7D3
1000000US110010020021017,"Block 1017, Block Group 1, Census Tract 20.02, District of Columbia, District of Columbia",6,2,2,2,0,0,0,0,6,6,2,2,2,0,0,0,0,0,0,0,0,0,0,0,0,110010020021017,4,404,404,4,psa_48,4D3
1000000US110010062021006,"Block 1006, Block Group 1, Census Tract 62.02, District of Columbia, District of Columbia",0,0,0,0,0,0,0,0,0,0,0,0,0,0,0,0,0,0,0,0,0,0,0,0,0,110010062021006,1,102,102,1,psa_18,1D1
1000000US110010076042027,"Block 2027, Block Group 2, Census Tract 76.04, District of Columbia, District of Columbia",33,4,29,0,0,0,0,0,33,33,4,29,0,0,0,0,0,0,0,0,0,0,0,0,0,110010076042027,6,606,606,6,psa_7,6D2
1000000US110010022013000,"Block 3000, Block Group 3, Census Tract 22.01, District of Columbia, District of Columbia",37,5,30,0,1,0,0,1,37,34,3,30,0,1,0,0,0,3,2,0,0,0,0,0,1,110010022013000,4,407,407,4,psa_47,4D2
1000000US110010069001016,"Block 1016, Block Group 1, Census Tract 69, District of Columbia, District of Columbia",28,21,6,0,1,0,0,0,28,28,21,6,0,1,0,0,0,0,0,0,0,0,0,0,0,110010069001016,1,107,107,1,psa_16,1D2
1000000US110010072001007,"Block 1007, Block Group 1, Census Tract 72, District of Columbia, District of Columbia",0,0,0,0,0,0,0,0,0,0,0,0,0,0,0,0,0,0,0,0,0,0,0,0,0,110010072001007,1,106,106,1,psa_13,1D3
1000000US110010022023007,"Block 3007, Block Group 3, Census Tract 22.02, District of Columbia, District of Columbia",162,18,114,1,1,0,18,10,162,127,11,111,1,1,0,0,3,35,7,3,0,0,0,18,7,110010022023007,4,407,407,4,psa_47,4D2
1000000US110010110001002,"Block 1002, Block Group 1, Census Tract 110, District of Columbia, District of Columbia",517,29,423,7,8,1,29,20,517,482,27,416,7,8,1,4,19,35,2,7,0,0,0,25,1,110010110001002,1,105,105,1,psa_22,1D3
1000000US110010076042031,"Block 2031, Block Group 2, Census Tract 76.04, District of Columbia, District of Columbia",40,0,39,0,1,0,0,0,40,40,0,39,0,1,0,0,0,0,0,0,0,0,0,0,0,110010076042031,6,606,606,6,psa_7,6D2
1000000US110010082002015,"Block 2015, Block Group 2, Census Tract 82, District of Columbia, District of Columbia",106,93,8,0,3,0,1,1,106,100,90,7,0,3,0,0,0,6,3,1,0,0,0,1,1,110010082002015,1,108,108,1,psa_17,1D2
1000000US110010046002016,"Block 2016, Block Group 2, Census Tract 46, District of Columbia, District of Columbia",115,47,61,0,5,0,0,2,115,109,41,61,0,5,0,0,2,6,6,0,0,0,0,0,0,110010046002016,3,308,308,3,psa_27,3D2
1000000US110010053013003,"Block 3003, Block Group 3, Census Tract 53.01, District of Columbia, District of Columbia",0,0,0,0,0,0,0,0,0,0,0,0,0,0,0,0,0,0,0,0,0,0,0,0,0,110010053013003,2,208,208,2,psa_33,2D3
1000000US110010077072015,"Block 2015, Block Group 2, Census Tract 77.07, District of Columbia, District of Columbia",78,0,78,0,0,0,0,0,78,78,0,78,0,0,0,0,0,0,0,0,0,0,0,0,0,110010077072015,6,604,604,6,psa_14,6D3
1000000US110010031001003,"Block 1003, Block Group 1, Census Tract 31, District of Columbia, District of Columbia",168,39,96,0,7,0,21,5,168,130,26,95,0,7,0,0,2,38,13,1,0,0,0,21,3,110010031001003,4,409,409,4,psa_41,4D3
1000000US110010094003007,"Block 3007, Block Group 3, Census Tract 94, District of Columbia, District of Columbia",0,0,0,0,0,0,0,0,0,0,0,0,0,0,0,0,0,0,0,0,0,0,0,0,0,110010094003007,5,503,503,5,psa_45,5D2
1000000US110010023012004,"Block 2004, Block Group 2, Census Tract 23.01, District of Columbia, District of Columbia",0,0,0,0,0,0,0,0,0,0,0,0,0,0,0,0,0,0,0,0,0,0,0,0,0,110010023012004,4,407,407,4,psa_47,4D2
1000000US110010040011000,"Block 1000, Block Group 1, Census Tract 40.01, District of Columbia, District of Columbia",312,248,13,0,23,0,11,17,312,282,228,12,0,23,0,2,17,30,20,1,0,0,0,9,0,110010040011000,3,303,303,3,psa_37,3D3
1000000US110010048011001,"Block 1001, Block Group 1, Census Tract 48.01, District of Columbia, District of Columbia",96,51,27,0,3,0,11,4,96,79,46,27,0,3,0,0,3,17,5,0,0,0,0,11,1,110010048011001,3,306,306,3,psa_38,3D2
1000000US110010106002033,"Block 2033, Block Group 2, Census Tract 106, District of Columbia, District of Columbia",0,0,0,0,0,0,0,0,0,0,0,0,0,0,0,0,0,0,0,0,0,0,0,0,0,110010106002033,1,102,102,1,psa_18,1D1
1000000US110010006004000,"Block 4000, Block Group 4, Census Tract 6, District of Columbia, District of Columbia",155,127,8,1,15,0,0,4,155,149,121,8,1,15,0,0,4,6,6,0,0,0,0,0,0,110010006004000,2,203,203,2,psa_50,2D1
1000000US110010111003018,"Block 3018, Block Group 3, Census Tract 111, District of Columbia, District of Columbia",100,5,91,0,1,0,1,2,100,98,4,91,0,1,0,0,2,2,1,0,0,0,0,1,0,110010111003018,5,505,505,5,psa_34,5D2
1000000US110010066001024,"Block 1024, Block Group 1, Census Tract 66, District of Columbia, District of Columbia",0,0,0,0,0,0,0,0,0,0,0,0,0,0,0,0,0,0,0,0,0,0,0,0,0,110010066001024,1,107,107,1,psa_16,1D2
1000000US110010099012000,"Block 2000, Block Group 2, Census Tract 99.01, District of Columbia, District of Columbia",0,0,0,0,0,0,0,0,0,0,0,0,0,0,0,0,0,0,0,0,0,0,0,0,0,110010099012000,6,605,605,6,psa_11,6D2
1000000US110010031001017,"Block 1017, Block Group 1, Census Tract 31, District of Columbia, District of Columbia",203,66,108,0,12,0,0,17,203,178,51,108,0,12,0,0,7,25,15,0,0,0,0,0,10,110010031001017,3,304,304,3,psa_36,3D1
1000000US110010055001007,"Block 1007, Block Group 1, Census Tract 55, District of Columbia, District of Columbia",0,0,0,0,0,0,0,0,0,0,0,0,0,0,0,0,0,0,0,0,0,0,0,0,0,110010055001007,2,208,208,2,psa_33,2D3
1000000US110010089031011,"Block 1011, Block Group 1, Census Tract 89.03, District of Columbia, District of Columbia",109,0,107,0,0,0,1,1,109,108,0,107,0,0,0,0,1,1,0,0,0,0,0,1,0,110010089031011,5,507,507,5,psa_23,5D3
1000000US110010001003008,"Block 3008, Block Group 3, Census Tract 1, District of Columbia, District of Columbia",44,41,0,0,3,0,0,0,44,42,39,0,0,3,0,0,0,2,2,0,0,0,0,0,0,110010001003008,2,206,206,2,psa_29,2D2
1000000US110010009022031,"Block 2031, Block Group 2, Census Tract 9.02, District of Columbia, District of Columbia",37,31,0,0,2,0,0,4,37,35,29,0,0,2,0,0,4,2,2,0,0,0,0,0,0,110010009022031,2,205,205,2,psa_46,2D2
1000000US110010010014000,"Block 4000, Block Group 4, Census Tract 10.01, District of Columbia, District of Columbia",24,16,2,0,3,0,0,3,24,24,16,2,0,3,0,0,3,0,0,0,0,0,0,0,0,110010010014000,2,202,202,2,psa_52,2D1
1000000US110010033022006,"Block 2006, Block Group 2, Census Tract 33.02, District of Columbia, District of Columbia",0,0,0,0,0,0,0,0,0,0,0,0,0,0,0,0,0,0,0,0,0,0,0,0,0,110010033022006,3,308,308,3,psa_27,3D2
1000000US110010062021179,"Block 1179, Block Group 1, Census Tract 62.02, District of Columbia, District of Columbia",0,0,0,0,0,0,0,0,0,0,0,0,0,0,0,0,0,0,0,0,0,0,0,0,0,110010062021179,2,207,207,2,psa_24,2D3
1000000US110010014012014,"Block 2014, Block Group 2, Census Tract 14.01, District of Columbia, District of Columbia",72,65,0,0,3,0,1,3,72,71,64,0,0,3,0,1,3,1,1,0,0,0,0,0,0,110010014012014,2,201,201,2,psa_55,2D1
1000000US110010098031005,"Block 1005, Block Group 1, Census Tract 98.03, District of Columbia, District of Columbia",247,1,243,0,0,0,0,3,247,245,1,241,0,0,0,0,3,2,0,2,0,0,0,0,0,110010098031005,7,707,707,7,psa_4,7D2
1000000US110010099011007,"Block 1007, Block Group 1, Census Tract 99.01, District of Columbia, District of Columbia",28,0,28,0,0,0,0,0,28,28,0,28,0,0,0,0,0,0,0,0,0,0,0,0,0,110010099011007,6,605,605,6,psa_11,6D2
1000000US110010047021007,"Block 1007, Block Group 1, Census Tract 47.02, District of Columbia, District of Columbia",2,1,0,0,1,0,0,0,2,2,1,0,0,1,0,0,0,0,0,0,0,0,0,0,0,110010047021007,1,101,101,1,psa_20,1D1
1000000US110010109002042,"Block 2042, Block Group 2, Census Tract 109, District of Columbia, District of Columbia",0,0,0,0,0,0,0,0,0,0,0,0,0,0,0,0,0,0,0,0,0,0,0,0,0,110010109002042,7,708,708,7,psa_1,7D3
1000000US110010053013004,"Block 3004, Block Group 3, Census Tract 53.01, District of Columbia, District of Columbia",0,0,0,0,0,0,0,0,0,0,0,0,0,0,0,0,0,0,0,0,0,0,0,0,0,110010053013004,2,208,208,2,psa_33,2D3
1000000US110010073011042,"Block 1042, Block Group 1, Census Tract 73.01, District of Columbia, District of Columbia",19,14,3,0,0,0,0,2,19,17,12,3,0,0,0,0,2,2,2,0,0,0,0,0,0,110010073011042,7,707,707,7,psa_4,7D2
1000000US110010012001007,"Block 1007, Block Group 1, Census Tract 12, District of Columbia, District of Columbia",10,9,0,0,1,0,0,0,10,10,9,0,0,1,0,0,0,0,0,0,0,0,0,0,0,110010012001007,2,202,202,2,psa_52,2D1
1000000US110010020022003,"Block 2003, Block Group 2, Census Tract 20.02, District of Columbia, District of Columbia",237,56,80,0,0,7,44,50,237,96,8,79,0,0,0,0,9,141,48,1,0,0,7,44,41,110010020022003,4,403,403,4,psa_51,4D1
1000000US110010041003001,"Block 3001, Block Group 3, Census Tract 41, District of Columbia, District of Columbia",79,64,3,0,8,0,0,4,79,74,60,3,0,8,0,0,3,5,4,0,0,0,0,0,1,110010041003001,2,208,208,2,psa_33,2D3
1000000US110010010012029,"Block 2029, Block Group 2, Census Tract 10.01, District of Columbia, District of Columbia",65,57,0,4,4,0,0,0,65,57,53,0,0,4,0,0,0,8,4,0,4,0,0,0,0,110010010012029,2,202,202,2,psa_52,2D1
1000000US110010107001014,"Block 1014, Block Group 1, Census Tract 107, District of Columbia, District of Columbia",0,0,0,0,0,0,0,0,0,0,0,0,0,0,0,0,0,0,0,0,0,0,0,0,0,110010107001014,2,207,207,2,psa_24,2D3
1000000US110010020012008,"Block 2008, Block Group 2, Census Tract 20.01, District of Columbia, District of Columbia",66,24,42,0,0,0,0,0,66,66,24,42,0,0,0,0,0,0,0,0,0,0,0,0,0,110010020012008,4,403,403,4,psa_51,4D1
1000000US110010094003022,"Block 3022, Block Group 3, Census Tract 94, District of Columbia, District of Columbia",33,7,16,0,0,0,10,0,33,24,7,16,0,0,0,1,0,9,0,0,0,0,0,9,0,110010094003022,5,503,503,5,psa_45,5D2
1000000US110010006004005,"Block 4005, Block Group 4, Census Tract 6, District of Columbia, District of Columbia",92,75,2,0,5,0,2,8,92,84,72,1,0,5,0,0,6,8,3,1,0,0,0,2,2,110010006004005,2,203,203,2,psa_50,2D1
1000000US110010111002004,"Block 2004, Block Group 2, Census Tract 111, District of Columbia, District of Columbia",59,0,59,0,0,0,0,0,59,59,0,59,0,0,0,0,0,0,0,0,0,0,0,0,0,110010111002004,5,503,503,5,psa_45,5D2
1000000US110010073042002,"Block 2002, Block Group 2, Census Tract 73.04, District of Columbia, District of Columbia",50,6,43,0,0,0,0,1,50,50,6,43,0,0,0,0,1,0,0,0,0,0,0,0,0,110010073042002,7,705,705,7,psa_3,7D2
1000000US110010078072008,"Block 2008, Block Group 2, Census Tract 78.07, District of Columbia, District of Columbia",88,0,82,0,0,0,0,6,88,88,0,82,0,0,0,0,6,0,0,0,0,0,0,0,0,110010078072008,6,608,608,6,psa_19,6D1
1000000US110010043002002,"Block 2002, Block Group 2, Census Tract 43, District of Columbia, District of Columbia",178,148,14,0,7,0,3,6,178,168,140,14,0,7,0,1,6,10,8,0,0,0,0,2,0,110010043002002,3,301,301,3,psa_31,3D3
1000000US110010026002010,"Block 2010, Block Group 2, Census Tract 26, District of Columbia, District of Columbia",69,28,38,0,0,0,1,2,69,67,27,38,0,0,0,0,2,2,1,0,0,0,0,1,0,110010026002010,4,404,404,4,psa_48,4D3
1000000US110010095092007,"Block 2007, Block Group 2, Census Tract 95.09, District of Columbia, District of Columbia",73,7,60,0,0,0,5,1,73,68,7,60,0,0,0,0,1,5,0,0,0,0,0,5,0,110010095092007,4,405,405,4,psa_49,4D2
1000000US110010016004011,"Block 4011, Block Group 4, Census Tract 16, District of Columbia, District of Columbia",41,23,17,0,1,0,0,0,41,36,18,17,0,1,0,0,0,5,5,0,0,0,0,0,0,110010016004011,4,401,401,4,psa_56,4D1
1000000US110010104002040,"Block 2040, Block Group 2, Census Tract 104, District of Columbia, District of Columbia",157,2,150,0,0,0,0,5,157,155,1,150,0,0,0,0,4,2,1,0,0,0,0,0,1,110010104002040,7,707,707,7,psa_4,7D2
1000000US110010042021001,"Block 1001, Block Group 1, Census Tract 42.02, District of Columbia, District of Columbia",263,222,7,0,27,1,1,5,263,251,211,7,0,27,1,0,5,12,11,0,0,0,0,1,0,110010042021001,2,208,208,2,psa_33,2D3
1000000US110010017021003,"Block 1003, Block Group 1, Census Tract 17.02, District of Columbia, District of Columbia",4,2,2,0,0,0,0,0,4,4,2,2,0,0,0,0,0,0,0,0,0,0,0,0,0,110010017021003,4,401,401,4,psa_56,4D1
1000000US110010027021000,"Block 1000, Block Group 1, Census Tract 27.02, District of Columbia, District of Columbia",708,367,124,8,61,0,119,29,708,474,281,113,1,59,0,4,16,234,86,11,7,2,0,115,13,110010027021000,3,302,302,3,psa_42,3D1
1000000US110010047021015,"Block 1015, Block Group 1, Census Tract 47.02, District of Columbia, District of Columbia",0,0,0,0,0,0,0,0,0,0,0,0,0,0,0,0,0,0,0,0,0,0,0,0,0,110010047021015,1,101,101,1,psa_20,1D1
1000000US110010102002010,"Block 2010, Block Group 2, Census Tract 102, District of Columbia, District of Columbia",0,0,0,0,0,0,0,0,0,0,0,0,0,0,0,0,0,0,0,0,0,0,0,0,0,110010102002010,1,103,103,1,psa_12,1D1
1000000US110010019021000,"Block 1000, Block Group 1, Census Tract 19.02, District of Columbia, District of Columbia",18,5,8,0,0,0,0,5,18,9,1,8,0,0,0,0,0,9,4,0,0,0,0,0,5,110010019021000,4,406,406,4,psa_54,4D2
1000000US110010058001007,"Block 1007, Block Group 1, Census Tract 58, District of Columbia, District of Columbia",0,0,0,0,0,0,0,0,0,0,0,0,0,0,0,0,0,0,0,0,0,0,0,0,0,110010058001007,2,209,209,2,psa_57,2D3
1000000US110010076033009,"Block 3009, Block Group 3, Census Tract 76.03, District of Columbia, District of Columbia",47,0,47,0,0,0,0,0,47,47,0,47,0,0,0,0,0,0,0,0,0,0,0,0,0,110010076033009,6,606,606,6,psa_7,6D2
1000000US110010076043012,"Block 3012, Block Group 3, Census Tract 76.04, District of Columbia, District of Columbia",3,0,3,0,0,0,0,0,3,3,0,3,0,0,0,0,0,0,0,0,0,0,0,0,0,110010076043012,6,607,607,6,psa_10,6D2
1000000US110010046002003,"Block 2003, Block Group 2, Census Tract 46, District of Columbia, District of Columbia",114,64,44,0,2,0,0,4,114,105,57,42,0,2,0,0,4,9,7,2,0,0,0,0,0,110010046002003,3,308,308,3,psa_27,3D2
1000000US110010062021182,"Block 1182, Block Group 1, Census Tract 62.02, District of Columbia, District of Columbia",0,0,0,0,0,0,0,0,0,0,0,0,0,0,0,0,0,0,0,0,0,0,0,0,0,110010062021182,1,103,103,1,psa_12,1D1
1000000US110010068011003,"Block 1003, Block Group 1, Census Tract 68.01, District of Columbia, District of Columbia",167,56,107,0,2,0,2,0,167,165,55,107,0,2,0,1,0,2,1,0,0,0,0,1,0,110010068011003,1,107,107,1,psa_16,1D2
1000000US110010111003057,"Block 3057, Block Group 3, Census Tract 111, District of Columbia, District of Columbia",0,0,0,0,0,0,0,0,0,0,0,0,0,0,0,0,0,0,0,0,0,0,0,0,0,110010111003057,5,507,507,5,psa_23,5D3
1000000US110010062021212,"Block 1212, Block Group 1, Census Tract 62.02, District of Columbia, District of Columbia",0,0,0,0,0,0,0,0,0,0,0,0,0,0,0,0,0,0,0,0,0,0,0,0,0,110010062021212,1,103,103,1,psa_12,1D1
1000000US110010072001000,"Block 1000, Block Group 1, Census Tract 72, District of Columbia, District of Columbia",0,0,0,0,0,0,0,0,0,0,0,0,0,0,0,0,0,0,0,0,0,0,0,0,0,110010072001000,1,106,106,1,psa_13,1D3
1000000US110010098071004,"Block 1004, Block Group 1, Census Tract 98.07, District of Columbia, District of Columbia",80,3,77,0,0,0,0,0,80,80,3,77,0,0,0,0,0,0,0,0,0,0,0,0,0,110010098071004,7,708,708,7,psa_1,7D3
1000000US110010064002017,"Block 2017, Block Group 2, Census Tract 64, District of Columbia, District of Columbia",0,0,0,0,0,0,0,0,0,0,0,0,0,0,0,0,0,0,0,0,0,0,0,0,0,110010064002017,1,105,105,1,psa_22,1D3
1000000US110010023021027,"Block 1027, Block Group 1, Census Tract 23.02, District of Columbia, District of Columbia",0,0,0,0,0,0,0,0,0,0,0,0,0,0,0,0,0,0,0,0,0,0,0,0,0,110010023021027,4,405,405,4,psa_49,4D2
1000000US110010095033002,"Block 3002, Block Group 3, Census Tract 95.03, District of Columbia, District of Columbia",30,2,27,0,1,0,0,0,30,29,1,27,0,1,0,0,0,1,1,0,0,0,0,0,0,110010095033002,4,405,405,4,psa_49,4D2
1000000US110010095092003,"Block 2003, Block Group 2, Census Tract 95.09, District of Columbia, District of Columbia",45,0,44,0,0,0,1,0,45,44,0,44,0,0,0,0,0,1,0,0,0,0,0,1,0,110010095092003,4,405,405,4,psa_49,4D2
1000000US110010056002008,"Block 2008, Block Group 2, Census Tract 56, District of Columbia, District of Columbia",198,159,16,0,12,0,0,11,198,196,159,14,0,12,0,0,11,2,0,2,0,0,0,0,0,110010056002008,2,207,207,2,psa_24,2D3
1000000US110010096042007,"Block 2007, Block Group 2, Census Tract 96.04, District of Columbia, District of Columbia",99,2,87,0,0,0,10,0,99,87,0,87,0,0,0,0,0,12,2,0,0,0,0,10,0,110010096042007,6,603,603,6,psa_15,6D3
1000000US110010043002004,"Block 2004, Block Group 2, Census Tract 43, District of Columbia, District of Columbia",127,98,13,0,10,0,1,5,127,124,96,13,0,10,0,0,5,3,2,0,0,0,0,1,0,110010043002004,3,301,301,3,psa_31,3D3
1000000US110010092032007,"Block 2007, Block Group 2, Census Tract 92.03, District of Columbia, District of Columbia",66,12,53,0,0,0,1,0,66,65,12,53,0,0,0,0,0,1,0,0,0,0,0,1,0,110010092032007,5,502,502,5,psa_40,5D1
1000000US110010025022005,"Block 2005, Block Group 2, Census Tract 25.02, District of Columbia, District of Columbia",74,32,39,0,0,0,0,3,74,57,15,39,0,0,0,0,3,17,17,0,0,0,0,0,0,110010025022005,4,404,404,4,psa_48,4D3
1000000US110010080012006,"Block 2006, Block Group 2, Census Tract 80.01, District of Columbia, District of Columbia",66,28,33,2,2,0,0,1,66,64,28,32,1,2,0,0,1,2,0,1,1,0,0,0,0,110010080012006,1,108,108,1,psa_17,1D2
1000000US110010107002010,"Block 2010, Block Group 2, Census Tract 107, District of Columbia, District of Columbia",0,0,0,0,0,0,0,0,0,0,0,0,0,0,0,0,0,0,0,0,0,0,0,0,0,110010107002010,2,208,208,2,psa_33,2D3
1000000US110010078071006,"Block 1006, Block Group 1, Census Tract 78.07, District of Columbia, District of Columbia",16,0,16,0,0,0,0,0,16,16,0,16,0,0,0,0,0,0,0,0,0,0,0,0,0,110010078071006,6,608,608,6,psa_19,6D1
1000000US110010091021008,"Block 1008, Block Group 1, Census Tract 91.02, District of Columbia, District of Columbia",0,0,0,0,0,0,0,0,0,0,0,0,0,0,0,0,0,0,0,0,0,0,0,0,0,110010091021008,5,505,505,5,psa_34,5D2
1000000US110010056004005,"Block 4005, Block Group 4, Census Tract 56, District of Columbia, District of Columbia",0,0,0,0,0,0,0,0,0,0,0,0,0,0,0,0,0,0,0,0,0,0,0,0,0,110010056004005,2,207,207,2,psa_24,2D3
1000000US110010078061006,"Block 1006, Block Group 1, Census Tract 78.06, District of Columbia, District of Columbia",40,0,39,0,0,0,0,1,40,39,0,39,0,0,0,0,0,1,0,0,0,0,0,0,1,110010078061006,6,602,602,6,psa_25,6D1
1000000US110010106002001,"Block 2001, Block Group 2, Census Tract 106, District of Columbia, District of Columbia",0,0,0,0,0,0,0,0,0,0,0,0,0,0,0,0,0,0,0,0,0,0,0,0,0,110010106002001,5,501,501,5,psa_35,5D1
1000000US110010111003000,"Block 3000, Block Group 3, Census Tract 111, District of Columbia, District of Columbia",0,0,0,0,0,0,0,0,0,0,0,0,0,0,0,0,0,0,0,0,0,0,0,0,0,110010111003000,5,503,503,5,psa_45,5D2
1000000US110010098071012,"Block 1012, Block Group 1, Census Tract 98.07, District of Columbia, District of Columbia",112,1,109,0,1,0,0,1,112,112,1,109,0,1,0,0,1,0,0,0,0,0,0,0,0,110010098071012,7,708,708,7,psa_1,7D3
1000000US110010009012018,"Block 2018, Block Group 2, Census Tract 9.01, District of Columbia, District of Columbia",6,5,0,0,1,0,0,0,6,6,5,0,0,1,0,0,0,0,0,0,0,0,0,0,0,110010009012018,2,205,205,2,psa_46,2D2
1000000US110010108002021,"Block 2021, Block Group 2, Census Tract 108.00, District of Columbia, District of Columbia",0,0,0,0,0,0,0,0,0,0,0,0,0,0,0,0,0,0,0,0,0,0,0,0,0,110010108002021,2,207,207,2,psa_24,2D3
1000000US110010015002014,"Block 2014, Block Group 2, Census Tract 15, District of Columbia, District of Columbia",39,34,3,0,2,0,0,0,39,37,32,3,0,2,0,0,0,2,2,0,0,0,0,0,0,110010015002014,2,201,201,2,psa_55,2D1
1000000US110010103001010,"Block 1010, Block Group 1, Census Tract 103, District of Columbia, District of Columbia",0,0,0,0,0,0,0,0,0,0,0,0,0,0,0,0,0,0,0,0,0,0,0,0,0,110010103001010,4,401,401,4,psa_56,4D1
1000000US110010015003002,"Block 3002, Block Group 3, Census Tract 15, District of Columbia, District of Columbia",77,60,2,0,6,0,0,9,77,71,58,2,0,6,0,0,5,6,2,0,0,0,0,0,4,110010015003002,2,201,201,2,psa_55,2D1
1000000US110010059001016,"Block 1016, Block Group 1, Census Tract 59, District of Columbia, District of Columbia",0,0,0,0,0,0,0,0,0,0,0,0,0,0,0,0,0,0,0,0,0,0,0,0,0,110010059001016,1,102,102,1,psa_18,1D1
1000000US110010056001012,"Block 1012, Block Group 1, Census Tract 56, District of Columbia, District of Columbia",0,0,0,0,0,0,0,0,0,0,0,0,0,0,0,0,0,0,0,0,0,0,0,0,0,110010056001012,2,207,207,2,psa_24,2D3
1000000US110010062021125,"Block 1125, Block Group 1, Census Tract 62.02, District of Columbia, District of Columbia",0,0,0,0,0,0,0,0,0,0,0,0,0,0,0,0,0,0,0,0,0,0,0,0,0,110010062021125,1,102,102,1,psa_18,1D1
1000000US110010068011004,"Block 1004, Block Group 1, Census Tract 68.01, District of Columbia, District of Columbia",120,35,85,0,0,0,0,0,120,113,31,82,0,0,0,0,0,7,4,3,0,0,0,0,0,110010068011004,1,107,107,1,psa_16,1D2
1000000US110010058001015,"Block 1015, Block Group 1, Census Tract 58, District of Columbia, District of Columbia",0,0,0,0,0,0,0,0,0,0,0,0,0,0,0,0,0,0,0,0,0,0,0,0,0,110010058001015,1,101,101,1,psa_20,1D1
1000000US110010011004010,"Block 4010, Block Group 4, Census Tract 11, District of Columbia, District of Columbia",114,96,7,1,5,0,0,5,114,109,92,7,1,5,0,0,4,5,4,0,0,0,0,0,1,110010011004010,2,203,203,2,psa_50,2D1
1000000US110010083012013,"Block 2013, Block Group 2, Census Tract 83.01, District of Columbia, District of Columbia",0,0,0,0,0,0,0,0,0,0,0,0,0,0,0,0,0,0,0,0,0,0,0,0,0,110010083012013,1,108,108,1,psa_17,1D2
1000000US110010093012024,"Block 2024, Block Group 2, Census Tract 93.01, District of Columbia, District of Columbia",60,10,49,1,0,0,0,0,60,58,8,49,1,0,0,0,0,2,2,0,0,0,0,0,0,110010093012024,5,504,504,5,psa_43,5D2
1000000US110010047012003,"Block 2003, Block Group 2, Census Tract 47.01, District of Columbia, District of Columbia",0,0,0,0,0,0,0,0,0,0,0,0,0,0,0,0,0,0,0,0,0,0,0,0,0,110010047012003,1,102,102,1,psa_18,1D1
1000000US110010062021160,"Block 1160, Block Group 1, Census Tract 62.02, District of Columbia, District of Columbia",0,0,0,0,0,0,0,0,0,0,0,0,0,0,0,0,0,0,0,0,0,0,0,0,0,110010062021160,2,207,207,2,psa_24,2D3
1000000US110010008013030,"Block 3030, Block Group 3, Census Tract 8.01, District of Columbia, District of Columbia",43,40,1,0,0,0,0,2,43,42,39,1,0,0,0,0,2,1,1,0,0,0,0,0,0,110010008013030,2,205,205,2,psa_46,2D2
1000000US110010009022009,"Block 2009, Block Group 2, Census Tract 9.02, District of Columbia, District of Columbia",0,0,0,0,0,0,0,0,0,0,0,0,0,0,0,0,0,0,0,0,0,0,0,0,0,110010009022009,2,205,205,2,psa_46,2D2
1000000US110010028021000,"Block 1000, Block Group 1, Census Tract 28.02, District of Columbia, District of Columbia",680,371,83,8,22,1,135,60,680,395,269,80,1,22,1,0,22,285,102,3,7,0,0,135,38,110010028021000,3,302,302,3,psa_42,3D1
1000000US110010048011000,"Block 1000, Block Group 1, Census Tract 48.01, District of Columbia, District of Columbia",38,8,30,0,0,0,0,0,38,37,7,30,0,0,0,0,0,1,1,0,0,0,0,0,0,110010048011000,3,306,306,3,psa_38,3D2
1000000US110010076015005,"Block 5005, Block Group 5, Census Tract 76.01, District of Columbia, District of Columbia",0,0,0,0,0,0,0,0,0,0,0,0,0,0,0,0,0,0,0,0,0,0,0,0,0,110010076015005,7,701,701,7,psa_9,7D1
1000000US110010001002006,"Block 2006, Block Group 2, Census Tract 1, District of Columbia, District of Columbia",88,80,0,0,1,0,0,7,88,87,79,0,0,1,0,0,7,1,1,0,0,0,0,0,0,110010001002006,2,206,206,2,psa_29,2D2
1000000US110010018031000,"Block 1000, Block Group 1, Census Tract 18.03, District of Columbia, District of Columbia",176,22,137,0,1,0,10,6,176,145,11,130,0,1,0,0,3,31,11,7,0,0,0,10,3,110010018031000,4,401,401,4,psa_56,4D1
1000000US110010048011025,"Block 1025, Block Group 1, Census Tract 48.01, District of Columbia, District of Columbia",0,0,0,0,0,0,0,0,0,0,0,0,0,0,0,0,0,0,0,0,0,0,0,0,0,110010048011025,3,308,308,3,psa_27,3D2
1000000US110010072002019,"Block 2019, Block Group 2, Census Tract 72, District of Columbia, District of Columbia",0,0,0,0,0,0,0,0,0,0,0,0,0,0,0,0,0,0,0,0,0,0,0,0,0,110010072002019,1,106,106,1,psa_13,1D3
1000000US110010091021012,"Block 1012, Block Group 1, Census Tract 91.02, District of Columbia, District of Columbia",114,2,103,1,0,0,2,6,114,107,1,103,1,0,0,0,2,7,1,0,0,0,0,2,4,110010091021012,5,505,505,5,psa_34,5D2
1000000US110010004001016,"Block 1016, Block Group 1, Census Tract 4, District of Columbia, District of Columbia",33,32,1,0,0,0,0,0,33,28,27,1,0,0,0,0,0,5,5,0,0,0,0,0,0,110010004001016,2,204,204,2,psa_44,2D2
1000000US110010008013003,"Block 3003, Block Group 3, Census Tract 8.01, District of Columbia, District of Columbia",0,0,0,0,0,0,0,0,0,0,0,0,0,0,0,0,0,0,0,0,0,0,0,0,0,110010008013003,2,205,205,2,psa_46,2D2
1000000US110010055002007,"Block 2007, Block Group 2, Census Tract 55, District of Columbia, District of Columbia",0,0,0,0,0,0,0,0,0,0,0,0,0,0,0,0,0,0,0,0,0,0,0,0,0,110010055002007,2,206,206,2,psa_29,2D2
1000000US110010078083001,"Block 3001, Block Group 3, Census Tract 78.08, District of Columbia, District of Columbia",56,5,44,1,0,0,0,6,56,56,5,44,1,0,0,0,6,0,0,0,0,0,0,0,0,110010078083001,6,608,608,6,psa_19,6D1
1000000US110010099021008,"Block 1008, Block Group 1, Census Tract 99.02, District of Columbia, District of Columbia",195,2,186,2,0,0,4,1,195,194,2,186,2,0,0,3,1,1,0,0,0,0,0,1,0,110010099021008,6,605,605,6,psa_11,6D2
1000000US110010020021007,"Block 1007, Block Group 1, Census Tract 20.02, District of Columbia, District of Columbia",22,5,16,0,0,0,1,0,22,20,5,14,0,0,0,1,0,2,0,2,0,0,0,0,0,110010020021007,4,404,404,4,psa_48,4D3
1000000US110010102002015,"Block 2015, Block Group 2, Census Tract 102, District of Columbia, District of Columbia",0,0,0,0,0,0,0,0,0,0,0,0,0,0,0,0,0,0,0,0,0,0,0,0,0,110010102002015,1,103,103,1,psa_12,1D1
1000000US110010007023001,"Block 3001, Block Group 3, Census Tract 7.02, District of Columbia, District of Columbia",715,597,34,0,39,1,20,24,715,653,558,34,0,38,1,5,17,62,39,0,0,1,0,15,7,110010007023001,2,204,204,2,psa_44,2D2
1000000US110010073011124,"Block 1124, Block Group 1, Census Tract 73.01, District of Columbia, District of Columbia",0,0,0,0,0,0,0,0,0,0,0,0,0,0,0,0,0,0,0,0,0,0,0,0,0,110010073011124,7,708,708,7,psa_1,7D3
1000000US110010084021006,"Block 1006, Block Group 1, Census Tract 84.02, District of Columbia, District of Columbia",185,107,67,0,7,0,0,4,185,176,99,67,0,7,0,0,3,9,8,0,0,0,0,0,1,110010084021006,1,104,104,1,psa_21,1D2
1000000US110010048021002,"Block 1002, Block Group 1, Census Tract 48.02, District of Columbia, District of Columbia",59,34,19,0,6,0,0,0,59,57,32,19,0,6,0,0,0,2,2,0,0,0,0,0,0,110010048021002,3,308,308,3,psa_27,3D2
1000000US110010049022012,"Block 2012, Block Group 2, Census Tract 49.02, District of Columbia, District of Columbia",0,0,0,0,0,0,0,0,0,0,0,0,0,0,0,0,0,0,0,0,0,0,0,0,0,110010049022012,3,307,307,3,psa_28,3D3
1000000US110010096021029,"Block 1029, Block Group 1, Census Tract 96.02, District of Columbia, District of Columbia",0,0,0,0,0,0,0,0,0,0,0,0,0,0,0,0,0,0,0,0,0,0,0,0,0,110010096021029,6,601,601,6,psa_30,6D1
1000000US110010017022015,"Block 2015, Block Group 2, Census Tract 17.02, District of Columbia, District of Columbia",106,8,72,0,0,0,16,10,106,78,4,72,0,0,0,0,2,28,4,0,0,0,0,16,8,110010017022015,4,406,406,4,psa_54,4D2
1000000US110010028012007,"Block 2007, Block Group 2, Census Tract 28.01, District of Columbia, District of Columbia",145,51,39,1,19,0,27,8,145,96,34,37,1,19,0,2,3,49,17,2,0,0,0,25,5,110010028012007,4,408,408,4,psa_39,4D3
1000000US110010073011021,"Block 1021, Block Group 1, Census Tract 73.01, District of Columbia, District of Columbia",0,0,0,0,0,0,0,0,0,0,0,0,0,0,0,0,0,0,0,0,0,0,0,0,0,110010073011021,7,703,703,7,psa_8,7D1
1000000US110010022021007,"Block 1007, Block Group 1, Census Tract 22.02, District of Columbia, District of Columbia",100,5,79,0,0,0,16,0,100,81,2,79,0,0,0,0,0,19,3,0,0,0,0,16,0,110010022021007,4,407,407,4,psa_47,4D2
1000000US110010025012000,"Block 2000, Block Group 2, Census Tract 25.01, District of Columbia, District of Columbia",97,28,64,0,3,0,0,2,97,88,19,64,0,3,0,0,2,9,9,0,0,0,0,0,0,110010025012000,4,404,404,4,psa_48,4D3
1000000US110010076051002,"Block 1002, Block Group 1, Census Tract 76.05, District of Columbia, District of Columbia",53,0,53,0,0,0,0,0,53,53,0,53,0,0,0,0,0,0,0,0,0,0,0,0,0,110010076051002,6,607,607,6,psa_10,6D2
1000000US110010089041005,"Block 1005, Block Group 1, Census Tract 89.04, District of Columbia, District of Columbia",102,0,99,0,0,0,0,3,102,98,0,98,0,0,0,0,0,4,0,1,0,0,0,0,3,110010089041005,5,507,507,5,psa_23,5D3
1000000US110010111001001,"Block 1001, Block Group 1, Census Tract 111, District of Columbia, District of Columbia",106,11,87,2,0,0,0,6,106,106,11,87,2,0,0,0,6,0,0,0,0,0,0,0,0,110010111001001,5,503,503,5,psa_45,5D2
1000000US110010062021229,"Block 1229, Block Group 1, Census Tract 62.02, District of Columbia, District of Columbia",0,0,0,0,0,0,0,0,0,0,0,0,0,0,0,0,0,0,0,0,0,0,0,0,0,110010062021229,1,103,103,1,psa_12,1D1
1000000US110010078071000,"Block 1000, Block Group 1, Census Tract 78.07, District of Columbia, District of Columbia",163,4,149,0,0,0,9,1,163,150,3,146,0,0,0,0,1,13,1,3,0,0,0,9,0,110010078071000,6,608,608,6,psa_19,6D1
1000000US110010095041004,"Block 1004, Block Group 1, Census Tract 95.04, District of Columbia, District of Columbia",119,11,103,0,0,0,0,5,119,118,10,103,0,0,0,0,5,1,1,0,0,0,0,0,0,110010095041004,4,405,405,4,psa_49,4D2
1000000US110010093012003,"Block 2003, Block Group 2, Census Tract 93.01, District of Columbia, District of Columbia",0,0,0,0,0,0,0,0,0,0,0,0,0,0,0,0,0,0,0,0,0,0,0,0,0,110010093012003,5,504,504,5,psa_43,5D2
1000000US110010095033014,"Block 3014, Block Group 3, Census Tract 95.03, District of Columbia, District of Columbia",82,23,54,0,3,0,0,2,82,81,22,54,0,3,0,0,2,1,1,0,0,0,0,0,0,110010095033014,5,504,504,5,psa_43,5D2
1000000US110010073011057,"Block 1057, Block Group 1, Census Tract 73.01, District of Columbia, District of Columbia",0,0,0,0,0,0,0,0,0,0,0,0,0,0,0,0,0,0,0,0,0,0,0,0,0,110010073011057,7,708,708,7,psa_1,7D3
1000000US110010062021119,"Block 1119, Block Group 1, Census Tract 62.02, District of Columbia, District of Columbia",0,0,0,0,0,0,0,0,0,0,0,0,0,0,0,0,0,0,0,0,0,0,0,0,0,110010062021119,1,102,102,1,psa_18,1D1
1000000US110010078031010,"Block 1010, Block Group 1, Census Tract 78.03, District of Columbia, District of Columbia",109,0,107,0,1,0,1,0,109,108,0,107,0,1,0,0,0,1,0,0,0,0,0,1,0,110010078031010,6,602,602,6,psa_25,6D1
1000000US110010078032007,"Block 2007, Block Group 2, Census Tract 78.03, District of Columbia, District of Columbia",122,2,118,0,2,0,0,0,122,122,2,118,0,2,0,0,0,0,0,0,0,0,0,0,0,110010078032007,6,602,602,6,psa_25,6D1
1000000US110010008022010,"Block 2010, Block Group 2, Census Tract 8.02, District of Columbia, District of Columbia",118,103,0,0,12,0,0,3,118,113,99,0,0,12,0,0,2,5,4,0,0,0,0,0,1,110010008022010,2,205,205,2,psa_46,2D2
1000000US110010034002009,"Block 2009, Block Group 2, Census Tract 34, District of Columbia, District of Columbia",0,0,0,0,0,0,0,0,0,0,0,0,0,0,0,0,0,0,0,0,0,0,0,0,0,110010034002009,3,306,306,3,psa_38,3D2
1000000US110010072002023,"Block 2023, Block Group 2, Census Tract 72, District of Columbia, District of Columbia",0,0,0,0,0,0,0,0,0,0,0,0,0,0,0,0,0,0,0,0,0,0,0,0,0,110010072002023,1,106,106,1,psa_13,1D3
1000000US110010076042004,"Block 2004, Block Group 2, Census Tract 76.04, District of Columbia, District of Columbia",0,0,0,0,0,0,0,0,0,0,0,0,0,0,0,0,0,0,0,0,0,0,0,0,0,110010076042004,6,607,607,6,psa_10,6D2
1000000US110010110002006,"Block 2006, Block Group 2, Census Tract 110, District of Columbia, District of Columbia",0,0,0,0,0,0,0,0,0,0,0,0,0,0,0,0,0,0,0,0,0,0,0,0,0,110010110002006,1,105,105,1,psa_22,1D3
1000000US110010011002020,"Block 2020, Block Group 2, Census Tract 11, District of Columbia, District of Columbia",0,0,0,0,0,0,0,0,0,0,0,0,0,0,0,0,0,0,0,0,0,0,0,0,0,110010011002020,2,202,202,2,psa_52,2D1
1000000US110010064002007,"Block 2007, Block Group 2, Census Tract 64, District of Columbia, District of Columbia",0,0,0,0,0,0,0,0,0,0,0,0,0,0,0,0,0,0,0,0,0,0,0,0,0,110010064002007,1,105,105,1,psa_22,1D3
1000000US110010078082013,"Block 2013, Block Group 2, Census Tract 78.08, District of Columbia, District of Columbia",0,0,0,0,0,0,0,0,0,0,0,0,0,0,0,0,0,0,0,0,0,0,0,0,0,110010078082013,6,608,608,6,psa_19,6D1
1000000US110010079031010,"Block 1010, Block Group 1, Census Tract 79.03, District of Columbia, District of Columbia",52,2,50,0,0,0,0,0,52,52,2,50,0,0,0,0,0,0,0,0,0,0,0,0,0,110010079031010,5,507,507,5,psa_23,5D3
1000000US110010012003000,"Block 3000, Block Group 3, Census Tract 12, District of Columbia, District of Columbia",198,120,9,2,50,0,12,5,198,167,104,9,0,50,0,1,3,31,16,0,2,0,0,11,2,110010012003000,2,203,203,2,psa_50,2D1
1000000US110010103001001,"Block 1001, Block Group 1, Census Tract 103, District of Columbia, District of Columbia",0,0,0,0,0,0,0,0,0,0,0,0,0,0,0,0,0,0,0,0,0,0,0,0,0,110010103001001,4,401,401,4,psa_56,4D1
1000000US110010010022002,"Block 2002, Block Group 2, Census Tract 10.02, District of Columbia, District of Columbia",306,250,22,0,26,0,0,8,306,286,231,22,0,26,0,0,7,20,19,0,0,0,0,0,1,110010010022002,2,204,204,2,psa_44,2D2
1000000US110010094002006,"Block 2006, Block Group 2, Census Tract 94, District of Columbia, District of Columbia",0,0,0,0,0,0,0,0,0,0,0,0,0,0,0,0,0,0,0,0,0,0,0,0,0,110010094002006,5,504,504,5,psa_43,5D2
1000000US110010006003000,"Block 3000, Block Group 3, Census Tract 6, District of Columbia, District of Columbia",50,44,6,0,0,0,0,0,50,49,43,6,0,0,0,0,0,1,1,0,0,0,0,0,0,110010006003000,2,203,203,2,psa_50,2D1
1000000US110010012004023,"Block 4023, Block Group 4, Census Tract 12, District of Columbia, District of Columbia",79,71,2,0,3,0,2,1,79,73,67,2,0,3,0,0,1,6,4,0,0,0,0,2,0,110010012004023,2,202,202,2,psa_52,2D1
1000000US110010076053003,"Block 3003, Block Group 3, Census Tract 76.05, District of Columbia, District of Columbia",119,1,113,5,0,0,0,0,119,119,1,113,5,0,0,0,0,0,0,0,0,0,0,0,0,110010076053003,6,607,607,6,psa_10,6D2
1000000US110010064002014,"Block 2014, Block Group 2, Census Tract 64, District of Columbia, District of Columbia",0,0,0,0,0,0,0,0,0,0,0,0,0,0,0,0,0,0,0,0,0,0,0,0,0,110010064002014,1,105,105,1,psa_22,1D3
1000000US110010099061000,"Block 1000, Block Group 1, Census Tract 99.06, District of Columbia, District of Columbia",0,0,0,0,0,0,0,0,0,0,0,0,0,0,0,0,0,0,0,0,0,0,0,0,0,110010099061000,6,604,604,6,psa_14,6D3
1000000US110010103002001,"Block 2001, Block Group 2, Census Tract 103, District of Columbia, District of Columbia",201,13,132,0,2,0,40,14,201,155,4,132,0,2,0,8,9,46,9,0,0,0,0,32,5,110010103002001,4,401,401,4,psa_56,4D1
1000000US110010008021002,"Block 1002, Block Group 1, Census Tract 8.02, District of Columbia, District of Columbia",20,20,0,0,0,0,0,0,20,20,20,0,0,0,0,0,0,0,0,0,0,0,0,0,0,110010008021002,2,205,205,2,psa_46,2D2
1000000US110010082002005,"Block 2005, Block Group 2, Census Tract 82, District of Columbia, District of Columbia",7,7,0,0,0,0,0,0,7,5,5,0,0,0,0,0,0,2,2,0,0,0,0,0,0,110010082002005,1,108,108,1,psa_17,1D2
1000000US110010077071010,"Block 1010, Block Group 1, Census Tract 77.07, District of Columbia, District of Columbia",0,0,0,0,0,0,0,0,0,0,0,0,0,0,0,0,0,0,0,0,0,0,0,0,0,110010077071010,6,604,604,6,psa_14,6D3
1000000US110010025012010,"Block 2010, Block Group 2, Census Tract 25.01, District of Columbia, District of Columbia",137,44,72,2,4,0,9,6,137,111,30,72,1,4,0,0,4,26,14,0,1,0,0,9,2,110010025012010,4,404,404,4,psa_48,4D3
1000000US110010032004003,"Block 4003, Block Group 4, Census Tract 32, District of Columbia, District of Columbia",149,30,103,0,7,0,4,5,149,128,18,99,0,7,0,0,4,21,12,4,0,0,0,4,1,110010032004003,4,409,409,4,psa_41,4D3
1000000US110010062021159,"Block 1159, Block Group 1, Census Tract 62.02, District of Columbia, District of Columbia",0,0,0,0,0,0,0,0,0,0,0,0,0,0,0,0,0,0,0,0,0,0,0,0,0,110010062021159,2,207,207,2,psa_24,2D3
1000000US110010022013004,"Block 3004, Block Group 3, Census Tract 22.01, District of Columbia, District of Columbia",118,16,94,0,0,0,6,2,118,111,15,94,0,0,0,0,2,7,1,0,0,0,0,6,0,110010022013004,4,407,407,4,psa_47,4D2
1000000US110010011002023,"Block 2023, Block Group 2, Census Tract 11, District of Columbia, District of Columbia",30,26,0,0,1,0,3,0,30,26,25,0,0,1,0,0,0,4,1,0,0,0,0,3,0,110010011002023,2,202,202,2,psa_52,2D1
1000000US110010034001000,"Block 1000, Block Group 1, Census Tract 34, District of Columbia, District of Columbia",343,14,313,1,1,0,6,8,343,330,14,307,1,1,0,1,6,13,0,6,0,0,0,5,2,110010034001000,3,306,306,3,psa_38,3D2
1000000US110010009022015,"Block 2015, Block Group 2, Census Tract 9.02, District of Columbia, District of Columbia",0,0,0,0,0,0,0,0,0,0,0,0,0,0,0,0,0,0,0,0,0,0,0,0,0,110010009022015,2,205,205,2,psa_46,2D2
1000000US110010095083003,"Block 3003, Block Group 3, Census Tract 95.08, District of Columbia, District of Columbia",82,6,73,1,0,0,0,2,82,82,6,73,1,0,0,0,2,0,0,0,0,0,0,0,0,110010095083003,4,406,406,4,psa_54,4D2
1000000US110010064002003,"Block 2003, Block Group 2, Census Tract 64, District of Columbia, District of Columbia",152,17,118,2,0,0,9,6,152,139,16,117,2,0,0,0,4,13,1,1,0,0,0,9,2,110010064002003,1,105,105,1,psa_22,1D3
1000000US110010068011005,"Block 1005, Block Group 1, Census Tract 68.01, District of Columbia, District of Columbia",136,55,75,0,2,0,2,2,136,129,51,74,0,2,0,0,2,7,4,1,0,0,0,2,0,110010068011005,1,107,107,1,psa_16,1D2
1000000US110010008014008,"Block 4008, Block Group 4, Census Tract 8.01, District of Columbia, District of Columbia",0,0,0,0,0,0,0,0,0,0,0,0,0,0,0,0,0,0,0,0,0,0,0,0,0,110010008014008,2,205,205,2,psa_46,2D2
1000000US110010015005003,"Block 5003, Block Group 5, Census Tract 15, District of Columbia, District of Columbia",269,238,15,0,9,0,0,7,269,262,234,15,0,9,0,0,4,7,4,0,0,0,0,0,3,110010015005003,2,201,201,2,psa_55,2D1
1000000US110010055005002,"Block 5002, Block Group 5, Census Tract 55, District of Columbia, District of Columbia",121,104,5,0,9,0,0,3,121,117,100,5,0,9,0,0,3,4,4,0,0,0,0,0,0,110010055005002,2,208,208,2,psa_33,2D3
1000000US110010073011119,"Block 1119, Block Group 1, Census Tract 73.01, District of Columbia, District of Columbia",0,0,0,0,0,0,0,0,0,0,0,0,0,0,0,0,0,0,0,0,0,0,0,0,0,110010073011119,7,708,708,7,psa_1,7D3
1000000US110010095081008,"Block 1008, Block Group 1, Census Tract 95.08, District of Columbia, District of Columbia",332,33,250,4,8,0,37,0,332,261,7,246,0,8,0,0,0,71,26,4,4,0,0,37,0,110010095081008,4,405,405,4,psa_49,4D2
1000000US110010098111001,"Block 1001, Block Group 1, Census Tract 98.11, District of Columbia, District of Columbia",714,2,695,2,0,0,3,12,714,701,1,690,0,0,0,0,10,13,1,5,2,0,0,3,2,110010098111001,7,706,706,7,psa_2,7D3
1000000US110010111002013,"Block 2013, Block Group 2, Census Tract 111, District of Columbia, District of Columbia",17,6,11,0,0,0,0,0,17,17,6,11,0,0,0,0,0,0,0,0,0,0,0,0,0,110010111002013,5,503,503,5,psa_45,5D2
1000000US110010010016009,"Block 6009, Block Group 6, Census Tract 10.01, District of Columbia, District of Columbia",69,61,3,0,2,0,0,3,69,65,57,3,0,2,0,0,3,4,4,0,0,0,0,0,0,110010010016009,2,202,202,2,psa_52,2D1
1000000US110010022012013,"Block 2013, Block Group 2, Census Tract 22.01, District of Columbia, District of Columbia",0,0,0,0,0,0,0,0,0,0,0,0,0,0,0,0,0,0,0,0,0,0,0,0,0,110010022012013,4,407,407,4,psa_47,4D2
1000000US110010102002034,"Block 2034, Block Group 2, Census Tract 102, District of Columbia, District of Columbia",64,58,3,0,0,0,0,3,64,60,54,3,0,0,0,0,3,4,4,0,0,0,0,0,0,110010102002034,1,103,103,1,psa_12,1D1
1000000US110010016001022,"Block 1022, Block Group 1, Census Tract 16, District of Columbia, District of Columbia",41,6,34,0,0,0,0,1,41,41,6,34,0,0,0,0,1,0,0,0,0,0,0,0,0,110010016001022,4,401,401,4,psa_56,4D1
1000000US110010019011004,"Block 1004, Block Group 1, Census Tract 19.01, District of Columbia, District of Columbia",225,9,164,0,1,2,36,13,225,172,5,160,0,1,2,0,4,53,4,4,0,0,0,36,9,110010019011004,4,402,402,4,psa_53,4D1
1000000US110010008013013,"Block 3013, Block Group 3, Census Tract 8.01, District of Columbia, District of Columbia",32,30,0,0,2,0,0,0,32,30,28,0,0,2,0,0,0,2,2,0,0,0,0,0,0,110010008013013,2,205,205,2,psa_46,2D2
1000000US110010009012021,"Block 2021, Block Group 2, Census Tract 9.01, District of Columbia, District of Columbia",100,96,2,0,0,0,0,2,100,100,96,2,0,0,0,0,2,0,0,0,0,0,0,0,0,110010009012021,2,205,205,2,psa_46,2D2
1000000US110010095041025,"Block 1025, Block Group 1, Census Tract 95.04, District of Columbia, District of Columbia",0,0,0,0,0,0,0,0,0,0,0,0,0,0,0,0,0,0,0,0,0,0,0,0,0,110010095041025,5,504,504,5,psa_43,5D2
1000000US110010044002009,"Block 2009, Block Group 2, Census Tract 44, District of Columbia, District of Columbia",149,118,16,5,3,0,3,4,149,141,112,16,4,3,0,2,4,8,6,0,1,0,0,1,0,110010044002009,3,305,305,3,psa_32,3D2
1000000US110010021025001,"Block 5001, Block Group 5, Census Tract 21.02, District of Columbia, District of Columbia",20,4,13,0,0,0,3,0,20,17,4,13,0,0,0,0,0,3,0,0,0,0,0,3,0,110010021025001,4,403,403,4,psa_51,4D1
1000000US110010062021071,"Block 1071, Block Group 1, Census Tract 62.02, District of Columbia, District of Columbia",0,0,0,0,0,0,0,0,0,0,0,0,0,0,0,0,0,0,0,0,0,0,0,0,0,110010062021071,2,207,207,2,psa_24,2D3
1000000US110010067003010,"Block 3010, Block Group 3, Census Tract 67, District of Columbia, District of Columbia",39,32,3,0,0,0,0,4,39,38,31,3,0,0,0,0,4,1,1,0,0,0,0,0,0,110010067003010,1,107,107,1,psa_16,1D2
1000000US110010017021023,"Block 1023, Block Group 1, Census Tract 17.02, District of Columbia, District of Columbia",21,1,19,0,0,0,0,1,21,20,1,19,0,0,0,0,0,1,0,0,0,0,0,0,1,110010017021023,4,401,401,4,psa_56,4D1
1000000US110010038001000,"Block 1000, Block Group 1, Census Tract 38, District of Columbia, District of Columbia",680,461,109,0,34,0,41,35,680,588,421,104,0,33,0,5,25,92,40,5,0,1,0,36,10,110010038001000,3,303,303,3,psa_37,3D3
1000000US110010050023003,"Block 3003, Block Group 3, Census Tract 50.02, District of Columbia, District of Columbia",0,0,0,0,0,0,0,0,0,0,0,0,0,0,0,0,0,0,0,0,0,0,0,0,0,110010050023003,3,307,307,3,psa_28,3D3
1000000US110010095052021,"Block 2021, Block Group 2, Census Tract 95.05, District of Columbia, District of Columbia",13,0,13,0,0,0,0,0,13,13,0,13,0,0,0,0,0,0,0,0,0,0,0,0,0,110010095052021,4,406,406,4,psa_54,4D2
1000000US110010095031017,"Block 1017, Block Group 1, Census Tract 95.03, District of Columbia, District of Columbia",85,0,84,0,0,0,0,1,85,85,0,84,0,0,0,0,1,0,0,0,0,0,0,0,0,110010095031017,4,405,405,4,psa_49,4D2
1000000US110010010015002,"Block 5002, Block Group 5, Census Tract 10.01, District of Columbia, District of Columbia",72,51,5,0,7,0,0,9,72,69,48,5,0,7,0,0,9,3,3,0,0,0,0,0,0,110010010015002,2,202,202,2,psa_52,2D1
1000000US110010078083011,"Block 3011, Block Group 3, Census Tract 78.08, District of Columbia, District of Columbia",98,0,96,1,0,0,0,1,98,93,0,92,0,0,0,0,1,5,0,4,1,0,0,0,0,110010078083011,6,608,608,6,psa_19,6D1
1000000US110010014011004,"Block 1004, Block Group 1, Census Tract 14.01, District of Columbia, District of Columbia",36,33,1,0,1,0,0,1,36,36,33,1,0,1,0,0,1,0,0,0,0,0,0,0,0,110010014011004,2,201,201,2,psa_55,2D1
1000000US110010019021004,"Block 1004, Block Group 1, Census Tract 19.02, District of Columbia, District of Columbia",82,3,78,1,0,0,0,0,82,80,3,77,0,0,0,0,0,2,0,1,1,0,0,0,0,110010019021004,4,402,402,4,psa_53,4D1
1000000US110010003003013,"Block 3013, Block Group 3, Census Tract 3, District of Columbia, District of Columbia",118,105,2,0,7,0,2,2,118,107,97,1,0,7,0,0,2,11,8,1,0,0,0,2,0,110010003003013,2,206,206,2,psa_29,2D2
1000000US110010062021143,"Block 1143, Block Group 1, Census Tract 62.02, District of Columbia, District of Columbia",0,0,0,0,0,0,0,0,0,0,0,0,0,0,0,0,0,0,0,0,0,0,0,0,0,110010062021143,1,106,106,1,psa_13,1D3
1000000US110010073011096,"Block 1096, Block Group 1, Census Tract 73.01, District of Columbia, District of Columbia",0,0,0,0,0,0,0,0,0,0,0,0,0,0,0,0,0,0,0,0,0,0,0,0,0,110010073011096,7,707,707,7,psa_4,7D2
1000000US110010073041013,"Block 1013, Block Group 1, Census Tract 73.04, District of Columbia, District of Columbia",151,2,147,0,0,0,2,0,151,151,2,147,0,0,0,2,0,0,0,0,0,0,0,0,0,110010073041013,7,704,704,7,psa_5,7D2
1000000US110010010011008,"Block 1008, Block Group 1, Census Tract 10.01, District of Columbia, District of Columbia",54,50,4,0,0,0,0,0,54,49,45,4,0,0,0,0,0,5,5,0,0,0,0,0,0,110010010011008,2,202,202,2,psa_52,2D1
1000000US110010013022006,"Block 2006, Block Group 2, Census Tract 13.02, District of Columbia, District of Columbia",0,0,0,0,0,0,0,0,0,0,0,0,0,0,0,0,0,0,0,0,0,0,0,0,0,110010013022006,2,203,203,2,psa_50,2D1
1000000US110010016003011,"Block 3011, Block Group 3, Census Tract 16, District of Columbia, District of Columbia",56,23,29,1,0,0,0,3,56,54,22,29,0,0,0,0,3,2,1,0,1,0,0,0,0,110010016003011,4,401,401,4,psa_56,4D1
1000000US110010099021016,"Block 1016, Block Group 1, Census Tract 99.02, District of Columbia, District of Columbia",80,1,77,0,0,0,0,2,80,78,1,75,0,0,0,0,2,2,0,2,0,0,0,0,0,110010099021016,6,605,605,6,psa_11,6D2
1000000US110010002022006,"Block 2006, Block Group 2, Census Tract 2.02, District of Columbia, District of Columbia",91,82,1,0,3,0,0,5,91,88,79,1,0,3,0,0,5,3,3,0,0,0,0,0,0,110010002022006,2,206,206,2,psa_29,2D2
1000000US110010025021005,"Block 1005, Block Group 1, Census Tract 25.02, District of Columbia, District of Columbia",232,52,100,4,1,0,69,6,232,139,34,100,0,1,0,1,3,93,18,0,4,0,0,68,3,110010025021005,4,404,404,4,psa_48,4D3
1000000US110010078092013,"Block 2013, Block Group 2, Census Tract 78.09, District of Columbia, District of Columbia",117,0,111,0,0,0,6,0,117,111,0,111,0,0,0,0,0,6,0,0,0,0,0,6,0,110010078092013,6,602,602,6,psa_25,6D1
1000000US110010096022005,"Block 2005, Block Group 2, Census Tract 96.02, District of Columbia, District of Columbia",0,0,0,0,0,0,0,0,0,0,0,0,0,0,0,0,0,0,0,0,0,0,0,0,0,110010096022005,6,601,601,6,psa_30,6D1
1000000US110010098011008,"Block 1008, Block Group 1, Census Tract 98.01, District of Columbia, District of Columbia",0,0,0,0,0,0,0,0,0,0,0,0,0,0,0,0,0,0,0,0,0,0,0,0,0,110010098011008,7,705,705,7,psa_3,7D2
1000000US110010001004044,"Block 4044, Block Group 4, Census Tract 1, District of Columbia, District of Columbia",36,33,0,0,0,0,2,1,36,33,31,0,0,0,0,1,1,3,2,0,0,0,0,1,0,110010001004044,2,206,206,2,psa_29,2D2
1000000US110010059001004,"Block 1004, Block Group 1, Census Tract 59, District of Columbia, District of Columbia",0,0,0,0,0,0,0,0,0,0,0,0,0,0,0,0,0,0,0,0,0,0,0,0,0,110010059001004,1,101,101,1,psa_20,1D1
1000000US110010076013002,"Block 3002, Block Group 3, Census Tract 76.01, District of Columbia, District of Columbia",368,1,360,0,2,0,1,4,368,366,1,358,0,2,0,1,4,2,0,2,0,0,0,0,0,110010076013002,6,607,607,6,psa_10,6D2
1000000US110010102001015,"Block 1015, Block Group 1, Census Tract 102, District of Columbia, District of Columbia",0,0,0,0,0,0,0,0,0,0,0,0,0,0,0,0,0,0,0,0,0,0,0,0,0,110010102001015,1,103,103,1,psa_12,1D1
1000000US110010042012006,"Block 2006, Block Group 2, Census Tract 42.01, District of Columbia, District of Columbia",208,175,9,0,16,0,3,5,208,194,165,9,0,16,0,0,4,14,10,0,0,0,0,3,1,110010042012006,3,301,301,3,psa_31,3D3
1000000US110010016004014,"Block 4014, Block Group 4, Census Tract 16, District of Columbia, District of Columbia",0,0,0,0,0,0,0,0,0,0,0,0,0,0,0,0,0,0,0,0,0,0,0,0,0,110010016004014,4,401,401,4,psa_56,4D1
1000000US110010002021000,"Block 1000, Block Group 1, Census Tract 2.02, District of Columbia, District of Columbia",0,0,0,0,0,0,0,0,0,0,0,0,0,0,0,0,0,0,0,0,0,0,0,0,0,110010002021000,2,204,204,2,psa_44,2D2
1000000US110010009022010,"Block 2010, Block Group 2, Census Tract 9.02, District of Columbia, District of Columbia",0,0,0,0,0,0,0,0,0,0,0,0,0,0,0,0,0,0,0,0,0,0,0,0,0,110010009022010,2,205,205,2,psa_46,2D2
1000000US110010075041001,"Block 1001, Block Group 1, Census Tract 75.04, District of Columbia, District of Columbia",56,0,56,0,0,0,0,0,56,56,0,56,0,0,0,0,0,0,0,0,0,0,0,0,0,110010075041001,7,701,701,7,psa_9,7D1
1000000US110010087012009,"Block 2009, Block Group 2, Census Tract 87.01, District of Columbia, District of Columbia",68,16,48,0,0,0,0,4,68,66,16,48,0,0,0,0,2,2,0,0,0,0,0,0,2,110010087012009,5,502,502,5,psa_40,5D1
1000000US110010022022007,"Block 2007, Block Group 2, Census Tract 22.02, District of Columbia, District of Columbia",67,2,51,0,0,0,11,3,67,46,1,45,0,0,0,0,0,21,1,6,0,0,0,11,3,110010022022007,4,407,407,4,psa_47,4D2
1000000US110010092031003,"Block 1003, Block Group 1, Census Tract 92.03, District of Columbia, District of Columbia",12,0,12,0,0,0,0,0,12,12,0,12,0,0,0,0,0,0,0,0,0,0,0,0,0,110010092031003,5,502,502,5,psa_40,5D1
1000000US110010019013006,"Block 3006, Block Group 3, Census Tract 19.01, District of Columbia, District of Columbia",87,23,50,0,0,0,7,7,87,64,9,48,0,0,0,0,7,23,14,2,0,0,0,7,0,110010019013006,4,402,402,4,psa_53,4D1
1000000US110010101001019,"Block 1019, Block Group 1, Census Tract 101, District of Columbia, District of Columbia",5,1,4,0,0,0,0,0,5,5,1,4,0,0,0,0,0,0,0,0,0,0,0,0,0,110010101001019,2,209,209,2,psa_57,2D3
1000000US110010012001015,"Block 1015, Block Group 1, Census Tract 12, District of Columbia, District of Columbia",0,0,0,0,0,0,0,0,0,0,0,0,0,0,0,0,0,0,0,0,0,0,0,0,0,110010012001015,2,202,202,2,psa_52,2D1
1000000US110010073011030,"Block 1030, Block Group 1, Census Tract 73.01, District of Columbia, District of Columbia",0,0,0,0,0,0,0,0,0,0,0,0,0,0,0,0,0,0,0,0,0,0,0,0,0,110010073011030,7,703,703,7,psa_8,7D1
1000000US110010081002007,"Block 2007, Block Group 2, Census Tract 81, District of Columbia, District of Columbia",80,50,22,0,0,0,0,8,80,73,46,22,0,0,0,0,5,7,4,0,0,0,0,0,3,110010081002007,1,108,108,1,psa_17,1D2
1000000US110010049012006,"Block 2006, Block Group 2, Census Tract 49.01, District of Columbia, District of Columbia",66,31,19,0,13,0,0,3,66,62,29,18,0,13,0,0,2,4,2,1,0,0,0,0,1,110010049012006,3,307,307,3,psa_28,3D3
1000000US110010106002017,"Block 2017, Block Group 2, Census Tract 106, District of Columbia, District of Columbia",68,15,49,0,2,0,2,0,68,63,14,47,0,2,0,0,0,5,1,2,0,0,0,2,0,110010106002017,5,501,501,5,psa_35,5D1
1000000US110010046001003,"Block 1003, Block Group 1, Census Tract 46, District of Columbia, District of Columbia",147,31,111,0,2,0,1,2,147,137,25,108,0,2,0,0,2,10,6,3,0,0,0,1,0,110010046001003,3,308,308,3,psa_27,3D2
1000000US110010076013008,"Block 3008, Block Group 3, Census Tract 76.01, District of Columbia, District of Columbia",84,0,77,0,6,0,0,1,84,84,0,77,0,6,0,0,1,0,0,0,0,0,0,0,0,110010076013008,6,607,607,6,psa_10,6D2
1000000US110010076043000,"Block 3000, Block Group 3, Census Tract 76.04, District of Columbia, District of Columbia",175,15,152,3,0,0,1,4,175,171,13,152,3,0,0,0,3,4,2,0,0,0,0,1,1,110010076043000,6,607,607,6,psa_10,6D2
1000000US110010077072002,"Block 2002, Block Group 2, Census Tract 77.07, District of Columbia, District of Columbia",88,0,87,1,0,0,0,0,88,87,0,86,1,0,0,0,0,1,0,1,0,0,0,0,0,110010077072002,6,605,605,6,psa_11,6D2
1000000US110010018042005,"Block 2005, Block Group 2, Census Tract 18.04, District of Columbia, District of Columbia",0,0,0,0,0,0,0,0,0,0,0,0,0,0,0,0,0,0,0,0,0,0,0,0,0,110010018042005,4,402,402,4,psa_53,4D1
1000000US110010038003004,"Block 3004, Block Group 3, Census Tract 38, District of Columbia, District of Columbia",455,192,129,5,4,0,101,24,455,290,144,128,4,4,0,3,7,165,48,1,1,0,0,98,17,110010038003004,3,303,303,3,psa_37,3D3
1000000US110010049011006,"Block 1006, Block Group 1, Census Tract 49.01, District of Columbia, District of Columbia",0,0,0,0,0,0,0,0,0,0,0,0,0,0,0,0,0,0,0,0,0,0,0,0,0,110010049011006,3,307,307,3,psa_28,3D3
1000000US110010078092007,"Block 2007, Block Group 2, Census Tract 78.09, District of Columbia, District of Columbia",37,0,37,0,0,0,0,0,37,37,0,37,0,0,0,0,0,0,0,0,0,0,0,0,0,110010078092007,6,602,602,6,psa_25,6D1
1000000US110010076041003,"Block 1003, Block Group 1, Census Tract 76.04, District of Columbia, District of Columbia",136,4,126,1,0,0,0,5,136,135,4,126,1,0,0,0,4,1,0,0,0,0,0,0,1,110010076041003,6,607,607,6,psa_10,6D2
1000000US110010073011120,"Block 1120, Block Group 1, Census Tract 73.01, District of Columbia, District of Columbia",0,0,0,0,0,0,0,0,0,0,0,0,0,0,0,0,0,0,0,0,0,0,0,0,0,110010073011120,7,708,708,7,psa_1,7D3
1000000US110010038002000,"Block 2000, Block Group 2, Census Tract 38, District of Columbia, District of Columbia",748,495,119,3,57,1,38,35,748,653,451,117,2,55,1,3,24,95,44,2,1,2,0,35,11,110010038002000,3,303,303,3,psa_37,3D3
1000000US110010006003001,"Block 3001, Block Group 3, Census Tract 6, District of Columbia, District of Columbia",58,53,5,0,0,0,0,0,58,55,50,5,0,0,0,0,0,3,3,0,0,0,0,0,0,110010006003001,2,203,203,2,psa_50,2D1
1000000US110010007011006,"Block 1006, Block Group 1, Census Tract 7.01, District of Columbia, District of Columbia",65,60,2,1,2,0,0,0,65,62,57,2,1,2,0,0,0,3,3,0,0,0,0,0,0,110010007011006,2,204,204,2,psa_44,2D2
1000000US110010011001004,"Block 1004, Block Group 1, Census Tract 11, District of Columbia, District of Columbia",0,0,0,0,0,0,0,0,0,0,0,0,0,0,0,0,0,0,0,0,0,0,0,0,0,110010011001004,2,201,201,2,psa_55,2D1
1000000US110010096041008,"Block 1008, Block Group 1, Census Tract 96.04, District of Columbia, District of Columbia",0,0,0,0,0,0,0,0,0,0,0,0,0,0,0,0,0,0,0,0,0,0,0,0,0,110010096041008,6,603,603,6,psa_15,6D3
1000000US110010111001025,"Block 1025, Block Group 1, Census Tract 111, District of Columbia, District of Columbia",123,11,111,0,0,0,0,1,123,114,2,111,0,0,0,0,1,9,9,0,0,0,0,0,0,110010111001025,5,503,503,5,psa_45,5D2
1000000US110010052011003,"Block 1003, Block Group 1, Census Tract 52.01, District of Columbia, District of Columbia",0,0,0,0,0,0,0,0,0,0,0,0,0,0,0,0,0,0,0,0,0,0,0,0,0,110010052011003,3,307,307,3,psa_28,3D3
1000000US110010059001010,"Block 1010, Block Group 1, Census Tract 59, District of Columbia, District of Columbia",1281,882,208,1,145,0,17,28,1281,1205,831,204,1,145,0,2,22,76,51,4,0,0,0,15,6,110010059001010,1,101,101,1,psa_20,1D1
1000000US110010076042000,"Block 2000, Block Group 2, Census Tract 76.04, District of Columbia, District of Columbia",0,0,0,0,0,0,0,0,0,0,0,0,0,0,0,0,0,0,0,0,0,0,0,0,0,110010076042000,6,607,607,6,psa_10,6D2
1000000US110010084022004,"Block 2004, Block Group 2, Census Tract 84.02, District of Columbia, District of Columbia",97,58,32,0,3,0,0,4,97,94,55,32,0,3,0,0,4,3,3,0,0,0,0,0,0,110010084022004,1,104,104,1,psa_21,1D2
1000000US110010004002026,"Block 2026, Block Group 2, Census Tract 4, District of Columbia, District of Columbia",62,57,0,0,4,0,0,1,62,58,53,0,0,4,0,0,1,4,4,0,0,0,0,0,0,110010004002026,2,204,204,2,psa_44,2D2
1000000US110010074011013,"Block 1013, Block Group 1, Census Tract 74.01, District of Columbia, District of Columbia",0,0,0,0,0,0,0,0,0,0,0,0,0,0,0,0,0,0,0,0,0,0,0,0,0,110010074011013,7,703,703,7,psa_8,7D1
1000000US110010015001005,"Block 1005, Block Group 1, Census Tract 15, District of Columbia, District of Columbia",0,0,0,0,0,0,0,0,0,0,0,0,0,0,0,0,0,0,0,0,0,0,0,0,0,110010015001005,2,201,201,2,psa_55,2D1
1000000US110010083011003,"Block 1003, Block Group 1, Census Tract 83.01, District of Columbia, District of Columbia",68,43,15,0,6,0,0,4,68,66,43,15,0,6,0,0,2,2,0,0,0,0,0,0,2,110010083011003,1,104,104,1,psa_21,1D2
1000000US110010095042004,"Block 2004, Block Group 2, Census Tract 95.04, District of Columbia, District of Columbia",46,5,36,0,0,0,2,3,46,43,5,35,0,0,0,0,3,3,0,1,0,0,0,2,0,110010095042004,4,405,405,4,psa_49,4D2
1000000US110010009022028,"Block 2028, Block Group 2, Census Tract 9.02, District of Columbia, District of Columbia",58,53,0,0,0,0,0,5,58,57,52,0,0,0,0,0,5,1,1,0,0,0,0,0,0,110010009022028,2,205,205,2,psa_46,2D2
1000000US110010016003007,"Block 3007, Block Group 3, Census Tract 16, District of Columbia, District of Columbia",2,1,1,0,0,0,0,0,2,2,1,1,0,0,0,0,0,0,0,0,0,0,0,0,0,110010016003007,4,401,401,4,psa_56,4D1
1000000US110010052013002,"Block 3002, Block Group 3, Census Tract 52.01, District of Columbia, District of Columbia",31,23,5,0,2,0,0,1,31,29,21,5,0,2,0,0,1,2,2,0,0,0,0,0,0,110010052013002,2,208,208,2,psa_33,2D3
1000000US110010087021010,"Block 1010, Block Group 1, Census Tract 87.02, District of Columbia, District of Columbia",118,14,100,0,2,0,0,2,118,116,13,99,0,2,0,0,2,2,1,1,0,0,0,0,0,110010087021010,5,502,502,5,psa_40,5D1
1000000US110010099041006,"Block 1006, Block Group 1, Census Tract 99.04, District of Columbia, District of Columbia",51,6,41,0,0,0,4,0,51,43,2,41,0,0,0,0,0,8,4,0,0,0,0,4,0,110010099041006,6,604,604,6,psa_14,6D3
1000000US110010013022002,"Block 2002, Block Group 2, Census Tract 13.02, District of Columbia, District of Columbia",0,0,0,0,0,0,0,0,0,0,0,0,0,0,0,0,0,0,0,0,0,0,0,0,0,110010013022002,2,203,203,2,psa_50,2D1
1000000US110010101001015,"Block 1015, Block Group 1, Census Tract 101, District of Columbia, District of Columbia",1,0,1,0,0,0,0,0,1,1,0,1,0,0,0,0,0,0,0,0,0,0,0,0,0,110010101001015,2,207,207,2,psa_24,2D3
1000000US110010010015009,"Block 5009, Block Group 5, Census Tract 10.01, District of Columbia, District of Columbia",71,61,0,0,6,0,0,4,71,68,58,0,0,6,0,0,4,3,3,0,0,0,0,0,0,110010010015009,2,202,202,2,psa_52,2D1
1000000US110010015001016,"Block 1016, Block Group 1, Census Tract 15, District of Columbia, District of Columbia",0,0,0,0,0,0,0,0,0,0,0,0,0,0,0,0,0,0,0,0,0,0,0,0,0,110010015001016,2,201,201,2,psa_55,2D1
1000000US110010078043013,"Block 3013, Block Group 3, Census Tract 78.04, District of Columbia, District of Columbia",87,0,83,0,0,0,0,4,87,87,0,83,0,0,0,0,4,0,0,0,0,0,0,0,0,110010078043013,6,608,608,6,psa_19,6D1
1000000US110010093021000,"Block 1000, Block Group 1, Census Tract 93.02, District of Columbia, District of Columbia",61,14,47,0,0,0,0,0,61,56,9,47,0,0,0,0,0,5,5,0,0,0,0,0,0,110010093021000,5,504,504,5,psa_43,5D2
1000000US110010009022017,"Block 2017, Block Group 2, Census Tract 9.02, District of Columbia, District of Columbia",0,0,0,0,0,0,0,0,0,0,0,0,0,0,0,0,0,0,0,0,0,0,0,0,0,110010009022017,2,205,205,2,psa_46,2D2
1000000US110010012001011,"Block 1011, Block Group 1, Census Tract 12, District of Columbia, District of Columbia",421,342,20,0,36,0,7,16,421,372,306,18,0,36,0,3,9,49,36,2,0,0,0,4,7,110010012001011,2,203,203,2,psa_50,2D1
1000000US110010076043002,"Block 3002, Block Group 3, Census Tract 76.04, District of Columbia, District of Columbia",83,0,82,0,0,0,0,1,83,83,0,82,0,0,0,0,1,0,0,0,0,0,0,0,0,110010076043002,6,607,607,6,psa_10,6D2
1000000US110010003003010,"Block 3010, Block Group 3, Census Tract 3, District of Columbia, District of Columbia",108,94,0,1,12,0,0,1,108,106,93,0,1,11,0,0,1,2,1,0,0,1,0,0,0,110010003003010,2,206,206,2,psa_29,2D2
1000000US110010015004006,"Block 4006, Block Group 4, Census Tract 15, District of Columbia, District of Columbia",114,104,1,0,2,0,1,6,114,108,103,1,0,2,0,1,1,6,1,0,0,0,0,0,5,110010015004006,2,201,201,2,psa_55,2D1
1000000US110010094001007,"Block 1007, Block Group 1, Census Tract 94, District of Columbia, District of Columbia",22,0,21,0,0,0,0,1,22,21,0,21,0,0,0,0,0,1,0,0,0,0,0,0,1,110010094001007,5,503,503,5,psa_45,5D2
1000000US110010064002021,"Block 2021, Block Group 2, Census Tract 64, District of Columbia, District of Columbia",0,0,0,0,0,0,0,0,0,0,0,0,0,0,0,0,0,0,0,0,0,0,0,0,0,110010064002021,1,105,105,1,psa_22,1D3
1000000US110010072001006,"Block 1006, Block Group 1, Census Tract 72, District of Columbia, District of Columbia",0,0,0,0,0,0,0,0,0,0,0,0,0,0,0,0,0,0,0,0,0,0,0,0,0,110010072001006,1,106,106,1,psa_13,1D3
1000000US110010091022027,"Block 2027, Block Group 2, Census Tract 91.02, District of Columbia, District of Columbia",0,0,0,0,0,0,0,0,0,0,0,0,0,0,0,0,0,0,0,0,0,0,0,0,0,110010091022027,5,505,505,5,psa_34,5D2
1000000US110010077081001,"Block 1001, Block Group 1, Census Tract 77.08, District of Columbia, District of Columbia",270,2,267,1,0,0,0,0,270,267,2,264,1,0,0,0,0,3,0,3,0,0,0,0,0,110010077081001,6,603,603,6,psa_15,6D3
1000000US110010027021004,"Block 1004, Block Group 1, Census Tract 27.02, District of Columbia, District of Columbia",685,250,58,26,16,1,293,41,685,152,76,44,4,16,0,6,6,533,174,14,22,0,1,287,35,110010027021004,3,302,302,3,psa_42,3D1
1000000US110010091022010,"Block 2010, Block Group 2, Census Tract 91.02, District of Columbia, District of Columbia",176,7,147,3,1,0,14,4,176,155,4,145,3,1,0,2,0,21,3,2,0,0,0,12,4,110010091022010,5,505,505,5,psa_34,5D2
1000000US110010106002000,"Block 2000, Block Group 2, Census Tract 106, District of Columbia, District of Columbia",54,15,36,0,3,0,0,0,54,53,15,35,0,3,0,0,0,1,0,1,0,0,0,0,0,110010106002000,5,501,501,5,psa_35,5D1
1000000US110010072002044,"Block 2044, Block Group 2, Census Tract 72, District of Columbia, District of Columbia",0,0,0,0,0,0,0,0,0,0,0,0,0,0,0,0,0,0,0,0,0,0,0,0,0,110010072002044,1,106,106,1,psa_13,1D3
1000000US110010011002022,"Block 2022, Block Group 2, Census Tract 11, District of Columbia, District of Columbia",24,22,1,0,1,0,0,0,24,24,22,1,0,1,0,0,0,0,0,0,0,0,0,0,0,110010011002022,2,202,202,2,psa_52,2D1
1000000US110010093021012,"Block 1012, Block Group 1, Census Tract 93.02, District of Columbia, District of Columbia",130,23,60,7,0,0,35,5,130,61,2,56,3,0,0,0,0,69,21,4,4,0,0,35,5,110010093021012,5,504,504,5,psa_43,5D2
1000000US110010084022006,"Block 2006, Block Group 2, Census Tract 84.02, District of Columbia, District of Columbia",280,152,97,1,15,0,2,13,280,258,141,92,1,13,0,0,11,22,11,5,0,2,0,2,2,110010084022006,1,104,104,1,psa_21,1D2
1000000US110010004002027,"Block 2027, Block Group 2, Census Tract 4, District of Columbia, District of Columbia",0,0,0,0,0,0,0,0,0,0,0,0,0,0,0,0,0,0,0,0,0,0,0,0,0,110010004002027,2,204,204,2,psa_44,2D2
1000000US110010078043016,"Block 3016, Block Group 3, Census Tract 78.04, District of Columbia, District of Columbia",10,2,8,0,0,0,0,0,10,10,2,8,0,0,0,0,0,0,0,0,0,0,0,0,0,110010078043016,6,608,608,6,psa_19,6D1
1000000US110010104002035,"Block 2035, Block Group 2, Census Tract 104, District of Columbia, District of Columbia",0,0,0,0,0,0,0,0,0,0,0,0,0,0,0,0,0,0,0,0,0,0,0,0,0,110010104002035,7,704,704,7,psa_5,7D2
1000000US110010077091014,"Block 1014, Block Group 1, Census Tract 77.09, District of Columbia, District of Columbia",46,0,41,0,0,0,0,5,46,43,0,41,0,0,0,0,2,3,0,0,0,0,0,0,3,110010077091014,6,605,605,6,psa_11,6D2
1000000US110010072002038,"Block 2038, Block Group 2, Census Tract 72, District of Columbia, District of Columbia",3,3,0,0,0,0,0,0,3,3,3,0,0,0,0,0,0,0,0,0,0,0,0,0,0,110010072002038,1,106,106,1,psa_13,1D3
1000000US110010079011004,"Block 1004, Block Group 1, Census Tract 79.01, District of Columbia, District of Columbia",94,12,81,0,0,0,0,1,94,89,8,81,0,0,0,0,0,5,4,0,0,0,0,0,1,110010079011004,5,507,507,5,psa_23,5D3
1000000US110010011001007,"Block 1007, Block Group 1, Census Tract 11, District of Columbia, District of Columbia",10,7,0,0,3,0,0,0,10,10,7,0,0,3,0,0,0,0,0,0,0,0,0,0,0,110010011001007,2,201,201,2,psa_55,2D1
1000000US110010062021138,"Block 1138, Block Group 1, Census Tract 62.02, District of Columbia, District of Columbia",0,0,0,0,0,0,0,0,0,0,0,0,0,0,0,0,0,0,0,0,0,0,0,0,0,110010062021138,1,106,106,1,psa_13,1D3
1000000US110010077071011,"Block 1011, Block Group 1, Census Tract 77.07, District of Columbia, District of Columbia",165,4,151,0,0,0,0,10,165,164,4,151,0,0,0,0,9,1,0,0,0,0,0,0,1,110010077071011,6,604,604,6,psa_14,6D3
1000000US110010109002012,"Block 2012, Block Group 2, Census Tract 109, District of Columbia, District of Columbia",0,0,0,0,0,0,0,0,0,0,0,0,0,0,0,0,0,0,0,0,0,0,0,0,0,110010109002012,7,708,708,7,psa_1,7D3
1000000US110010032003001,"Block 3001, Block Group 3, Census Tract 32, District of Columbia, District of Columbia",790,114,517,5,19,1,110,24,790,574,35,509,5,19,1,0,5,216,79,8,0,0,0,110,19,110010032003001,4,409,409,4,psa_41,4D3
1000000US110010095042011,"Block 2011, Block Group 2, Census Tract 95.04, District of Columbia, District of Columbia",54,23,31,0,0,0,0,0,54,48,21,27,0,0,0,0,0,6,2,4,0,0,0,0,0,110010095042011,4,405,405,4,psa_49,4D2
1000000US110010078033003,"Block 3003, Block Group 3, Census Tract 78.03, District of Columbia, District of Columbia",36,0,34,0,0,0,0,2,36,36,0,34,0,0,0,0,2,0,0,0,0,0,0,0,0,110010078033003,6,602,602,6,psa_25,6D1
1000000US110010095011008,"Block 1008, Block Group 1, Census Tract 95.01, District of Columbia, District of Columbia",0,0,0,0,0,0,0,0,0,0,0,0,0,0,0,0,0,0,0,0,0,0,0,0,0,110010095011008,4,405,405,4,psa_49,4D2
1000000US110010016004003,"Block 4003, Block Group 4, Census Tract 16, District of Columbia, District of Columbia",73,3,66,0,0,0,4,0,73,67,2,65,0,0,0,0,0,6,1,1,0,0,0,4,0,110010016004003,4,401,401,4,psa_56,4D1
1000000US110010062021009,"Block 1009, Block Group 1, Census Tract 62.02, District of Columbia, District of Columbia",0,0,0,0,0,0,0,0,0,0,0,0,0,0,0,0,0,0,0,0,0,0,0,0,0,110010062021009,1,102,102,1,psa_18,1D1
1000000US110010011001018,"Block 1018, Block Group 1, Census Tract 11, District of Columbia, District of Columbia",80,71,4,0,3,0,0,2,80,78,70,4,0,3,0,0,1,2,1,0,0,0,0,0,1,110010011001018,2,201,201,2,psa_55,2D1
1000000US110010048011010,"Block 1010, Block Group 1, Census Tract 48.01, District of Columbia, District of Columbia",29,9,17,0,0,0,2,1,29,27,9,17,0,0,0,0,1,2,0,0,0,0,0,2,0,110010048011010,3,308,308,3,psa_27,3D2
1000000US110010065002026,"Block 2026, Block Group 2, Census Tract 65, District of Columbia, District of Columbia",0,0,0,0,0,0,0,0,0,0,0,0,0,0,0,0,0,0,0,0,0,0,0,0,0,110010065002026,1,106,106,1,psa_13,1D3
1000000US110010111003036,"Block 3036, Block Group 3, Census Tract 111, District of Columbia, District of Columbia",0,0,0,0,0,0,0,0,0,0,0,0,0,0,0,0,0,0,0,0,0,0,0,0,0,110010111003036,5,503,503,5,psa_45,5D2
1000000US110010075032003,"Block 2003, Block Group 2, Census Tract 75.03, District of Columbia, District of Columbia",143,4,137,1,0,0,0,1,143,143,4,137,1,0,0,0,1,0,0,0,0,0,0,0,0,110010075032003,7,701,701,7,psa_9,7D1
1000000US110010078041004,"Block 1004, Block Group 1, Census Tract 78.04, District of Columbia, District of Columbia",60,0,56,0,0,0,0,4,60,59,0,55,0,0,0,0,4,1,0,1,0,0,0,0,0,110010078041004,6,602,602,6,psa_25,6D1
1000000US110010088031022,"Block 1022, Block Group 1, Census Tract 88.03, District of Columbia, District of Columbia",0,0,0,0,0,0,0,0,0,0,0,0,0,0,0,0,0,0,0,0,0,0,0,0,0,110010088031022,5,501,501,5,psa_35,5D1
1000000US110010077032009,"Block 2009, Block Group 2, Census Tract 77.03, District of Columbia, District of Columbia",115,2,111,0,0,0,0,2,115,115,2,111,0,0,0,0,2,0,0,0,0,0,0,0,0,110010077032009,6,603,603,6,psa_15,6D3
1000000US110010056002019,"Block 2019, Block Group 2, Census Tract 56, District of Columbia, District of Columbia",0,0,0,0,0,0,0,0,0,0,0,0,0,0,0,0,0,0,0,0,0,0,0,0,0,110010056002019,2,207,207,2,psa_24,2D3
1000000US110010065002023,"Block 2023, Block Group 2, Census Tract 65, District of Columbia, District of Columbia",0,0,0,0,0,0,0,0,0,0,0,0,0,0,0,0,0,0,0,0,0,0,0,0,0,110010065002023,1,106,106,1,psa_13,1D3
1000000US110010008014004,"Block 4004, Block Group 4, Census Tract 8.01, District of Columbia, District of Columbia",282,218,20,0,29,0,5,10,282,261,203,20,0,29,0,0,9,21,15,0,0,0,0,5,1,110010008014004,2,205,205,2,psa_46,2D2
1000000US110010015001035,"Block 1035, Block Group 1, Census Tract 15, District of Columbia, District of Columbia",0,0,0,0,0,0,0,0,0,0,0,0,0,0,0,0,0,0,0,0,0,0,0,0,0,110010015001035,2,201,201,2,psa_55,2D1
1000000US110010055002000,"Block 2000, Block Group 2, Census Tract 55, District of Columbia, District of Columbia",56,52,0,0,3,0,0,1,56,53,49,0,0,3,0,0,1,3,3,0,0,0,0,0,0,110010055002000,2,208,208,2,psa_33,2D3
1000000US110010062021167,"Block 1167, Block Group 1, Census Tract 62.02, District of Columbia, District of Columbia",0,0,0,0,0,0,0,0,0,0,0,0,0,0,0,0,0,0,0,0,0,0,0,0,0,110010062021167,2,207,207,2,psa_24,2D3
1000000US110010076013013,"Block 3013, Block Group 3, Census Tract 76.01, District of Columbia, District of Columbia",33,0,33,0,0,0,0,0,33,32,0,32,0,0,0,0,0,1,0,1,0,0,0,0,0,110010076013013,6,607,607,6,psa_10,6D2
1000000US110010099021017,"Block 1017, Block Group 1, Census Tract 99.02, District of Columbia, District of Columbia",0,0,0,0,0,0,0,0,0,0,0,0,0,0,0,0,0,0,0,0,0,0,0,0,0,110010099021017,6,605,605,6,psa_11,6D2
1000000US110010111002028,"Block 2028, Block Group 2, Census Tract 111, District of Columbia, District of Columbia",56,9,47,0,0,0,0,0,56,54,9,45,0,0,0,0,0,2,0,2,0,0,0,0,0,110010111002028,5,503,503,5,psa_45,5D2
1000000US110010020021012,"Block 1012, Block Group 1, Census Tract 20.02, District of Columbia, District of Columbia",134,27,65,0,12,0,12,18,134,110,26,65,0,12,0,1,6,24,1,0,0,0,0,11,12,110010020021012,4,404,404,4,psa_48,4D3
1000000US110010107001007,"Block 1007, Block Group 1, Census Tract 107, District of Columbia, District of Columbia",255,211,11,0,29,0,0,4,255,237,194,11,0,29,0,0,3,18,17,0,0,0,0,0,1,110010107001007,2,207,207,2,psa_24,2D3
1000000US110010110003003,"Block 3003, Block Group 3, Census Tract 110, District of Columbia, District of Columbia",0,0,0,0,0,0,0,0,0,0,0,0,0,0,0,0,0,0,0,0,0,0,0,0,0,110010110003003,1,103,103,1,psa_12,1D1
1000000US110010074081007,"Block 1007, Block Group 1, Census Tract 74.08, District of Columbia, District of Columbia",75,0,75,0,0,0,0,0,75,74,0,74,0,0,0,0,0,1,0,1,0,0,0,0,0,110010074081007,7,702,702,7,psa_6,7D1
1000000US110010078081013,"Block 1013, Block Group 1, Census Tract 78.08, District of Columbia, District of Columbia",183,0,183,0,0,0,0,0,183,183,0,183,0,0,0,0,0,0,0,0,0,0,0,0,0,110010078081013,6,608,608,6,psa_19,6D1
1000000US110010095031013,"Block 1013, Block Group 1, Census Tract 95.03, District of Columbia, District of Columbia",81,1,79,0,0,0,0,1,81,81,1,79,0,0,0,0,1,0,0,0,0,0,0,0,0,110010095031013,4,405,405,4,psa_49,4D2
1000000US110010079031015,"Block 1015, Block Group 1, Census Tract 79.03, District of Columbia, District of Columbia",123,6,115,0,1,0,0,1,123,115,6,108,0,0,0,0,1,8,0,7,0,1,0,0,0,110010079031015,5,507,507,5,psa_23,5D3
1000000US110010058001005,"Block 1005, Block Group 1, Census Tract 58, District of Columbia, District of Columbia",0,0,0,0,0,0,0,0,0,0,0,0,0,0,0,0,0,0,0,0,0,0,0,0,0,110010058001005,2,209,209,2,psa_57,2D3
1000000US110010002024026,"Block 4026, Block Group 4, Census Tract 2.02, District of Columbia, District of Columbia",132,103,4,0,14,0,3,8,132,121,96,4,0,14,0,0,7,11,7,0,0,0,0,3,1,110010002024026,2,206,206,2,psa_29,2D2
1000000US110010078083006,"Block 3006, Block Group 3, Census Tract 78.08, District of Columbia, District of Columbia",38,2,33,0,0,0,0,3,38,38,2,33,0,0,0,0,3,0,0,0,0,0,0,0,0,110010078083006,6,608,608,6,psa_19,6D1
1000000US110010002023004,"Block 3004, Block Group 3, Census Tract 2.02, District of Columbia, District of Columbia",122,102,4,1,10,0,0,5,122,115,97,3,1,10,0,0,4,7,5,1,0,0,0,0,1,110010002023004,2,206,206,2,psa_29,2D2
1000000US110010071001022,"Block 1022, Block Group 1, Census Tract 71, District of Columbia, District of Columbia",0,0,0,0,0,0,0,0,0,0,0,0,0,0,0,0,0,0,0,0,0,0,0,0,0,110010071001022,1,106,106,1,psa_13,1D3
1000000US110010074012002,"Block 2002, Block Group 2, Census Tract 74.01, District of Columbia, District of Columbia",70,0,70,0,0,0,0,0,70,70,0,70,0,0,0,0,0,0,0,0,0,0,0,0,0,110010074012002,7,703,703,7,psa_8,7D1
1000000US110010021011011,"Block 1011, Block Group 1, Census Tract 21.01, District of Columbia, District of Columbia",109,7,94,0,3,0,5,0,109,99,3,93,0,3,0,0,0,10,4,1,0,0,0,5,0,110010021011011,4,403,403,4,psa_51,4D1
1000000US110010056001010,"Block 1010, Block Group 1, Census Tract 56, District of Columbia, District of Columbia",0,0,0,0,0,0,0,0,0,0,0,0,0,0,0,0,0,0,0,0,0,0,0,0,0,110010056001010,2,206,206,2,psa_29,2D2
1000000US110010056001001,"Block 1001, Block Group 1, Census Tract 56, District of Columbia, District of Columbia",216,162,14,0,31,0,4,5,216,193,146,13,0,31,0,0,3,23,16,1,0,0,0,4,2,110010056001001,2,207,207,2,psa_24,2D3
1000000US110010068011000,"Block 1000, Block Group 1, Census Tract 68.01, District of Columbia, District of Columbia",252,69,171,0,6,0,1,5,252,246,63,171,0,6,0,1,5,6,6,0,0,0,0,0,0,110010068011000,1,107,107,1,psa_16,1D2
1000000US110010033011002,"Block 1002, Block Group 1, Census Tract 33.01, District of Columbia, District of Columbia",272,79,168,1,5,0,0,19,272,264,73,166,1,5,0,0,19,8,6,2,0,0,0,0,0,110010033011002,3,306,306,3,psa_38,3D2
1000000US110010044002006,"Block 2006, Block Group 2, Census Tract 44, District of Columbia, District of Columbia",111,78,19,1,2,0,4,7,111,104,78,17,1,2,0,1,5,7,0,2,0,0,0,3,2,110010044002006,3,305,305,3,psa_32,3D2
1000000US110010078071012,"Block 1012, Block Group 1, Census Tract 78.07, District of Columbia, District of Columbia",91,0,88,0,1,0,0,2,91,91,0,88,0,1,0,0,2,0,0,0,0,0,0,0,0,110010078071012,6,608,608,6,psa_19,6D1
1000000US110010023021011,"Block 1011, Block Group 1, Census Tract 23.02, District of Columbia, District of Columbia",0,0,0,0,0,0,0,0,0,0,0,0,0,0,0,0,0,0,0,0,0,0,0,0,0,110010023021011,4,405,405,4,psa_49,4D2
1000000US110010089031012,"Block 1012, Block Group 1, Census Tract 89.03, District of Columbia, District of Columbia",132,0,130,0,0,0,0,2,132,130,0,128,0,0,0,0,2,2,0,2,0,0,0,0,0,110010089031012,5,507,507,5,psa_23,5D3
1000000US110010092011010,"Block 1010, Block Group 1, Census Tract 92.01, District of Columbia, District of Columbia",87,15,59,0,0,0,12,1,87,70,10,59,0,0,0,0,1,17,5,0,0,0,0,12,0,110010092011010,5,502,502,5,psa_40,5D1
1000000US110010019011007,"Block 1007, Block Group 1, Census Tract 19.01, District of Columbia, District of Columbia",63,5,55,0,1,0,0,2,63,63,5,55,0,1,0,0,2,0,0,0,0,0,0,0,0,110010019011007,4,402,402,4,psa_53,4D1
1000000US110010094003020,"Block 3020, Block Group 3, Census Tract 94, District of Columbia, District of Columbia",35,0,35,0,0,0,0,0,35,34,0,34,0,0,0,0,0,1,0,1,0,0,0,0,0,110010094003020,5,503,503,5,psa_45,5D2
1000000US110010103001002,"Block 1002, Block Group 1, Census Tract 103, District of Columbia, District of Columbia",0,0,0,0,0,0,0,0,0,0,0,0,0,0,0,0,0,0,0,0,0,0,0,0,0,110010103001002,4,401,401,4,psa_56,4D1
1000000US110010009021003,"Block 1003, Block Group 1, Census Tract 9.02, District of Columbia, District of Columbia",59,55,0,0,3,0,1,0,59,52,48,0,0,3,0,1,0,7,7,0,0,0,0,0,0,110010009021003,2,205,205,2,psa_46,2D2
1000000US110010019014000,"Block 4000, Block Group 4, Census Tract 19.01, District of Columbia, District of Columbia",50,7,27,0,4,0,0,12,50,50,7,27,0,4,0,0,12,0,0,0,0,0,0,0,0,110010019014000,4,402,402,4,psa_53,4D1
1000000US110010055003000,"Block 3000, Block Group 3, Census Tract 55, District of Columbia, District of Columbia",56,50,0,0,4,0,0,2,56,48,42,0,0,4,0,0,2,8,8,0,0,0,0,0,0,110010055003000,2,208,208,2,psa_33,2D3
1000000US110010076012006,"Block 2006, Block Group 2, Census Tract 76.01, District of Columbia, District of Columbia",0,0,0,0,0,0,0,0,0,0,0,0,0,0,0,0,0,0,0,0,0,0,0,0,0,110010076012006,6,607,607,6,psa_10,6D2
1000000US110010080012000,"Block 2000, Block Group 2, Census Tract 80.01, District of Columbia, District of Columbia",81,28,52,0,1,0,0,0,81,81,28,52,0,1,0,0,0,0,0,0,0,0,0,0,0,110010080012000,1,104,104,1,psa_21,1D2
1000000US110010039002000,"Block 2000, Block Group 2, Census Tract 39, District of Columbia, District of Columbia",0,0,0,0,0,0,0,0,0,0,0,0,0,0,0,0,0,0,0,0,0,0,0,0,0,110010039002000,3,303,303,3,psa_37,3D3
1000000US110010066001014,"Block 1014, Block Group 1, Census Tract 66, District of Columbia, District of Columbia",201,171,10,6,10,0,0,4,201,194,165,9,6,10,0,0,4,7,6,1,0,0,0,0,0,110010066001014,1,107,107,1,psa_16,1D2
1000000US110010084101003,"Block 1003, Block Group 1, Census Tract 84.10, District of Columbia, District of Columbia",105,21,82,1,0,0,0,1,105,104,20,82,1,0,0,0,1,1,1,0,0,0,0,0,0,110010084101003,1,104,104,1,psa_21,1D2
1000000US110010013021001,"Block 1001, Block Group 1, Census Tract 13.02, District of Columbia, District of Columbia",2196,1703,178,4,224,1,24,62,2196,2023,1561,176,2,221,1,4,58,173,142,2,2,3,0,20,4,110010013021001,2,203,203,2,psa_50,2D1
1000000US110010074081009,"Block 1009, Block Group 1, Census Tract 74.08, District of Columbia, District of Columbia",55,0,54,0,1,0,0,0,55,54,0,53,0,1,0,0,0,1,0,1,0,0,0,0,0,110010074081009,7,702,702,7,psa_6,7D1
1000000US110010012004000,"Block 4000, Block Group 4, Census Tract 12, District of Columbia, District of Columbia",24,24,0,0,0,0,0,0,24,18,18,0,0,0,0,0,0,6,6,0,0,0,0,0,0,110010012004000,2,203,203,2,psa_50,2D1
1000000US110010043001001,"Block 1001, Block Group 1, Census Tract 43, District of Columbia, District of Columbia",405,117,151,1,17,0,104,15,405,241,75,150,1,10,0,1,4,164,42,1,0,7,0,103,11,110010043001001,3,301,301,3,psa_31,3D3
1000000US110010083012010,"Block 2010, Block Group 2, Census Tract 83.01, District of Columbia, District of Columbia",42,41,0,0,1,0,0,0,42,42,41,0,0,1,0,0,0,0,0,0,0,0,0,0,0,110010083012010,1,108,108,1,psa_17,1D2
1000000US110010001004031,"Block 4031, Block Group 4, Census Tract 1, District of Columbia, District of Columbia",0,0,0,0,0,0,0,0,0,0,0,0,0,0,0,0,0,0,0,0,0,0,0,0,0,110010001004031,2,206,206,2,psa_29,2D2
1000000US110010093013022,"Block 3022, Block Group 3, Census Tract 93.01, District of Columbia, District of Columbia",5,0,5,0,0,0,0,0,5,5,0,5,0,0,0,0,0,0,0,0,0,0,0,0,0,110010093013022,5,504,504,5,psa_43,5D2
1000000US110010095052000,"Block 2000, Block Group 2, Census Tract 95.05, District of Columbia, District of Columbia",106,10,80,0,5,0,9,2,106,94,7,80,0,5,0,0,2,12,3,0,0,0,0,9,0,110010095052000,4,406,406,4,psa_54,4D2
1000000US110010058002008,"Block 2008, Block Group 2, Census Tract 58, District of Columbia, District of Columbia",0,0,0,0,0,0,0,0,0,0,0,0,0,0,0,0,0,0,0,0,0,0,0,0,0,110010058002008,1,101,101,1,psa_20,1D1
1000000US110010017021008,"Block 1008, Block Group 1, Census Tract 17.02, District of Columbia, District of Columbia",117,44,49,1,5,0,11,7,117,92,34,48,1,5,0,0,4,25,10,1,0,0,0,11,3,110010017021008,4,401,401,4,psa_56,4D1
1000000US110010024001007,"Block 1007, Block Group 1, Census Tract 24, District of Columbia, District of Columbia",130,39,67,0,3,0,16,5,130,99,26,66,0,3,0,0,4,31,13,1,0,0,0,16,1,110010024001007,4,407,407,4,psa_47,4D2
1000000US110010010013000,"Block 3000, Block Group 3, Census Tract 10.01, District of Columbia, District of Columbia",43,41,0,0,1,0,0,1,43,39,37,0,0,1,0,0,1,4,4,0,0,0,0,0,0,110010010013000,2,202,202,2,psa_52,2D1
1000000US110010062021176,"Block 1176, Block Group 1, Census Tract 62.02, District of Columbia, District of Columbia",0,0,0,0,0,0,0,0,0,0,0,0,0,0,0,0,0,0,0,0,0,0,0,0,0,110010062021176,2,207,207,2,psa_24,2D3
1000000US110010062021202,"Block 1202, Block Group 1, Census Tract 62.02, District of Columbia, District of Columbia",0,0,0,0,0,0,0,0,0,0,0,0,0,0,0,0,0,0,0,0,0,0,0,0,0,110010062021202,1,103,103,1,psa_12,1D1
1000000US110010003001012,"Block 1012, Block Group 1, Census Tract 3, District of Columbia, District of Columbia",26,20,0,0,6,0,0,0,26,26,20,0,0,6,0,0,0,0,0,0,0,0,0,0,0,110010003001012,2,204,204,2,psa_44,2D2
1000000US110010070002019,"Block 2019, Block Group 2, Census Tract 70, District of Columbia, District of Columbia",584,501,57,2,7,4,5,8,584,529,460,52,2,6,4,0,5,55,41,5,0,1,0,5,3,110010070002019,1,106,106,1,psa_13,1D3
1000000US110010111003016,"Block 3016, Block Group 3, Census Tract 111, District of Columbia, District of Columbia",0,0,0,0,0,0,0,0,0,0,0,0,0,0,0,0,0,0,0,0,0,0,0,0,0,110010111003016,5,505,505,5,psa_34,5D2
1000000US110010074081002,"Block 1002, Block Group 1, Census Tract 74.08, District of Columbia, District of Columbia",0,0,0,0,0,0,0,0,0,0,0,0,0,0,0,0,0,0,0,0,0,0,0,0,0,110010074081002,7,702,702,7,psa_6,7D1
1000000US110010024003002,"Block 3002, Block Group 3, Census Tract 24, District of Columbia, District of Columbia",90,6,57,0,13,0,14,0,90,73,6,54,0,13,0,0,0,17,0,3,0,0,0,14,0,110010024003002,4,407,407,4,psa_47,4D2
1000000US110010019013009,"Block 3009, Block Group 3, Census Tract 19.01, District of Columbia, District of Columbia",116,12,63,0,0,0,33,8,116,69,8,61,0,0,0,0,0,47,4,2,0,0,0,33,8,110010019013009,4,402,402,4,psa_53,4D1
1000000US110010025011012,"Block 1012, Block Group 1, Census Tract 25.01, District of Columbia, District of Columbia",0,0,0,0,0,0,0,0,0,0,0,0,0,0,0,0,0,0,0,0,0,0,0,0,0,110010025011012,4,404,404,4,psa_48,4D3
1000000US110010052012007,"Block 2007, Block Group 2, Census Tract 52.01, District of Columbia, District of Columbia",0,0,0,0,0,0,0,0,0,0,0,0,0,0,0,0,0,0,0,0,0,0,0,0,0,110010052012007,2,208,208,2,psa_33,2D3
1000000US110010065001002,"Block 1002, Block Group 1, Census Tract 65, District of Columbia, District of Columbia",0,0,0,0,0,0,0,0,0,0,0,0,0,0,0,0,0,0,0,0,0,0,0,0,0,110010065001002,1,107,107,1,psa_16,1D2
1000000US110010084101019,"Block 1019, Block Group 1, Census Tract 84.10, District of Columbia, District of Columbia",17,5,12,0,0,0,0,0,17,13,5,8,0,0,0,0,0,4,0,4,0,0,0,0,0,110010084101019,1,104,104,1,psa_21,1D2
1000000US110010095042003,"Block 2003, Block Group 2, Census Tract 95.04, District of Columbia, District of Columbia",0,0,0,0,0,0,0,0,0,0,0,0,0,0,0,0,0,0,0,0,0,0,0,0,0,110010095042003,4,405,405,4,psa_49,4D2
1000000US110010083011002,"Block 1002, Block Group 1, Census Tract 83.01, District of Columbia, District of Columbia",149,87,42,0,11,0,6,3,149,139,83,41,0,11,0,1,3,10,4,1,0,0,0,5,0,110010083011002,1,104,104,1,psa_21,1D2
1000000US110010093012002,"Block 2002, Block Group 2, Census Tract 93.01, District of Columbia, District of Columbia",0,0,0,0,0,0,0,0,0,0,0,0,0,0,0,0,0,0,0,0,0,0,0,0,0,110010093012002,5,504,504,5,psa_43,5D2
1000000US110010040013009,"Block 3009, Block Group 3, Census Tract 40.01, District of Columbia, District of Columbia",440,381,16,1,25,2,6,9,440,411,362,15,1,25,2,0,6,29,19,1,0,0,0,6,3,110010040013009,3,303,303,3,psa_37,3D3
1000000US110010108001000,"Block 1000, Block Group 1, Census Tract 108.00, District of Columbia, District of Columbia",0,0,0,0,0,0,0,0,0,0,0,0,0,0,0,0,0,0,0,0,0,0,0,0,0,110010108001000,2,207,207,2,psa_24,2D3
1000000US110010010012022,"Block 2022, Block Group 2, Census Tract 10.01, District of Columbia, District of Columbia",0,0,0,0,0,0,0,0,0,0,0,0,0,0,0,0,0,0,0,0,0,0,0,0,0,110010010012022,2,202,202,2,psa_52,2D1
1000000US110010062021015,"Block 1015, Block Group 1, Census Tract 62.02, District of Columbia, District of Columbia",0,0,0,0,0,0,0,0,0,0,0,0,0,0,0,0,0,0,0,0,0,0,0,0,0,110010062021015,1,102,102,1,psa_18,1D1
1000000US110010076032006,"Block 2006, Block Group 2, Census Tract 76.03, District of Columbia, District of Columbia",26,0,22,0,0,0,0,4,26,26,0,22,0,0,0,0,4,0,0,0,0,0,0,0,0,110010076032006,6,606,606,6,psa_7,6D2
1000000US110010015001014,"Block 1014, Block Group 1, Census Tract 15, District of Columbia, District of Columbia",73,37,22,0,4,0,6,4,73,68,37,22,0,4,0,1,4,5,0,0,0,0,0,5,0,110010015001014,2,201,201,2,psa_55,2D1
1000000US110010088041000,"Block 1000, Block Group 1, Census Tract 88.04, District of Columbia, District of Columbia",131,6,116,2,0,0,7,0,131,118,6,110,2,0,0,0,0,13,0,6,0,0,0,7,0,110010088041000,5,506,506,5,psa_26,5D3
1000000US110010026001023,"Block 1023, Block Group 1, Census Tract 26, District of Columbia, District of Columbia",23,5,15,0,0,0,0,3,23,23,5,15,0,0,0,0,3,0,0,0,0,0,0,0,0,110010026001023,4,404,404,4,psa_48,4D3
1000000US110010075022009,"Block 2009, Block Group 2, Census Tract 75.02, District of Columbia, District of Columbia",485,9,462,0,3,0,0,11,485,477,7,458,0,3,0,0,9,8,2,4,0,0,0,0,2,110010075022009,7,702,702,7,psa_6,7D1
1000000US110010005012005,"Block 2005, Block Group 2, Census Tract 5.01, District of Columbia, District of Columbia",0,0,0,0,0,0,0,0,0,0,0,0,0,0,0,0,0,0,0,0,0,0,0,0,0,110010005012005,2,204,204,2,psa_44,2D2
1000000US110010006002008,"Block 2008, Block Group 2, Census Tract 6, District of Columbia, District of Columbia",0,0,0,0,0,0,0,0,0,0,0,0,0,0,0,0,0,0,0,0,0,0,0,0,0,110010006002008,2,204,204,2,psa_44,2D2
1000000US110010067002000,"Block 2000, Block Group 2, Census Tract 67, District of Columbia, District of Columbia",5,5,0,0,0,0,0,0,5,5,5,0,0,0,0,0,0,0,0,0,0,0,0,0,0,110010067002000,1,107,107,1,psa_16,1D2
1000000US110010095082001,"Block 2001, Block Group 2, Census Tract 95.08, District of Columbia, District of Columbia",242,5,237,0,0,0,0,0,242,234,2,232,0,0,0,0,0,8,3,5,0,0,0,0,0,110010095082001,4,406,406,4,psa_54,4D2
1000000US110010010022004,"Block 2004, Block Group 2, Census Tract 10.02, District of Columbia, District of Columbia",0,0,0,0,0,0,0,0,0,0,0,0,0,0,0,0,0,0,0,0,0,0,0,0,0,110010010022004,2,204,204,2,psa_44,2D2
1000000US110010064002025,"Block 2025, Block Group 2, Census Tract 64, District of Columbia, District of Columbia",0,0,0,0,0,0,0,0,0,0,0,0,0,0,0,0,0,0,0,0,0,0,0,0,0,110010064002025,1,105,105,1,psa_22,1D3
1000000US110010001004046,"Block 4046, Block Group 4, Census Tract 1, District of Columbia, District of Columbia",0,0,0,0,0,0,0,0,0,0,0,0,0,0,0,0,0,0,0,0,0,0,0,0,0,110010001004046,2,206,206,2,psa_29,2D2
1000000US110010011002011,"Block 2011, Block Group 2, Census Tract 11, District of Columbia, District of Columbia",73,36,20,0,5,0,8,4,73,71,36,20,0,5,0,6,4,2,0,0,0,0,0,2,0,110010011002011,2,202,202,2,psa_52,2D1
1000000US110010011004028,"Block 4028, Block Group 4, Census Tract 11, District of Columbia, District of Columbia",0,0,0,0,0,0,0,0,0,0,0,0,0,0,0,0,0,0,0,0,0,0,0,0,0,110010011004028,2,202,202,2,psa_52,2D1
1000000US110010013012002,"Block 2002, Block Group 2, Census Tract 13.01, District of Columbia, District of Columbia",49,40,4,0,0,0,0,5,49,48,39,4,0,0,0,0,5,1,1,0,0,0,0,0,0,110010013012002,2,203,203,2,psa_50,2D1
1000000US110010098112005,"Block 2005, Block Group 2, Census Tract 98.11, District of Columbia, District of Columbia",59,0,54,0,0,0,0,5,59,59,0,54,0,0,0,0,5,0,0,0,0,0,0,0,0,110010098112005,7,706,706,7,psa_2,7D3
1000000US110010076042015,"Block 2015, Block Group 2, Census Tract 76.04, District of Columbia, District of Columbia",94,12,81,1,0,0,0,0,94,93,12,80,1,0,0,0,0,1,0,1,0,0,0,0,0,110010076042015,6,606,606,6,psa_7,6D2
1000000US110010099042003,"Block 2003, Block Group 2, Census Tract 99.04, District of Columbia, District of Columbia",50,0,50,0,0,0,0,0,50,49,0,49,0,0,0,0,0,1,0,1,0,0,0,0,0,110010099042003,6,604,604,6,psa_14,6D3
1000000US110010002024033,"Block 4033, Block Group 4, Census Tract 2.02, District of Columbia, District of Columbia",0,0,0,0,0,0,0,0,0,0,0,0,0,0,0,0,0,0,0,0,0,0,0,0,0,110010002024033,2,206,206,2,psa_29,2D2
1000000US110010041003002,"Block 3002, Block Group 3, Census Tract 41, District of Columbia, District of Columbia",33,33,0,0,0,0,0,0,33,23,23,0,0,0,0,0,0,10,10,0,0,0,0,0,0,110010041003002,2,208,208,2,psa_33,2D3
1000000US110010069001000,"Block 1000, Block Group 1, Census Tract 69, District of Columbia, District of Columbia",85,40,38,0,4,0,1,2,85,83,38,38,0,4,0,1,2,2,2,0,0,0,0,0,0,110010069001000,1,107,107,1,psa_16,1D2
1000000US110010076033006,"Block 3006, Block Group 3, Census Tract 76.03, District of Columbia, District of Columbia",31,0,29,2,0,0,0,0,31,29,0,29,0,0,0,0,0,2,0,0,2,0,0,0,0,110010076033006,6,606,606,6,psa_7,6D2
1000000US110010101001018,"Block 1018, Block Group 1, Census Tract 101, District of Columbia, District of Columbia",0,0,0,0,0,0,0,0,0,0,0,0,0,0,0,0,0,0,0,0,0,0,0,0,0,110010101001018,2,207,207,2,psa_24,2D3
1000000US110010106002056,"Block 2056, Block Group 2, Census Tract 106, District of Columbia, District of Columbia",0,0,0,0,0,0,0,0,0,0,0,0,0,0,0,0,0,0,0,0,0,0,0,0,0,110010106002056,1,102,102,1,psa_18,1D1
1000000US110010072001017,"Block 1017, Block Group 1, Census Tract 72, District of Columbia, District of Columbia",0,0,0,0,0,0,0,0,0,0,0,0,0,0,0,0,0,0,0,0,0,0,0,0,0,110010072001017,1,106,106,1,psa_13,1D3
1000000US110010084101006,"Block 1006, Block Group 1, Census Tract 84.10, District of Columbia, District of Columbia",87,23,63,0,1,0,0,0,87,83,19,63,0,1,0,0,0,4,4,0,0,0,0,0,0,110010084101006,1,104,104,1,psa_21,1D2
1000000US110010024002016,"Block 2016, Block Group 2, Census Tract 24, District of Columbia, District of Columbia",0,0,0,0,0,0,0,0,0,0,0,0,0,0,0,0,0,0,0,0,0,0,0,0,0,110010024002016,4,407,407,4,psa_47,4D2
1000000US110010055001010,"Block 1010, Block Group 1, Census Tract 55, District of Columbia, District of Columbia",9,8,0,0,0,0,0,1,9,9,8,0,0,0,0,0,1,0,0,0,0,0,0,0,0,110010055001010,2,208,208,2,psa_33,2D3
1000000US110010111002017,"Block 2017, Block Group 2, Census Tract 111, District of Columbia, District of Columbia",18,1,17,0,0,0,0,0,18,17,1,16,0,0,0,0,0,1,0,1,0,0,0,0,0,110010111002017,5,505,505,5,psa_34,5D2
1000000US110010078034006,"Block 4006, Block Group 4, Census Tract 78.03, District of Columbia, District of Columbia",463,7,419,0,1,0,21,15,463,437,6,416,0,1,0,4,10,26,1,3,0,0,0,17,5,110010078034006,6,602,602,6,psa_25,6D1
1000000US110010098011005,"Block 1005, Block Group 1, Census Tract 98.01, District of Columbia, District of Columbia",149,1,148,0,0,0,0,0,149,149,1,148,0,0,0,0,0,0,0,0,0,0,0,0,0,110010098011005,7,706,706,7,psa_2,7D3
1000000US110010013012013,"Block 2013, Block Group 2, Census Tract 13.01, District of Columbia, District of Columbia",42,36,4,0,0,0,2,0,42,35,31,4,0,0,0,0,0,7,5,0,0,0,0,2,0,110010013012013,2,203,203,2,psa_50,2D1
1000000US110010019021019,"Block 1019, Block Group 1, Census Tract 19.02, District of Columbia, District of Columbia",54,6,44,0,0,0,4,0,54,49,5,44,0,0,0,0,0,5,1,0,0,0,0,4,0,110010019021019,4,402,402,4,psa_53,4D1
1000000US110010028012000,"Block 2000, Block Group 2, Census Tract 28.01, District of Columbia, District of Columbia",110,22,41,0,2,0,42,3,110,62,17,41,0,2,0,0,2,48,5,0,0,0,0,42,1,110010028012000,4,408,408,4,psa_39,4D3
1000000US110010104001018,"Block 1018, Block Group 1, Census Tract 104, District of Columbia, District of Columbia",0,0,0,0,0,0,0,0,0,0,0,0,0,0,0,0,0,0,0,0,0,0,0,0,0,110010104001018,7,707,707,7,psa_4,7D2
1000000US110010001002009,"Block 2009, Block Group 2, Census Tract 1, District of Columbia, District of Columbia",43,42,1,0,0,0,0,0,43,41,40,1,0,0,0,0,0,2,2,0,0,0,0,0,0,110010001002009,2,206,206,2,psa_29,2D2
1000000US110010050011008,"Block 1008, Block Group 1, Census Tract 50.01, District of Columbia, District of Columbia",33,31,1,0,0,0,0,1,33,31,29,1,0,0,0,0,1,2,2,0,0,0,0,0,0,110010050011008,3,307,307,3,psa_28,3D3
1000000US110010014021005,"Block 1005, Block Group 1, Census Tract 14.02, District of Columbia, District of Columbia",33,24,7,0,1,0,1,0,33,28,20,7,0,1,0,0,0,5,4,0,0,0,0,1,0,110010014021005,2,201,201,2,psa_55,2D1
1000000US110010020021013,"Block 1013, Block Group 1, Census Tract 20.02, District of Columbia, District of Columbia",0,0,0,0,0,0,0,0,0,0,0,0,0,0,0,0,0,0,0,0,0,0,0,0,0,110010020021013,4,404,404,4,psa_48,4D3
1000000US110010011002015,"Block 2015, Block Group 2, Census Tract 11, District of Columbia, District of Columbia",42,35,4,0,3,0,0,0,42,41,34,4,0,3,0,0,0,1,1,0,0,0,0,0,0,110010011002015,2,202,202,2,psa_52,2D1
1000000US110010028021004,"Block 1004, Block Group 1, Census Tract 28.02, District of Columbia, District of Columbia",523,215,106,1,21,0,160,20,523,263,133,104,1,21,0,0,4,260,82,2,0,0,0,160,16,110010028021004,3,302,302,3,psa_42,3D1
1000000US110010073011067,"Block 1067, Block Group 1, Census Tract 73.01, District of Columbia, District of Columbia",0,0,0,0,0,0,0,0,0,0,0,0,0,0,0,0,0,0,0,0,0,0,0,0,0,110010073011067,7,707,707,7,psa_4,7D2
1000000US110010074071006,"Block 1006, Block Group 1, Census Tract 74.07, District of Columbia, District of Columbia",0,0,0,0,0,0,0,0,0,0,0,0,0,0,0,0,0,0,0,0,0,0,0,0,0,110010074071006,7,703,703,7,psa_8,7D1
1000000US110010078081012,"Block 1012, Block Group 1, Census Tract 78.08, District of Columbia, District of Columbia",72,0,72,0,0,0,0,0,72,72,0,72,0,0,0,0,0,0,0,0,0,0,0,0,0,110010078081012,6,608,608,6,psa_19,6D1
1000000US110010092011012,"Block 1012, Block Group 1, Census Tract 92.01, District of Columbia, District of Columbia",28,25,1,0,1,0,1,0,28,26,24,1,0,1,0,0,0,2,1,0,0,0,0,1,0,110010092011012,5,502,502,5,psa_40,5D1
1000000US110010094003024,"Block 3024, Block Group 3, Census Tract 94, District of Columbia, District of Columbia",42,4,36,0,0,0,2,0,42,40,4,36,0,0,0,0,0,2,0,0,0,0,0,2,0,110010094003024,5,503,503,5,psa_45,5D2
1000000US110010076012001,"Block 2001, Block Group 2, Census Tract 76.01, District of Columbia, District of Columbia",0,0,0,0,0,0,0,0,0,0,0,0,0,0,0,0,0,0,0,0,0,0,0,0,0,110010076012001,6,607,607,6,psa_10,6D2
1000000US110010058001036,"Block 1036, Block Group 1, Census Tract 58, District of Columbia, District of Columbia",0,0,0,0,0,0,0,0,0,0,0,0,0,0,0,0,0,0,0,0,0,0,0,0,0,110010058001036,2,207,207,2,psa_24,2D3
1000000US110010065002022,"Block 2022, Block Group 2, Census Tract 65, District of Columbia, District of Columbia",0,0,0,0,0,0,0,0,0,0,0,0,0,0,0,0,0,0,0,0,0,0,0,0,0,110010065002022,1,106,106,1,psa_13,1D3
1000000US110010073011087,"Block 1087, Block Group 1, Census Tract 73.01, District of Columbia, District of Columbia",0,0,0,0,0,0,0,0,0,0,0,0,0,0,0,0,0,0,0,0,0,0,0,0,0,110010073011087,7,707,707,7,psa_4,7D2
1000000US110010076015016,"Block 5016, Block Group 5, Census Tract 76.01, District of Columbia, District of Columbia",0,0,0,0,0,0,0,0,0,0,0,0,0,0,0,0,0,0,0,0,0,0,0,0,0,110010076015016,7,701,701,7,psa_9,7D1
1000000US110010088031027,"Block 1027, Block Group 1, Census Tract 88.03, District of Columbia, District of Columbia",0,0,0,0,0,0,0,0,0,0,0,0,0,0,0,0,0,0,0,0,0,0,0,0,0,110010088031027,5,501,501,5,psa_35,5D1
1000000US110010095031000,"Block 1000, Block Group 1, Census Tract 95.03, District of Columbia, District of Columbia",0,0,0,0,0,0,0,0,0,0,0,0,0,0,0,0,0,0,0,0,0,0,0,0,0,110010095031000,4,405,405,4,psa_49,4D2
1000000US110010076043008,"Block 3008, Block Group 3, Census Tract 76.04, District of Columbia, District of Columbia",36,0,36,0,0,0,0,0,36,36,0,36,0,0,0,0,0,0,0,0,0,0,0,0,0,110010076043008,6,607,607,6,psa_10,6D2
1000000US110010095031005,"Block 1005, Block Group 1, Census Tract 95.03, District of Columbia, District of Columbia",262,59,184,1,6,0,1,11,262,245,48,180,1,6,0,1,9,17,11,4,0,0,0,0,2,110010095031005,4,405,405,4,psa_49,4D2
1000000US110010059001015,"Block 1015, Block Group 1, Census Tract 59, District of Columbia, District of Columbia",20,3,16,0,0,0,1,0,20,19,3,16,0,0,0,0,0,1,0,0,0,0,0,1,0,110010059001015,1,101,101,1,psa_20,1D1
1000000US110010016004009,"Block 4009, Block Group 4, Census Tract 16, District of Columbia, District of Columbia",50,14,34,0,0,0,0,2,50,50,14,34,0,0,0,0,2,0,0,0,0,0,0,0,0,110010016004009,4,401,401,4,psa_56,4D1
1000000US110010023021016,"Block 1016, Block Group 1, Census Tract 23.02, District of Columbia, District of Columbia",0,0,0,0,0,0,0,0,0,0,0,0,0,0,0,0,0,0,0,0,0,0,0,0,0,110010023021016,4,405,405,4,psa_49,4D2
1000000US110010074011001,"Block 1001, Block Group 1, Census Tract 74.01, District of Columbia, District of Columbia",0,0,0,0,0,0,0,0,0,0,0,0,0,0,0,0,0,0,0,0,0,0,0,0,0,110010074011001,1,106,106,1,psa_13,1D3
1000000US110010088031029,"Block 1029, Block Group 1, Census Tract 88.03, District of Columbia, District of Columbia",0,0,0,0,0,0,0,0,0,0,0,0,0,0,0,0,0,0,0,0,0,0,0,0,0,110010088031029,5,501,501,5,psa_35,5D1
1000000US110010011001014,"Block 1014, Block Group 1, Census Tract 11, District of Columbia, District of Columbia",58,56,1,0,0,1,0,0,58,57,55,1,0,0,1,0,0,1,1,0,0,0,0,0,0,110010011001014,2,202,202,2,psa_52,2D1
1000000US110010014022004,"Block 2004, Block Group 2, Census Tract 14.02, District of Columbia, District of Columbia",85,72,8,0,5,0,0,0,85,77,64,8,0,5,0,0,0,8,8,0,0,0,0,0,0,110010014022004,2,201,201,2,psa_55,2D1
1000000US110010070002003,"Block 2003, Block Group 2, Census Tract 70, District of Columbia, District of Columbia",0,0,0,0,0,0,0,0,0,0,0,0,0,0,0,0,0,0,0,0,0,0,0,0,0,110010070002003,1,106,106,1,psa_13,1D3
1000000US110010094002012,"Block 2012, Block Group 2, Census Tract 94, District of Columbia, District of Columbia",119,19,96,0,0,0,0,4,119,116,16,96,0,0,0,0,4,3,3,0,0,0,0,0,0,110010094002012,5,504,504,5,psa_43,5D2
1000000US110010070002023,"Block 2023, Block Group 2, Census Tract 70, District of Columbia, District of Columbia",0,0,0,0,0,0,0,0,0,0,0,0,0,0,0,0,0,0,0,0,0,0,0,0,0,110010070002023,1,106,106,1,psa_13,1D3
1000000US110010047011001,"Block 1001, Block Group 1, Census Tract 47.01, District of Columbia, District of Columbia",267,1,264,1,0,0,0,1,267,265,1,262,1,0,0,0,1,2,0,2,0,0,0,0,0,110010047011001,1,102,102,1,psa_18,1D1
1000000US110010074042010,"Block 2010, Block Group 2, Census Tract 74.04, District of Columbia, District of Columbia",149,0,149,0,0,0,0,0,149,149,0,149,0,0,0,0,0,0,0,0,0,0,0,0,0,110010074042010,7,704,704,7,psa_5,7D2
1000000US110010099061001,"Block 1001, Block Group 1, Census Tract 99.06, District of Columbia, District of Columbia",157,0,149,1,0,0,4,3,157,149,0,145,1,0,0,0,3,8,0,4,0,0,0,4,0,110010099061001,6,604,604,6,psa_14,6D3
1000000US110010027023000,"Block 3000, Block Group 3, Census Tract 27.02, District of Columbia, District of Columbia",249,172,32,1,7,0,21,16,249,217,164,31,1,7,0,0,14,32,8,1,0,0,0,21,2,110010027023000,3,302,302,3,psa_42,3D1
1000000US110010102002042,"Block 2042, Block Group 2, Census Tract 102, District of Columbia, District of Columbia",278,149,88,1,28,0,4,8,278,265,143,85,1,28,0,0,8,13,6,3,0,0,0,4,0,110010102002042,1,105,105,1,psa_22,1D3
1000000US110010016004027,"Block 4027, Block Group 4, Census Tract 16, District of Columbia, District of Columbia",23,11,11,0,1,0,0,0,23,23,11,11,0,1,0,0,0,0,0,0,0,0,0,0,0,110010016004027,4,401,401,4,psa_56,4D1
1000000US110010074011029,"Block 1029, Block Group 1, Census Tract 74.01, District of Columbia, District of Columbia",0,0,0,0,0,0,0,0,0,0,0,0,0,0,0,0,0,0,0,0,0,0,0,0,0,110010074011029,7,703,703,7,psa_8,7D1
1000000US110010102002008,"Block 2008, Block Group 2, Census Tract 102, District of Columbia, District of Columbia",0,0,0,0,0,0,0,0,0,0,0,0,0,0,0,0,0,0,0,0,0,0,0,0,0,110010102002008,1,103,103,1,psa_12,1D1
1000000US110010049021000,"Block 1000, Block Group 1, Census Tract 49.02, District of Columbia, District of Columbia",340,10,326,0,0,0,4,0,340,323,2,321,0,0,0,0,0,17,8,5,0,0,0,4,0,110010049021000,3,307,307,3,psa_28,3D3
1000000US110010062021214,"Block 1214, Block Group 1, Census Tract 62.02, District of Columbia, District of Columbia",0,0,0,0,0,0,0,0,0,0,0,0,0,0,0,0,0,0,0,0,0,0,0,0,0,110010062021214,1,103,103,1,psa_12,1D1
1000000US110010035001006,"Block 1006, Block Group 1, Census Tract 35, District of Columbia, District of Columbia",296,92,148,0,9,0,23,24,296,227,68,142,0,9,0,3,5,69,24,6,0,0,0,20,19,110010035001006,3,304,304,3,psa_36,3D1
1000000US110010047021005,"Block 1005, Block Group 1, Census Tract 47.02, District of Columbia, District of Columbia",0,0,0,0,0,0,0,0,0,0,0,0,0,0,0,0,0,0,0,0,0,0,0,0,0,110010047021005,1,101,101,1,psa_20,1D1
1000000US110010103002008,"Block 2008, Block Group 2, Census Tract 103, District of Columbia, District of Columbia",168,18,75,3,9,0,56,7,168,87,2,73,3,9,0,0,0,81,16,2,0,0,0,56,7,110010103002008,4,401,401,4,psa_56,4D1
1000000US110010078062004,"Block 2004, Block Group 2, Census Tract 78.06, District of Columbia, District of Columbia",28,0,28,0,0,0,0,0,28,28,0,28,0,0,0,0,0,0,0,0,0,0,0,0,0,110010078062004,6,602,602,6,psa_25,6D1
1000000US110010091022007,"Block 2007, Block Group 2, Census Tract 91.02, District of Columbia, District of Columbia",214,8,194,0,1,0,8,3,214,205,7,192,0,1,0,2,3,9,1,2,0,0,0,6,0,110010091022007,5,505,505,5,psa_34,5D2
1000000US110010093021016,"Block 1016, Block Group 1, Census Tract 93.02, District of Columbia, District of Columbia",0,0,0,0,0,0,0,0,0,0,0,0,0,0,0,0,0,0,0,0,0,0,0,0,0,110010093021016,5,504,504,5,psa_43,5D2
1000000US110010073011094,"Block 1094, Block Group 1, Census Tract 73.01, District of Columbia, District of Columbia",0,0,0,0,0,0,0,0,0,0,0,0,0,0,0,0,0,0,0,0,0,0,0,0,0,110010073011094,7,707,707,7,psa_4,7D2
1000000US110010035002007,"Block 2007, Block Group 2, Census Tract 35, District of Columbia, District of Columbia",0,0,0,0,0,0,0,0,0,0,0,0,0,0,0,0,0,0,0,0,0,0,0,0,0,110010035002007,3,305,305,3,psa_32,3D2
1000000US110010021021016,"Block 1016, Block Group 1, Census Tract 21.02, District of Columbia, District of Columbia",0,0,0,0,0,0,0,0,0,0,0,0,0,0,0,0,0,0,0,0,0,0,0,0,0,110010021021016,4,406,406,4,psa_54,4D2
1000000US110010098041005,"Block 1005, Block Group 1, Census Tract 98.04, District of Columbia, District of Columbia",92,0,91,0,1,0,0,0,92,92,0,91,0,1,0,0,0,0,0,0,0,0,0,0,0,110010098041005,7,705,705,7,psa_3,7D2
1000000US110010014011014,"Block 1014, Block Group 1, Census Tract 14.01, District of Columbia, District of Columbia",51,40,0,0,4,0,0,7,51,45,35,0,0,4,0,0,6,6,5,0,0,0,0,0,1,110010014011014,2,201,201,2,psa_55,2D1
1000000US110010020021024,"Block 1024, Block Group 1, Census Tract 20.02, District of Columbia, District of Columbia",1,0,1,0,0,0,0,0,1,1,0,1,0,0,0,0,0,0,0,0,0,0,0,0,0,110010020021024,4,404,404,4,psa_48,4D3
1000000US110010002024029,"Block 4029, Block Group 4, Census Tract 2.02, District of Columbia, District of Columbia",75,73,0,0,0,0,0,2,75,65,64,0,0,0,0,0,1,10,9,0,0,0,0,0,1,110010002024029,2,206,206,2,psa_29,2D2
1000000US110010078033009,"Block 3009, Block Group 3, Census Tract 78.03, District of Columbia, District of Columbia",77,0,77,0,0,0,0,0,77,77,0,77,0,0,0,0,0,0,0,0,0,0,0,0,0,110010078033009,6,608,608,6,psa_19,6D1
1000000US110010088031017,"Block 1017, Block Group 1, Census Tract 88.03, District of Columbia, District of Columbia",91,8,75,0,0,0,7,1,91,69,0,69,0,0,0,0,0,22,8,6,0,0,0,7,1,110010088031017,5,501,501,5,psa_35,5D1
1000000US110010059001026,"Block 1026, Block Group 1, Census Tract 59, District of Columbia, District of Columbia",0,0,0,0,0,0,0,0,0,0,0,0,0,0,0,0,0,0,0,0,0,0,0,0,0,110010059001026,1,101,101,1,psa_20,1D1
1000000US110010089031001,"Block 1001, Block Group 1, Census Tract 89.03, District of Columbia, District of Columbia",107,1,106,0,0,0,0,0,107,107,1,106,0,0,0,0,0,0,0,0,0,0,0,0,0,110010089031001,5,507,507,5,psa_23,5D3
1000000US110010110001000,"Block 1000, Block Group 1, Census Tract 110, District of Columbia, District of Columbia",91,3,80,0,0,0,2,6,91,80,1,74,0,0,0,0,5,11,2,6,0,0,0,2,1,110010110001000,1,105,105,1,psa_22,1D3
1000000US110010018032000,"Block 2000, Block Group 2, Census Tract 18.03, District of Columbia, District of Columbia",460,42,248,3,9,0,143,15,460,269,8,244,2,9,0,3,3,191,34,4,1,0,0,140,12,110010018032000,4,402,402,4,psa_53,4D1
1000000US110010041003026,"Block 3026, Block Group 3, Census Tract 41, District of Columbia, District of Columbia",0,0,0,0,0,0,0,0,0,0,0,0,0,0,0,0,0,0,0,0,0,0,0,0,0,110010041003026,2,206,206,2,psa_29,2D2
1000000US110010008013028,"Block 3028, Block Group 3, Census Tract 8.01, District of Columbia, District of Columbia",22,21,0,0,0,1,0,0,22,22,21,0,0,0,1,0,0,0,0,0,0,0,0,0,0,110010008013028,2,205,205,2,psa_46,2D2
1000000US110010009022011,"Block 2011, Block Group 2, Census Tract 9.02, District of Columbia, District of Columbia",0,0,0,0,0,0,0,0,0,0,0,0,0,0,0,0,0,0,0,0,0,0,0,0,0,110010009022011,2,205,205,2,psa_46,2D2
1000000US110010071001011,"Block 1011, Block Group 1, Census Tract 71, District of Columbia, District of Columbia",0,0,0,0,0,0,0,0,0,0,0,0,0,0,0,0,0,0,0,0,0,0,0,0,0,110010071001011,1,106,106,1,psa_13,1D3
1000000US110010082002002,"Block 2002, Block Group 2, Census Tract 82, District of Columbia, District of Columbia",0,0,0,0,0,0,0,0,0,0,0,0,0,0,0,0,0,0,0,0,0,0,0,0,0,110010082002002,1,108,108,1,psa_17,1D2
1000000US110010003001003,"Block 1003, Block Group 1, Census Tract 3, District of Columbia, District of Columbia",157,135,0,1,16,0,2,3,157,151,131,0,1,16,0,0,3,6,4,0,0,0,0,2,0,110010003001003,2,206,206,2,psa_29,2D2
1000000US110010020012011,"Block 2011, Block Group 2, Census Tract 20.01, District of Columbia, District of Columbia",110,29,59,0,6,4,1,11,110,96,22,59,0,6,4,0,5,14,7,0,0,0,0,1,6,110010020012011,4,403,403,4,psa_51,4D1
1000000US110010022012008,"Block 2008, Block Group 2, Census Tract 22.01, District of Columbia, District of Columbia",140,20,67,0,0,0,42,11,140,69,6,62,0,0,0,0,1,71,14,5,0,0,0,42,10,110010022012008,4,407,407,4,psa_47,4D2
1000000US110010096021004,"Block 1004, Block Group 1, Census Tract 96.02, District of Columbia, District of Columbia",80,0,80,0,0,0,0,0,80,80,0,80,0,0,0,0,0,0,0,0,0,0,0,0,0,110010096021004,6,601,601,6,psa_30,6D1
1000000US110010099072004,"Block 2004, Block Group 2, Census Tract 99.07, District of Columbia, District of Columbia",297,0,293,0,0,0,0,4,297,297,0,293,0,0,0,0,4,0,0,0,0,0,0,0,0,110010099072004,6,604,604,6,psa_14,6D3
1000000US110010006003003,"Block 3003, Block Group 3, Census Tract 6, District of Columbia, District of Columbia",159,113,11,0,16,0,11,8,159,140,104,11,0,16,0,2,7,19,9,0,0,0,0,9,1,110010006003003,2,204,204,2,psa_44,2D2
1000000US110010010014017,"Block 4017, Block Group 4, Census Tract 10.01, District of Columbia, District of Columbia",56,46,0,0,5,0,0,5,56,55,45,0,0,5,0,0,5,1,1,0,0,0,0,0,0,110010010014017,2,202,202,2,psa_52,2D1
1000000US110010055001009,"Block 1009, Block Group 1, Census Tract 55, District of Columbia, District of Columbia",0,0,0,0,0,0,0,0,0,0,0,0,0,0,0,0,0,0,0,0,0,0,0,0,0,110010055001009,2,208,208,2,psa_33,2D3
1000000US110010062021030,"Block 1030, Block Group 1, Census Tract 62.02, District of Columbia, District of Columbia",0,0,0,0,0,0,0,0,0,0,0,0,0,0,0,0,0,0,0,0,0,0,0,0,0,110010062021030,2,207,207,2,psa_24,2D3
1000000US110010091022018,"Block 2018, Block Group 2, Census Tract 91.02, District of Columbia, District of Columbia",0,0,0,0,0,0,0,0,0,0,0,0,0,0,0,0,0,0,0,0,0,0,0,0,0,110010091022018,5,505,505,5,psa_34,5D2
1000000US110010095033004,"Block 3004, Block Group 3, Census Tract 95.03, District of Columbia, District of Columbia",24,0,24,0,0,0,0,0,24,24,0,24,0,0,0,0,0,0,0,0,0,0,0,0,0,110010095033004,4,405,405,4,psa_49,4D2
1000000US110010062021000,"Block 1000, Block Group 1, Census Tract 62.02, District of Columbia, District of Columbia",0,0,0,0,0,0,0,0,0,0,0,0,0,0,0,0,0,0,0,0,0,0,0,0,0,110010062021000,1,102,102,1,psa_18,1D1
1000000US110010067001001,"Block 1001, Block Group 1, Census Tract 67, District of Columbia, District of Columbia",240,181,42,0,10,0,0,7,240,234,178,42,0,10,0,0,4,6,3,0,0,0,0,0,3,110010067001001,1,107,107,1,psa_16,1D2
1000000US110010011004027,"Block 4027, Block Group 4, Census Tract 11, District of Columbia, District of Columbia",0,0,0,0,0,0,0,0,0,0,0,0,0,0,0,0,0,0,0,0,0,0,0,0,0,110010011004027,2,202,202,2,psa_52,2D1
1000000US110010014023010,"Block 3010, Block Group 3, Census Tract 14.02, District of Columbia, District of Columbia",0,0,0,0,0,0,0,0,0,0,0,0,0,0,0,0,0,0,0,0,0,0,0,0,0,110010014023010,2,203,203,2,psa_50,2D1
1000000US110010092032004,"Block 2004, Block Group 2, Census Tract 92.03, District of Columbia, District of Columbia",126,12,103,0,2,0,9,0,126,117,12,103,0,2,0,0,0,9,0,0,0,0,0,9,0,110010092032004,5,502,502,5,psa_40,5D1
1000000US110010099012027,"Block 2027, Block Group 2, Census Tract 99.01, District of Columbia, District of Columbia",40,3,37,0,0,0,0,0,40,39,2,37,0,0,0,0,0,1,1,0,0,0,0,0,0,110010099012027,6,605,605,6,psa_11,6D2
1000000US110010018031012,"Block 1012, Block Group 1, Census Tract 18.03, District of Columbia, District of Columbia",0,0,0,0,0,0,0,0,0,0,0,0,0,0,0,0,0,0,0,0,0,0,0,0,0,110010018031012,2,201,201,2,psa_55,2D1
1000000US110010064002011,"Block 2011, Block Group 2, Census Tract 64, District of Columbia, District of Columbia",0,0,0,0,0,0,0,0,0,0,0,0,0,0,0,0,0,0,0,0,0,0,0,0,0,110010064002011,1,105,105,1,psa_22,1D3
1000000US110010073011010,"Block 1010, Block Group 1, Census Tract 73.01, District of Columbia, District of Columbia",0,0,0,0,0,0,0,0,0,0,0,0,0,0,0,0,0,0,0,0,0,0,0,0,0,110010073011010,7,707,707,7,psa_4,7D2
1000000US110010044001000,"Block 1000, Block Group 1, Census Tract 44, District of Columbia, District of Columbia",87,46,37,0,2,0,0,2,87,86,45,37,0,2,0,0,2,1,1,0,0,0,0,0,0,110010044001000,3,305,305,3,psa_32,3D2
1000000US110010096011026,"Block 1026, Block Group 1, Census Tract 96.01, District of Columbia, District of Columbia",19,0,19,0,0,0,0,0,19,19,0,19,0,0,0,0,0,0,0,0,0,0,0,0,0,110010096011026,6,601,601,6,psa_30,6D1
1000000US110010068022006,"Block 2006, Block Group 2, Census Tract 68.02, District of Columbia, District of Columbia",0,0,0,0,0,0,0,0,0,0,0,0,0,0,0,0,0,0,0,0,0,0,0,0,0,110010068022006,1,107,107,1,psa_16,1D2
1000000US110010088042002,"Block 2002, Block Group 2, Census Tract 88.04, District of Columbia, District of Columbia",84,5,76,0,0,0,0,3,84,84,5,76,0,0,0,0,3,0,0,0,0,0,0,0,0,110010088042002,5,506,506,5,psa_26,5D3
1000000US110010005021004,"Block 1004, Block Group 1, Census Tract 5.02, District of Columbia, District of Columbia",0,0,0,0,0,0,0,0,0,0,0,0,0,0,0,0,0,0,0,0,0,0,0,0,0,110010005021004,2,204,204,2,psa_44,2D2
1000000US110010073011073,"Block 1073, Block Group 1, Census Tract 73.01, District of Columbia, District of Columbia",0,0,0,0,0,0,0,0,0,0,0,0,0,0,0,0,0,0,0,0,0,0,0,0,0,110010073011073,7,707,707,7,psa_4,7D2
1000000US110010083012000,"Block 2000, Block Group 2, Census Tract 83.01, District of Columbia, District of Columbia",169,147,11,1,4,0,3,3,169,160,142,11,1,4,0,0,2,9,5,0,0,0,0,3,1,110010083012000,1,104,104,1,psa_21,1D2
1000000US110010022012004,"Block 2004, Block Group 2, Census Tract 22.01, District of Columbia, District of Columbia",160,40,100,3,0,0,13,4,160,118,16,100,0,0,0,1,1,42,24,0,3,0,0,12,3,110010022012004,4,407,407,4,psa_47,4D2
1000000US110010042011001,"Block 1001, Block Group 1, Census Tract 42.01, District of Columbia, District of Columbia",200,155,19,0,11,0,11,4,200,174,142,19,0,11,0,0,2,26,13,0,0,0,0,11,2,110010042011001,3,301,301,3,psa_31,3D3
1000000US110010074041010,"Block 1010, Block Group 1, Census Tract 74.04, District of Columbia, District of Columbia",57,0,57,0,0,0,0,0,57,57,0,57,0,0,0,0,0,0,0,0,0,0,0,0,0,110010074041010,7,704,704,7,psa_5,7D2
1000000US110010025012003,"Block 2003, Block Group 2, Census Tract 25.01, District of Columbia, District of Columbia",21,8,10,0,0,0,0,3,21,19,8,10,0,0,0,0,1,2,0,0,0,0,0,0,2,110010025012003,4,404,404,4,psa_48,4D3
1000000US110010066001004,"Block 1004, Block Group 1, Census Tract 66, District of Columbia, District of Columbia",103,101,2,0,0,0,0,0,103,99,97,2,0,0,0,0,0,4,4,0,0,0,0,0,0,110010066001004,1,106,106,1,psa_13,1D3
1000000US110010074011016,"Block 1016, Block Group 1, Census Tract 74.01, District of Columbia, District of Columbia",0,0,0,0,0,0,0,0,0,0,0,0,0,0,0,0,0,0,0,0,0,0,0,0,0,110010074011016,7,703,703,7,psa_8,7D1
1000000US110010105002006,"Block 2006, Block Group 2, Census Tract 105, District of Columbia, District of Columbia",0,0,0,0,0,0,0,0,0,0,0,0,0,0,0,0,0,0,0,0,0,0,0,0,0,110010105002006,1,103,103,1,psa_12,1D1
1000000US110010009022038,"Block 2038, Block Group 2, Census Tract 9.02, District of Columbia, District of Columbia",0,0,0,0,0,0,0,0,0,0,0,0,0,0,0,0,0,0,0,0,0,0,0,0,0,110010009022038,2,205,205,2,psa_46,2D2
1000000US110010111002029,"Block 2029, Block Group 2, Census Tract 111, District of Columbia, District of Columbia",58,10,48,0,0,0,0,0,58,58,10,48,0,0,0,0,0,0,0,0,0,0,0,0,0,110010111002029,5,503,503,5,psa_45,5D2
1000000US110010050011006,"Block 1006, Block Group 1, Census Tract 50.01, District of Columbia, District of Columbia",40,36,2,0,1,0,0,1,40,38,34,2,0,1,0,0,1,2,2,0,0,0,0,0,0,110010050011006,3,307,307,3,psa_28,3D3
1000000US110010072002059,"Block 2059, Block Group 2, Census Tract 72, District of Columbia, District of Columbia",0,0,0,0,0,0,0,0,0,0,0,0,0,0,0,0,0,0,0,0,0,0,0,0,0,110010072002059,1,106,106,1,psa_13,1D3
1000000US110010088024004,"Block 4004, Block Group 4, Census Tract 88.02, District of Columbia, District of Columbia",231,20,200,1,0,0,7,3,231,219,20,197,0,0,0,1,1,12,0,3,1,0,0,6,2,110010088024004,5,506,506,5,psa_26,5D3
1000000US110010062021161,"Block 1161, Block Group 1, Census Tract 62.02, District of Columbia, District of Columbia",0,0,0,0,0,0,0,0,0,0,0,0,0,0,0,0,0,0,0,0,0,0,0,0,0,110010062021161,2,207,207,2,psa_24,2D3
1000000US110010023011000,"Block 1000, Block Group 1, Census Tract 23.01, District of Columbia, District of Columbia",174,15,134,0,1,0,20,4,174,139,10,128,0,1,0,0,0,35,5,6,0,0,0,20,4,110010023011000,4,407,407,4,psa_47,4D2
1000000US110010062021047,"Block 1047, Block Group 1, Census Tract 62.02, District of Columbia, District of Columbia",0,0,0,0,0,0,0,0,0,0,0,0,0,0,0,0,0,0,0,0,0,0,0,0,0,110010062021047,2,207,207,2,psa_24,2D3
1000000US110010015005004,"Block 5004, Block Group 5, Census Tract 15, District of Columbia, District of Columbia",56,56,0,0,0,0,0,0,56,56,56,0,0,0,0,0,0,0,0,0,0,0,0,0,0,110010015005004,2,201,201,2,psa_55,2D1
1000000US110010062021111,"Block 1111, Block Group 1, Census Tract 62.02, District of Columbia, District of Columbia",0,0,0,0,0,0,0,0,0,0,0,0,0,0,0,0,0,0,0,0,0,0,0,0,0,110010062021111,1,102,102,1,psa_18,1D1
1000000US110010020021025,"Block 1025, Block Group 1, Census Tract 20.02, District of Columbia, District of Columbia",119,15,85,0,0,0,11,8,119,97,11,84,0,0,0,1,1,22,4,1,0,0,0,10,7,110010020021025,4,404,404,4,psa_48,4D3
1000000US110010020023002,"Block 3002, Block Group 3, Census Tract 20.02, District of Columbia, District of Columbia",151,42,90,0,2,0,8,9,151,129,35,90,0,2,0,0,2,22,7,0,0,0,0,8,7,110010020023002,4,403,403,4,psa_51,4D1
1000000US110010095032006,"Block 2006, Block Group 2, Census Tract 95.03, District of Columbia, District of Columbia",0,0,0,0,0,0,0,0,0,0,0,0,0,0,0,0,0,0,0,0,0,0,0,0,0,110010095032006,5,503,503,5,psa_45,5D2
1000000US110010018043002,"Block 3002, Block Group 3, Census Tract 18.04, District of Columbia, District of Columbia",554,105,293,7,6,0,129,14,554,344,33,292,4,6,0,5,4,210,72,1,3,0,0,124,10,110010018043002,4,402,402,4,psa_53,4D1
1000000US110010001004027,"Block 4027, Block Group 4, Census Tract 1, District of Columbia, District of Columbia",0,0,0,0,0,0,0,0,0,0,0,0,0,0,0,0,0,0,0,0,0,0,0,0,0,110010001004027,2,206,206,2,psa_29,2D2
1000000US110010023021026,"Block 1026, Block Group 1, Census Tract 23.02, District of Columbia, District of Columbia",0,0,0,0,0,0,0,0,0,0,0,0,0,0,0,0,0,0,0,0,0,0,0,0,0,110010023021026,4,405,405,4,psa_49,4D2
1000000US110010001004014,"Block 4014, Block Group 4, Census Tract 1, District of Columbia, District of Columbia",0,0,0,0,0,0,0,0,0,0,0,0,0,0,0,0,0,0,0,0,0,0,0,0,0,110010001004014,2,206,206,2,psa_29,2D2
1000000US110010072002052,"Block 2052, Block Group 2, Census Tract 72, District of Columbia, District of Columbia",0,0,0,0,0,0,0,0,0,0,0,0,0,0,0,0,0,0,0,0,0,0,0,0,0,110010072002052,1,106,106,1,psa_13,1D3
1000000US110010073011111,"Block 1111, Block Group 1, Census Tract 73.01, District of Columbia, District of Columbia",0,0,0,0,0,0,0,0,0,0,0,0,0,0,0,0,0,0,0,0,0,0,0,0,0,110010073011111,7,708,708,7,psa_1,7D3
1000000US110010099053005,"Block 3005, Block Group 3, Census Tract 99.05, District of Columbia, District of Columbia",61,0,61,0,0,0,0,0,61,61,0,61,0,0,0,0,0,0,0,0,0,0,0,0,0,110010099053005,6,604,604,6,psa_14,6D3
1000000US110010019021015,"Block 1015, Block Group 1, Census Tract 19.02, District of Columbia, District of Columbia",92,23,67,0,1,0,0,1,92,69,2,65,0,1,0,0,1,23,21,2,0,0,0,0,0,110010019021015,4,402,402,4,psa_53,4D1
1000000US110010078091005,"Block 1005, Block Group 1, Census Tract 78.09, District of Columbia, District of Columbia",160,4,151,0,0,0,0,5,160,154,4,145,0,0,0,0,5,6,0,6,0,0,0,0,0,110010078091005,6,608,608,6,psa_19,6D1
1000000US110010074093005,"Block 3005, Block Group 3, Census Tract 74.09, District of Columbia, District of Columbia",0,0,0,0,0,0,0,0,0,0,0,0,0,0,0,0,0,0,0,0,0,0,0,0,0,110010074093005,7,704,704,7,psa_5,7D2
1000000US110010080021003,"Block 1003, Block Group 1, Census Tract 80.02, District of Columbia, District of Columbia",0,0,0,0,0,0,0,0,0,0,0,0,0,0,0,0,0,0,0,0,0,0,0,0,0,110010080021003,1,108,108,1,psa_17,1D2
1000000US110010111001011,"Block 1011, Block Group 1, Census Tract 111, District of Columbia, District of Columbia",42,4,36,1,1,0,0,0,42,40,4,34,1,1,0,0,0,2,0,2,0,0,0,0,0,110010111001011,5,503,503,5,psa_45,5D2
1000000US110010020011003,"Block 1003, Block Group 1, Census Tract 20.01, District of Columbia, District of Columbia",0,0,0,0,0,0,0,0,0,0,0,0,0,0,0,0,0,0,0,0,0,0,0,0,0,110010020011003,4,403,403,4,psa_51,4D1
1000000US110010081003003,"Block 3003, Block Group 3, Census Tract 81, District of Columbia, District of Columbia",39,36,0,0,0,0,1,2,39,38,36,0,0,0,0,0,2,1,0,0,0,0,0,1,0,110010081003003,1,108,108,1,psa_17,1D2
1000000US110010093012001,"Block 2001, Block Group 2, Census Tract 93.01, District of Columbia, District of Columbia",66,47,13,2,3,0,0,1,66,64,46,13,2,3,0,0,0,2,1,0,0,0,0,0,1,110010093012001,5,504,504,5,psa_43,5D2
1000000US110010108002013,"Block 2013, Block Group 2, Census Tract 108.00, District of Columbia, District of Columbia",10,1,8,0,0,0,1,0,10,9,1,8,0,0,0,0,0,1,0,0,0,0,0,1,0,110010108002013,2,207,207,2,psa_24,2D3
1000000US110010096011009,"Block 1009, Block Group 1, Census Tract 96.01, District of Columbia, District of Columbia",52,0,52,0,0,0,0,0,52,52,0,52,0,0,0,0,0,0,0,0,0,0,0,0,0,110010096011009,6,601,601,6,psa_30,6D1
1000000US110010106001002,"Block 1002, Block Group 1, Census Tract 106, District of Columbia, District of Columbia",163,56,101,0,5,0,0,1,163,160,56,98,0,5,0,0,1,3,0,3,0,0,0,0,0,110010106001002,5,501,501,5,psa_35,5D1
1000000US110010008013007,"Block 3007, Block Group 3, Census Tract 8.01, District of Columbia, District of Columbia",13,13,0,0,0,0,0,0,13,13,13,0,0,0,0,0,0,0,0,0,0,0,0,0,0,110010008013007,2,205,205,2,psa_46,2D2
1000000US110010058001004,"Block 1004, Block Group 1, Census Tract 58, District of Columbia, District of Columbia",0,0,0,0,0,0,0,0,0,0,0,0,0,0,0,0,0,0,0,0,0,0,0,0,0,110010058001004,1,101,101,1,psa_20,1D1
1000000US110010083021000,"Block 1000, Block Group 1, Census Tract 83.02, District of Columbia, District of Columbia",122,61,49,0,6,0,0,6,122,118,57,49,0,6,0,0,6,4,4,0,0,0,0,0,0,110010083021000,1,104,104,1,psa_21,1D2
1000000US110010099052004,"Block 2004, Block Group 2, Census Tract 99.05, District of Columbia, District of Columbia",191,0,183,0,0,0,8,0,191,182,0,181,0,0,0,1,0,9,0,2,0,0,0,7,0,110010099052004,6,604,604,6,psa_14,6D3
1000000US110010107001019,"Block 1019, Block Group 1, Census Tract 107, District of Columbia, District of Columbia",0,0,0,0,0,0,0,0,0,0,0,0,0,0,0,0,0,0,0,0,0,0,0,0,0,110010107001019,2,207,207,2,psa_24,2D3
1000000US110010062021204,"Block 1204, Block Group 1, Census Tract 62.02, District of Columbia, District of Columbia",0,0,0,0,0,0,0,0,0,0,0,0,0,0,0,0,0,0,0,0,0,0,0,0,0,110010062021204,1,103,103,1,psa_12,1D1
1000000US110010076032003,"Block 2003, Block Group 2, Census Tract 76.03, District of Columbia, District of Columbia",3,2,1,0,0,0,0,0,3,3,2,1,0,0,0,0,0,0,0,0,0,0,0,0,0,110010076032003,6,606,606,6,psa_7,6D2
1000000US110010076033011,"Block 3011, Block Group 3, Census Tract 76.03, District of Columbia, District of Columbia",63,5,56,0,1,0,0,1,63,63,5,56,0,1,0,0,1,0,0,0,0,0,0,0,0,110010076033011,6,606,606,6,psa_7,6D2
1000000US110010076042008,"Block 2008, Block Group 2, Census Tract 76.04, District of Columbia, District of Columbia",0,0,0,0,0,0,0,0,0,0,0,0,0,0,0,0,0,0,0,0,0,0,0,0,0,110010076042008,6,607,607,6,psa_10,6D2
1000000US110010018031002,"Block 1002, Block Group 1, Census Tract 18.03, District of Columbia, District of Columbia",113,30,66,1,3,0,2,11,113,100,26,64,1,2,0,0,7,13,4,2,0,1,0,2,4,110010018031002,4,401,401,4,psa_56,4D1
1000000US110010078072000,"Block 2000, Block Group 2, Census Tract 78.07, District of Columbia, District of Columbia",479,6,463,0,0,0,10,0,479,460,1,459,0,0,0,0,0,19,5,4,0,0,0,10,0,110010078072000,6,608,608,6,psa_19,6D1
1000000US110010099012028,"Block 2028, Block Group 2, Census Tract 99.01, District of Columbia, District of Columbia",90,7,76,0,0,0,0,7,90,89,7,75,0,0,0,0,7,1,0,1,0,0,0,0,0,110010099012028,6,605,605,6,psa_11,6D2
1000000US110010021015003,"Block 5003, Block Group 5, Census Tract 21.01, District of Columbia, District of Columbia",17,0,14,0,0,0,0,3,17,17,0,14,0,0,0,0,3,0,0,0,0,0,0,0,0,110010021015003,4,403,403,4,psa_51,4D1
1000000US110010088031016,"Block 1016, Block Group 1, Census Tract 88.03, District of Columbia, District of Columbia",39,0,35,0,0,0,4,0,39,35,0,35,0,0,0,0,0,4,0,0,0,0,0,4,0,110010088031016,5,506,506,5,psa_26,5D3
1000000US110010095053021,"Block 3021, Block Group 3, Census Tract 95.05, District of Columbia, District of Columbia",26,2,24,0,0,0,0,0,26,26,2,24,0,0,0,0,0,0,0,0,0,0,0,0,0,110010095053021,4,406,406,4,psa_54,4D2
1000000US110010011002016,"Block 2016, Block Group 2, Census Tract 11, District of Columbia, District of Columbia",66,57,0,0,4,0,0,5,66,66,57,0,0,4,0,0,5,0,0,0,0,0,0,0,0,110010011002016,2,202,202,2,psa_52,2D1
1000000US110010075031002,"Block 1002, Block Group 1, Census Tract 75.03, District of Columbia, District of Columbia",56,4,50,0,0,0,0,2,56,56,4,50,0,0,0,0,2,0,0,0,0,0,0,0,0,110010075031002,7,701,701,7,psa_9,7D1
1000000US110010078092012,"Block 2012, Block Group 2, Census Tract 78.09, District of Columbia, District of Columbia",94,0,94,0,0,0,0,0,94,94,0,94,0,0,0,0,0,0,0,0,0,0,0,0,0,110010078092012,6,602,602,6,psa_25,6D1
1000000US110010015001020,"Block 1020, Block Group 1, Census Tract 15, District of Columbia, District of Columbia",0,0,0,0,0,0,0,0,0,0,0,0,0,0,0,0,0,0,0,0,0,0,0,0,0,110010015001020,2,201,201,2,psa_55,2D1
1000000US110010053011001,"Block 1001, Block Group 1, Census Tract 53.01, District of Columbia, District of Columbia",431,361,13,1,35,0,8,13,431,405,349,12,0,34,0,0,10,26,12,1,1,1,0,8,3,110010053011001,3,301,301,3,psa_31,3D3
1000000US110010049022001,"Block 2001, Block Group 2, Census Tract 49.02, District of Columbia, District of Columbia",38,17,6,0,0,1,13,1,38,23,16,6,0,0,1,0,0,15,1,0,0,0,0,13,1,110010049022001,3,307,307,3,psa_28,3D3
1000000US110010080022004,"Block 2004, Block Group 2, Census Tract 80.02, District of Columbia, District of Columbia",31,12,18,0,0,0,1,0,31,30,12,18,0,0,0,0,0,1,0,0,0,0,0,1,0,110010080022004,1,108,108,1,psa_17,1D2
1000000US110010093014000,"Block 4000, Block Group 4, Census Tract 93.01, District of Columbia, District of Columbia",44,19,21,0,3,0,0,1,44,42,18,20,0,3,0,0,1,2,1,1,0,0,0,0,0,110010093014000,5,504,504,5,psa_43,5D2
1000000US110010010012001,"Block 2001, Block Group 2, Census Tract 10.01, District of Columbia, District of Columbia",62,53,0,0,7,0,2,0,62,60,53,0,0,7,0,0,0,2,0,0,0,0,0,2,0,110010010012001,2,202,202,2,psa_52,2D1
1000000US110010026002012,"Block 2012, Block Group 2, Census Tract 26, District of Columbia, District of Columbia",36,14,20,0,2,0,0,0,36,36,14,20,0,2,0,0,0,0,0,0,0,0,0,0,0,110010026002012,4,404,404,4,psa_48,4D3
1000000US110010021023000,"Block 3000, Block Group 3, Census Tract 21.02, District of Columbia, District of Columbia",202,16,153,1,0,0,25,7,202,165,12,149,1,0,0,0,3,37,4,4,0,0,0,25,4,110010021023000,4,406,406,4,psa_54,4D2
1000000US110010078042010,"Block 2010, Block Group 2, Census Tract 78.04, District of Columbia, District of Columbia",274,2,269,0,0,0,0,3,274,274,2,269,0,0,0,0,3,0,0,0,0,0,0,0,0,110010078042010,6,602,602,6,psa_25,6D1
1000000US110010023021006,"Block 1006, Block Group 1, Census Tract 23.02, District of Columbia, District of Columbia",0,0,0,0,0,0,0,0,0,0,0,0,0,0,0,0,0,0,0,0,0,0,0,0,0,110010023021006,4,405,405,4,psa_49,4D2
1000000US110010027023019,"Block 3019, Block Group 3, Census Tract 27.02, District of Columbia, District of Columbia",0,0,0,0,0,0,0,0,0,0,0,0,0,0,0,0,0,0,0,0,0,0,0,0,0,110010027023019,2,204,204,2,psa_44,2D2
1000000US110010043001005,"Block 1005, Block Group 1, Census Tract 43, District of Columbia, District of Columbia",326,235,56,5,19,0,5,6,326,296,216,55,1,19,0,0,5,30,19,1,4,0,0,5,1,110010043001005,3,301,301,3,psa_31,3D3
1000000US110010073011106,"Block 1106, Block Group 1, Census Tract 73.01, District of Columbia, District of Columbia",0,0,0,0,0,0,0,0,0,0,0,0,0,0,0,0,0,0,0,0,0,0,0,0,0,110010073011106,7,708,708,7,psa_1,7D3
1000000US110010074011036,"Block 1036, Block Group 1, Census Tract 74.01, District of Columbia, District of Columbia",26,2,24,0,0,0,0,0,26,25,1,24,0,0,0,0,0,1,1,0,0,0,0,0,0,110010074011036,7,703,703,7,psa_8,7D1
1000000US110010076012013,"Block 2013, Block Group 2, Census Tract 76.01, District of Columbia, District of Columbia",105,3,99,1,0,0,0,2,105,105,3,99,1,0,0,0,2,0,0,0,0,0,0,0,0,110010076012013,6,607,607,6,psa_10,6D2
1000000US110010023012013,"Block 2013, Block Group 2, Census Tract 23.01, District of Columbia, District of Columbia",47,9,35,0,0,0,0,3,47,47,9,35,0,0,0,0,3,0,0,0,0,0,0,0,0,110010023012013,4,407,407,4,psa_47,4D2
1000000US110010005021014,"Block 1014, Block Group 1, Census Tract 5.02, District of Columbia, District of Columbia",52,51,1,0,0,0,0,0,52,47,46,1,0,0,0,0,0,5,5,0,0,0,0,0,0,110010005021014,2,204,204,2,psa_44,2D2
1000000US110010008013025,"Block 3025, Block Group 3, Census Tract 8.01, District of Columbia, District of Columbia",0,0,0,0,0,0,0,0,0,0,0,0,0,0,0,0,0,0,0,0,0,0,0,0,0,110010008013025,2,204,204,2,psa_44,2D2
1000000US110010013011016,"Block 1016, Block Group 1, Census Tract 13.01, District of Columbia, District of Columbia",77,71,3,0,0,0,1,2,77,73,68,3,0,0,0,0,2,4,3,0,0,0,0,1,0,110010013011016,2,203,203,2,psa_50,2D1
1000000US110010073011011,"Block 1011, Block Group 1, Census Tract 73.01, District of Columbia, District of Columbia",0,0,0,0,0,0,0,0,0,0,0,0,0,0,0,0,0,0,0,0,0,0,0,0,0,110010073011011,7,707,707,7,psa_4,7D2
1000000US110010073011080,"Block 1080, Block Group 1, Census Tract 73.01, District of Columbia, District of Columbia",0,0,0,0,0,0,0,0,0,0,0,0,0,0,0,0,0,0,0,0,0,0,0,0,0,110010073011080,7,707,707,7,psa_4,7D2
1000000US110010016001006,"Block 1006, Block Group 1, Census Tract 16, District of Columbia, District of Columbia",28,1,27,0,0,0,0,0,28,28,1,27,0,0,0,0,0,0,0,0,0,0,0,0,0,110010016001006,4,401,401,4,psa_56,4D1
1000000US110010062021108,"Block 1108, Block Group 1, Census Tract 62.02, District of Columbia, District of Columbia",0,0,0,0,0,0,0,0,0,0,0,0,0,0,0,0,0,0,0,0,0,0,0,0,0,110010062021108,1,102,102,1,psa_18,1D1
1000000US110010109002038,"Block 2038, Block Group 2, Census Tract 109, District of Columbia, District of Columbia",0,0,0,0,0,0,0,0,0,0,0,0,0,0,0,0,0,0,0,0,0,0,0,0,0,110010109002038,7,708,708,7,psa_1,7D3
1000000US110010111003055,"Block 3055, Block Group 3, Census Tract 111, District of Columbia, District of Columbia",0,0,0,0,0,0,0,0,0,0,0,0,0,0,0,0,0,0,0,0,0,0,0,0,0,110010111003055,5,503,503,5,psa_45,5D2
1000000US110010076011006,"Block 1006, Block Group 1, Census Tract 76.01, District of Columbia, District of Columbia",27,0,27,0,0,0,0,0,27,27,0,27,0,0,0,0,0,0,0,0,0,0,0,0,0,110010076011006,6,607,607,6,psa_10,6D2
1000000US110010022023000,"Block 3000, Block Group 3, Census Tract 22.02, District of Columbia, District of Columbia",128,9,113,0,0,0,0,6,128,121,8,107,0,0,0,0,6,7,1,6,0,0,0,0,0,110010022023000,4,407,407,4,psa_47,4D2
1000000US110010077031006,"Block 1006, Block Group 1, Census Tract 77.03, District of Columbia, District of Columbia",150,1,143,0,0,0,6,0,150,140,0,140,0,0,0,0,0,10,1,3,0,0,0,6,0,110010077031006,6,603,603,6,psa_15,6D3
1000000US110010002023001,"Block 3001, Block Group 3, Census Tract 2.02, District of Columbia, District of Columbia",44,43,0,0,1,0,0,0,44,44,43,0,0,1,0,0,0,0,0,0,0,0,0,0,0,110010002023001,2,206,206,2,psa_29,2D2
1000000US110010083021016,"Block 1016, Block Group 1, Census Tract 83.02, District of Columbia, District of Columbia",117,7,108,0,0,0,0,2,117,117,7,108,0,0,0,0,2,0,0,0,0,0,0,0,0,110010083021016,1,108,108,1,psa_17,1D2
1000000US110010104002007,"Block 2007, Block Group 2, Census Tract 104, District of Columbia, District of Columbia",0,0,0,0,0,0,0,0,0,0,0,0,0,0,0,0,0,0,0,0,0,0,0,0,0,110010104002007,7,703,703,7,psa_8,7D1
1000000US110010105002002,"Block 2002, Block Group 2, Census Tract 105, District of Columbia, District of Columbia",0,0,0,0,0,0,0,0,0,0,0,0,0,0,0,0,0,0,0,0,0,0,0,0,0,110010105002002,1,103,103,1,psa_12,1D1
1000000US110010018041004,"Block 1004, Block Group 1, Census Tract 18.04, District of Columbia, District of Columbia",230,17,188,0,3,0,17,5,230,196,4,185,0,3,0,0,4,34,13,3,0,0,0,17,1,110010018041004,4,402,402,4,psa_53,4D1
1000000US110010084022001,"Block 2001, Block Group 2, Census Tract 84.02, District of Columbia, District of Columbia",279,38,230,2,1,3,1,4,279,273,37,227,2,1,3,0,3,6,1,3,0,0,0,1,1,110010084022001,1,104,104,1,psa_21,1D2
1000000US110010108003003,"Block 3003, Block Group 3, Census Tract 108.00, District of Columbia, District of Columbia",1246,1015,49,0,141,0,11,30,1246,1232,1012,49,0,141,0,0,30,14,3,0,0,0,0,11,0,110010108003003,2,207,207,2,psa_24,2D3
1000000US110010025022000,"Block 2000, Block Group 2, Census Tract 25.02, District of Columbia, District of Columbia",357,78,173,0,6,0,73,27,357,244,48,172,0,6,0,2,16,113,30,1,0,0,0,71,11,110010025022000,4,404,404,4,psa_48,4D3
1000000US110010037002003,"Block 2003, Block Group 2, Census Tract 37, District of Columbia, District of Columbia",423,131,220,1,15,0,41,15,423,336,104,207,1,14,0,1,9,87,27,13,0,1,0,40,6,110010037002003,3,304,304,3,psa_36,3D1
1000000US110010009022004,"Block 2004, Block Group 2, Census Tract 9.02, District of Columbia, District of Columbia",0,0,0,0,0,0,0,0,0,0,0,0,0,0,0,0,0,0,0,0,0,0,0,0,0,110010009022004,2,205,205,2,psa_46,2D2
1000000US110010018042002,"Block 2002, Block Group 2, Census Tract 18.04, District of Columbia, District of Columbia",58,5,34,0,8,0,8,3,58,50,5,34,0,8,0,0,3,8,0,0,0,0,0,8,0,110010018042002,4,402,402,4,psa_53,4D1
1000000US110010076011001,"Block 1001, Block Group 1, Census Tract 76.01, District of Columbia, District of Columbia",61,1,57,0,0,0,0,3,61,60,1,57,0,0,0,0,2,1,0,0,0,0,0,0,1,110010076011001,6,607,607,6,psa_10,6D2
1000000US110010036003003,"Block 3003, Block Group 3, Census Tract 36, District of Columbia, District of Columbia",458,279,117,0,34,0,9,19,458,413,255,114,0,34,0,0,10,45,24,3,0,0,0,9,9,110010036003003,3,304,304,3,psa_36,3D1
1000000US110010099051006,"Block 1006, Block Group 1, Census Tract 99.05, District of Columbia, District of Columbia",87,0,86,0,0,0,0,1,87,87,0,86,0,0,0,0,1,0,0,0,0,0,0,0,0,110010099051006,6,604,604,6,psa_14,6D3
1000000US110010001003005,"Block 3005, Block Group 3, Census Tract 1, District of Columbia, District of Columbia",85,85,0,0,0,0,0,0,85,85,85,0,0,0,0,0,0,0,0,0,0,0,0,0,0,110010001003005,2,206,206,2,psa_29,2D2
1000000US110010027023006,"Block 3006, Block Group 3, Census Tract 27.02, District of Columbia, District of Columbia",0,0,0,0,0,0,0,0,0,0,0,0,0,0,0,0,0,0,0,0,0,0,0,0,0,110010027023006,2,204,204,2,psa_44,2D2
1000000US110010008022009,"Block 2009, Block Group 2, Census Tract 8.02, District of Columbia, District of Columbia",22,22,0,0,0,0,0,0,22,22,22,0,0,0,0,0,0,0,0,0,0,0,0,0,0,110010008022009,2,205,205,2,psa_46,2D2
1000000US110010076015004,"Block 5004, Block Group 5, Census Tract 76.01, District of Columbia, District of Columbia",0,0,0,0,0,0,0,0,0,0,0,0,0,0,0,0,0,0,0,0,0,0,0,0,0,110010076015004,1,106,106,1,psa_13,1D3
1000000US110010093012004,"Block 2004, Block Group 2, Census Tract 93.01, District of Columbia, District of Columbia",0,0,0,0,0,0,0,0,0,0,0,0,0,0,0,0,0,0,0,0,0,0,0,0,0,110010093012004,5,504,504,5,psa_43,5D2
1000000US110010096042000,"Block 2000, Block Group 2, Census Tract 96.04, District of Columbia, District of Columbia",0,0,0,0,0,0,0,0,0,0,0,0,0,0,0,0,0,0,0,0,0,0,0,0,0,110010096042000,6,601,601,6,psa_30,6D1
1000000US110010078034004,"Block 4004, Block Group 4, Census Tract 78.03, District of Columbia, District of Columbia",133,0,118,6,2,0,5,2,133,128,0,118,6,2,0,0,2,5,0,0,0,0,0,5,0,110010078034004,6,602,602,6,psa_25,6D1
1000000US110010015002009,"Block 2009, Block Group 2, Census Tract 15, District of Columbia, District of Columbia",46,40,6,0,0,0,0,0,46,38,32,6,0,0,0,0,0,8,8,0,0,0,0,0,0,110010015002009,2,201,201,2,psa_55,2D1
1000000US110010059001037,"Block 1037, Block Group 1, Census Tract 59, District of Columbia, District of Columbia",0,0,0,0,0,0,0,0,0,0,0,0,0,0,0,0,0,0,0,0,0,0,0,0,0,110010059001037,1,102,102,1,psa_18,1D1
1000000US110010005012004,"Block 2004, Block Group 2, Census Tract 5.01, District of Columbia, District of Columbia",0,0,0,0,0,0,0,0,0,0,0,0,0,0,0,0,0,0,0,0,0,0,0,0,0,110010005012004,2,204,204,2,psa_44,2D2
1000000US110010022021003,"Block 1003, Block Group 1, Census Tract 22.02, District of Columbia, District of Columbia",177,27,114,1,1,0,22,12,177,134,18,112,1,1,0,0,2,43,9,2,0,0,0,22,10,110010022021003,4,407,407,4,psa_47,4D2
1000000US110010103002010,"Block 2010, Block Group 2, Census Tract 103, District of Columbia, District of Columbia",61,10,48,0,0,0,0,3,61,56,5,48,0,0,0,0,3,5,5,0,0,0,0,0,0,110010103002010,4,401,401,4,psa_56,4D1
1000000US110010009022026,"Block 2026, Block Group 2, Census Tract 9.02, District of Columbia, District of Columbia",73,69,1,3,0,0,0,0,73,71,67,1,3,0,0,0,0,2,2,0,0,0,0,0,0,110010009022026,2,205,205,2,psa_46,2D2
1000000US110010021026006,"Block 6006, Block Group 6, Census Tract 21.02, District of Columbia, District of Columbia",120,6,91,0,0,0,23,0,120,96,6,90,0,0,0,0,0,24,0,1,0,0,0,23,0,110010021026006,4,403,403,4,psa_51,4D1
1000000US110010073011054,"Block 1054, Block Group 1, Census Tract 73.01, District of Columbia, District of Columbia",0,0,0,0,0,0,0,0,0,0,0,0,0,0,0,0,0,0,0,0,0,0,0,0,0,110010073011054,7,708,708,7,psa_1,7D3
1000000US110010108002006,"Block 2006, Block Group 2, Census Tract 108.00, District of Columbia, District of Columbia",0,0,0,0,0,0,0,0,0,0,0,0,0,0,0,0,0,0,0,0,0,0,0,0,0,110010108002006,2,207,207,2,psa_24,2D3
1000000US110010003001000,"Block 1000, Block Group 1, Census Tract 3, District of Columbia, District of Columbia",274,253,5,2,10,0,0,4,274,255,235,5,2,10,0,0,3,19,18,0,0,0,0,0,1,110010003001000,2,204,204,2,psa_44,2D2
1000000US110010019021013,"Block 1013, Block Group 1, Census Tract 19.02, District of Columbia, District of Columbia",69,0,64,0,1,0,0,4,69,68,0,64,0,1,0,0,3,1,0,0,0,0,0,0,1,110010019021013,4,402,402,4,psa_53,4D1
1000000US110010020012001,"Block 2001, Block Group 2, Census Tract 20.01, District of Columbia, District of Columbia",62,55,7,0,0,0,0,0,62,58,54,4,0,0,0,0,0,4,1,3,0,0,0,0,0,110010020012001,4,403,403,4,psa_51,4D1
1000000US110010078083014,"Block 3014, Block Group 3, Census Tract 78.08, District of Columbia, District of Columbia",0,0,0,0,0,0,0,0,0,0,0,0,0,0,0,0,0,0,0,0,0,0,0,0,0,110010078083014,6,608,608,6,psa_19,6D1
1000000US110010098112007,"Block 2007, Block Group 2, Census Tract 98.11, District of Columbia, District of Columbia",86,6,79,1,0,0,0,0,86,86,6,79,1,0,0,0,0,0,0,0,0,0,0,0,0,110010098112007,7,706,706,7,psa_2,7D3
1000000US110010014023003,"Block 3003, Block Group 3, Census Tract 14.02, District of Columbia, District of Columbia",77,66,3,0,5,0,0,3,77,74,65,2,0,5,0,0,2,3,1,1,0,0,0,0,1,110010014023003,2,201,201,2,psa_55,2D1
1000000US110010041003021,"Block 3021, Block Group 3, Census Tract 41, District of Columbia, District of Columbia",38,24,0,0,4,0,6,4,38,32,22,0,0,4,0,2,4,6,2,0,0,0,0,4,0,110010041003021,2,208,208,2,psa_33,2D3
1000000US110010072002034,"Block 2034, Block Group 2, Census Tract 72, District of Columbia, District of Columbia",0,0,0,0,0,0,0,0,0,0,0,0,0,0,0,0,0,0,0,0,0,0,0,0,0,110010072002034,1,106,106,1,psa_13,1D3
1000000US110010014012018,"Block 2018, Block Group 2, Census Tract 14.01, District of Columbia, District of Columbia",37,36,0,0,0,0,0,1,37,37,36,0,0,0,0,0,1,0,0,0,0,0,0,0,0,110010014012018,2,201,201,2,psa_55,2D1
1000000US110010062021219,"Block 1219, Block Group 1, Census Tract 62.02, District of Columbia, District of Columbia",0,0,0,0,0,0,0,0,0,0,0,0,0,0,0,0,0,0,0,0,0,0,0,0,0,110010062021219,1,103,103,1,psa_12,1D1
1000000US110010099021015,"Block 1015, Block Group 1, Census Tract 99.02, District of Columbia, District of Columbia",49,2,44,0,1,0,0,2,49,49,2,44,0,1,0,0,2,0,0,0,0,0,0,0,0,110010099021015,6,605,605,6,psa_11,6D2
1000000US110010102001013,"Block 1013, Block Group 1, Census Tract 102, District of Columbia, District of Columbia",0,0,0,0,0,0,0,0,0,0,0,0,0,0,0,0,0,0,0,0,0,0,0,0,0,110010102001013,1,103,103,1,psa_12,1D1
1000000US110010058001039,"Block 1039, Block Group 1, Census Tract 58, District of Columbia, District of Columbia",92,75,8,0,5,0,0,4,92,86,71,8,0,4,0,0,3,6,4,0,0,1,0,0,1,110010058001039,1,102,102,1,psa_18,1D1
1000000US110010065002020,"Block 2020, Block Group 2, Census Tract 65, District of Columbia, District of Columbia",0,0,0,0,0,0,0,0,0,0,0,0,0,0,0,0,0,0,0,0,0,0,0,0,0,110010065002020,1,106,106,1,psa_13,1D3
1000000US110010077092008,"Block 2008, Block Group 2, Census Tract 77.09, District of Columbia, District of Columbia",4,0,4,0,0,0,0,0,4,4,0,4,0,0,0,0,0,0,0,0,0,0,0,0,0,110010077092008,6,605,605,6,psa_11,6D2
1000000US110010020022000,"Block 2000, Block Group 2, Census Tract 20.02, District of Columbia, District of Columbia",236,43,126,4,7,0,46,10,236,164,25,122,4,7,0,1,5,72,18,4,0,0,0,45,5,110010020022000,4,403,403,4,psa_51,4D1
1000000US110010093011006,"Block 1006, Block Group 1, Census Tract 93.01, District of Columbia, District of Columbia",48,11,37,0,0,0,0,0,48,44,7,37,0,0,0,0,0,4,4,0,0,0,0,0,0,110010093011006,5,504,504,5,psa_43,5D2
1000000US110010009021002,"Block 1002, Block Group 1, Census Tract 9.02, District of Columbia, District of Columbia",179,160,8,0,5,0,0,6,179,158,143,6,0,5,0,0,4,21,17,2,0,0,0,0,2,110010009021002,2,205,205,2,psa_46,2D2
1000000US110010019011013,"Block 1013, Block Group 1, Census Tract 19.01, District of Columbia, District of Columbia",0,0,0,0,0,0,0,0,0,0,0,0,0,0,0,0,0,0,0,0,0,0,0,0,0,110010019011013,4,402,402,4,psa_53,4D1
1000000US110010058002007,"Block 2007, Block Group 2, Census Tract 58, District of Columbia, District of Columbia",0,0,0,0,0,0,0,0,0,0,0,0,0,0,0,0,0,0,0,0,0,0,0,0,0,110010058002007,1,101,101,1,psa_20,1D1
1000000US110010102002022,"Block 2022, Block Group 2, Census Tract 102, District of Columbia, District of Columbia",0,0,0,0,0,0,0,0,0,0,0,0,0,0,0,0,0,0,0,0,0,0,0,0,0,110010102002022,1,103,103,1,psa_12,1D1
1000000US110010076034001,"Block 4001, Block Group 4, Census Tract 76.03, District of Columbia, District of Columbia",16,1,15,0,0,0,0,0,16,16,1,15,0,0,0,0,0,0,0,0,0,0,0,0,0,110010076034001,6,606,606,6,psa_7,6D2
1000000US110010010012014,"Block 2014, Block Group 2, Census Tract 10.01, District of Columbia, District of Columbia",84,77,1,0,5,0,0,1,84,77,70,1,0,5,0,0,1,7,7,0,0,0,0,0,0,110010010012014,2,202,202,2,psa_52,2D1
1000000US110010076032009,"Block 2009, Block Group 2, Census Tract 76.03, District of Columbia, District of Columbia",34,4,30,0,0,0,0,0,34,34,4,30,0,0,0,0,0,0,0,0,0,0,0,0,0,110010076032009,6,606,606,6,psa_7,6D2
1000000US110010088031028,"Block 1028, Block Group 1, Census Tract 88.03, District of Columbia, District of Columbia",0,0,0,0,0,0,0,0,0,0,0,0,0,0,0,0,0,0,0,0,0,0,0,0,0,110010088031028,5,501,501,5,psa_35,5D1
1000000US110010074071001,"Block 1001, Block Group 1, Census Tract 74.07, District of Columbia, District of Columbia",24,0,23,1,0,0,0,0,24,22,0,21,1,0,0,0,0,2,0,2,0,0,0,0,0,110010074071001,7,702,702,7,psa_6,7D1
1000000US110010083012014,"Block 2014, Block Group 2, Census Tract 83.01, District of Columbia, District of Columbia",0,0,0,0,0,0,0,0,0,0,0,0,0,0,0,0,0,0,0,0,0,0,0,0,0,110010083012014,1,108,108,1,psa_17,1D2
1000000US110010107001027,"Block 1027, Block Group 1, Census Tract 107, District of Columbia, District of Columbia",0,0,0,0,0,0,0,0,0,0,0,0,0,0,0,0,0,0,0,0,0,0,0,0,0,110010107001027,2,207,207,2,psa_24,2D3
1000000US110010048011019,"Block 1019, Block Group 1, Census Tract 48.01, District of Columbia, District of Columbia",0,0,0,0,0,0,0,0,0,0,0,0,0,0,0,0,0,0,0,0,0,0,0,0,0,110010048011019,3,308,308,3,psa_27,3D2
1000000US110010099052000,"Block 2000, Block Group 2, Census Tract 99.05, District of Columbia, District of Columbia",214,5,206,0,0,0,0,3,214,212,5,204,0,0,0,0,3,2,0,2,0,0,0,0,0,110010099052000,6,604,604,6,psa_14,6D3
1000000US110010014011001,"Block 1001, Block Group 1, Census Tract 14.01, District of Columbia, District of Columbia",41,35,0,0,2,0,0,4,41,40,34,0,0,2,0,0,4,1,1,0,0,0,0,0,0,110010014011001,2,201,201,2,psa_55,2D1
1000000US110010078031009,"Block 1009, Block Group 1, Census Tract 78.03, District of Columbia, District of Columbia",122,0,109,0,0,0,7,6,122,112,0,106,0,0,0,0,6,10,0,3,0,0,0,7,0,110010078031009,6,602,602,6,psa_25,6D1
1000000US110010021015005,"Block 5005, Block Group 5, Census Tract 21.01, District of Columbia, District of Columbia",264,46,138,0,8,0,56,16,264,163,16,135,0,8,0,0,4,101,30,3,0,0,0,56,12,110010021015005,4,403,403,4,psa_51,4D1
1000000US110010010015011,"Block 5011, Block Group 5, Census Tract 10.01, District of Columbia, District of Columbia",76,56,1,0,12,0,0,7,76,76,56,1,0,12,0,0,7,0,0,0,0,0,0,0,0,110010010015011,2,202,202,2,psa_52,2D1
1000000US110010021021006,"Block 1006, Block Group 1, Census Tract 21.02, District of Columbia, District of Columbia",0,0,0,0,0,0,0,0,0,0,0,0,0,0,0,0,0,0,0,0,0,0,0,0,0,110010021021006,4,406,406,4,psa_54,4D2
1000000US110010020023012,"Block 3012, Block Group 3, Census Tract 20.02, District of Columbia, District of Columbia",37,15,19,0,0,0,0,3,37,25,3,19,0,0,0,0,3,12,12,0,0,0,0,0,0,110010020023012,4,404,404,4,psa_48,4D3
1000000US110010096011020,"Block 1020, Block Group 1, Census Tract 96.01, District of Columbia, District of Columbia",0,0,0,0,0,0,0,0,0,0,0,0,0,0,0,0,0,0,0,0,0,0,0,0,0,110010096011020,6,601,601,6,psa_30,6D1
1000000US110010096031007,"Block 1007, Block Group 1, Census Tract 96.03, District of Columbia, District of Columbia",149,0,135,2,4,1,0,7,149,149,0,135,2,4,1,0,7,0,0,0,0,0,0,0,0,110010096031007,6,603,603,6,psa_15,6D3
1000000US110010099012010,"Block 2010, Block Group 2, Census Tract 99.01, District of Columbia, District of Columbia",95,0,95,0,0,0,0,0,95,95,0,95,0,0,0,0,0,0,0,0,0,0,0,0,0,110010099012010,6,605,605,6,psa_11,6D2
1000000US110010076042016,"Block 2016, Block Group 2, Census Tract 76.04, District of Columbia, District of Columbia",55,0,55,0,0,0,0,0,55,55,0,55,0,0,0,0,0,0,0,0,0,0,0,0,0,110010076042016,6,606,606,6,psa_7,6D2
1000000US110010093013014,"Block 3014, Block Group 3, Census Tract 93.01, District of Columbia, District of Columbia",14,5,8,0,0,0,0,1,14,14,5,8,0,0,0,0,1,0,0,0,0,0,0,0,0,110010093013014,5,504,504,5,psa_43,5D2
1000000US110010028022004,"Block 2004, Block Group 2, Census Tract 28.02, District of Columbia, District of Columbia",47,25,13,3,1,0,4,1,47,37,22,12,1,1,0,0,1,10,3,1,2,0,0,4,0,110010028022004,3,302,302,3,psa_42,3D1
1000000US110010073011064,"Block 1064, Block Group 1, Census Tract 73.01, District of Columbia, District of Columbia",13,13,0,0,0,0,0,0,13,12,12,0,0,0,0,0,0,1,1,0,0,0,0,0,0,110010073011064,7,707,707,7,psa_4,7D2
1000000US110010102001021,"Block 1021, Block Group 1, Census Tract 102, District of Columbia, District of Columbia",440,220,177,1,22,0,0,20,440,416,203,174,1,22,0,0,16,24,17,3,0,0,0,0,4,110010102001021,1,103,103,1,psa_12,1D1
1000000US110010020012006,"Block 2006, Block Group 2, Census Tract 20.01, District of Columbia, District of Columbia",0,0,0,0,0,0,0,0,0,0,0,0,0,0,0,0,0,0,0,0,0,0,0,0,0,110010020012006,4,403,403,4,psa_51,4D1
1000000US110010008021000,"Block 1000, Block Group 1, Census Tract 8.02, District of Columbia, District of Columbia",45,45,0,0,0,0,0,0,45,38,38,0,0,0,0,0,0,7,7,0,0,0,0,0,0,110010008021000,2,205,205,2,psa_46,2D2
1000000US110010013012011,"Block 2011, Block Group 2, Census Tract 13.01, District of Columbia, District of Columbia",28,17,8,0,0,0,2,1,28,27,16,8,0,0,0,2,1,1,1,0,0,0,0,0,0,110010013012011,2,203,203,2,psa_50,2D1
1000000US110010080012012,"Block 2012, Block Group 2, Census Tract 80.01, District of Columbia, District of Columbia",191,59,101,0,4,0,21,6,191,162,58,98,0,4,0,1,1,29,1,3,0,0,0,20,5,110010080012012,1,104,104,1,psa_21,1D2
1000000US110010006001002,"Block 1002, Block Group 1, Census Tract 6, District of Columbia, District of Columbia",0,0,0,0,0,0,0,0,0,0,0,0,0,0,0,0,0,0,0,0,0,0,0,0,0,110010006001002,2,203,203,2,psa_50,2D1
1000000US110010018042009,"Block 2009, Block Group 2, Census Tract 18.04, District of Columbia, District of Columbia",0,0,0,0,0,0,0,0,0,0,0,0,0,0,0,0,0,0,0,0,0,0,0,0,0,110010018042009,4,402,402,4,psa_53,4D1
1000000US110010077092012,"Block 2012, Block Group 2, Census Tract 77.09, District of Columbia, District of Columbia",87,0,85,0,0,0,2,0,87,86,0,84,0,0,0,2,0,1,0,1,0,0,0,0,0,110010077092012,6,605,605,6,psa_11,6D2
1000000US110010031001001,"Block 1001, Block Group 1, Census Tract 31, District of Columbia, District of Columbia",86,38,28,0,0,0,16,4,86,67,36,27,0,0,0,1,3,19,2,1,0,0,0,15,1,110010031001001,4,409,409,4,psa_41,4D3
1000000US110010090001009,"Block 1009, Block Group 1, Census Tract 90, District of Columbia, District of Columbia",0,0,0,0,0,0,0,0,0,0,0,0,0,0,0,0,0,0,0,0,0,0,0,0,0,110010090001009,5,503,503,5,psa_45,5D2
1000000US110010095031016,"Block 1016, Block Group 1, Census Tract 95.03, District of Columbia, District of Columbia",71,2,68,0,0,0,0,1,71,71,2,68,0,0,0,0,1,0,0,0,0,0,0,0,0,110010095031016,4,405,405,4,psa_49,4D2
1000000US110010077091019,"Block 1019, Block Group 1, Census Tract 77.09, District of Columbia, District of Columbia",75,3,71,0,0,0,0,1,75,74,3,70,0,0,0,0,1,1,0,1,0,0,0,0,0,110010077091019,6,605,605,6,psa_11,6D2
1000000US110010013012008,"Block 2008, Block Group 2, Census Tract 13.01, District of Columbia, District of Columbia",49,25,18,0,3,0,3,0,49,46,25,18,0,3,0,0,0,3,0,0,0,0,0,3,0,110010013012008,2,203,203,2,psa_50,2D1
1000000US110010088031002,"Block 1002, Block Group 1, Census Tract 88.03, District of Columbia, District of Columbia",154,10,132,1,4,1,4,2,154,143,5,129,1,4,1,1,2,11,5,3,0,0,0,3,0,110010088031002,5,506,506,5,psa_26,5D3
1000000US110010099012006,"Block 2006, Block Group 2, Census Tract 99.01, District of Columbia, District of Columbia",0,0,0,0,0,0,0,0,0,0,0,0,0,0,0,0,0,0,0,0,0,0,0,0,0,110010099012006,6,605,605,6,psa_11,6D2
1000000US110010099071001,"Block 1001, Block Group 1, Census Tract 99.07, District of Columbia, District of Columbia",203,1,198,0,0,0,0,4,203,203,1,198,0,0,0,0,4,0,0,0,0,0,0,0,0,110010099071001,6,605,605,6,psa_11,6D2
1000000US110010010014010,"Block 4010, Block Group 4, Census Tract 10.01, District of Columbia, District of Columbia",421,281,30,1,81,0,10,18,421,394,263,30,1,81,0,2,17,27,18,0,0,0,0,8,1,110010010014010,2,202,202,2,psa_52,2D1
1000000US110010014012012,"Block 2012, Block Group 2, Census Tract 14.01, District of Columbia, District of Columbia",88,80,7,0,0,0,1,0,88,86,78,7,0,0,0,1,0,2,2,0,0,0,0,0,0,110010014012012,2,201,201,2,psa_55,2D1
1000000US110010014021012,"Block 1012, Block Group 1, Census Tract 14.02, District of Columbia, District of Columbia",69,56,6,0,3,0,1,3,69,66,56,5,0,3,0,0,2,3,0,1,0,0,0,1,1,110010014021012,2,201,201,2,psa_55,2D1
1000000US110010015001029,"Block 1029, Block Group 1, Census Tract 15, District of Columbia, District of Columbia",0,0,0,0,0,0,0,0,0,0,0,0,0,0,0,0,0,0,0,0,0,0,0,0,0,110010015001029,2,201,201,2,psa_55,2D1
1000000US110010110003002,"Block 3002, Block Group 3, Census Tract 110, District of Columbia, District of Columbia",0,0,0,0,0,0,0,0,0,0,0,0,0,0,0,0,0,0,0,0,0,0,0,0,0,110010110003002,1,103,103,1,psa_12,1D1
1000000US110010015001002,"Block 1002, Block Group 1, Census Tract 15, District of Columbia, District of Columbia",0,0,0,0,0,0,0,0,0,0,0,0,0,0,0,0,0,0,0,0,0,0,0,0,0,110010015001002,2,201,201,2,psa_55,2D1
1000000US110010076013003,"Block 3003, Block Group 3, Census Tract 76.01, District of Columbia, District of Columbia",161,9,140,0,2,0,2,8,161,160,9,139,0,2,0,2,8,1,0,1,0,0,0,0,0,110010076013003,6,607,607,6,psa_10,6D2
1000000US110010087012010,"Block 2010, Block Group 2, Census Tract 87.01, District of Columbia, District of Columbia",0,0,0,0,0,0,0,0,0,0,0,0,0,0,0,0,0,0,0,0,0,0,0,0,0,110010087012010,5,502,502,5,psa_40,5D1
1000000US110010092041003,"Block 1003, Block Group 1, Census Tract 92.04, District of Columbia, District of Columbia",170,19,143,1,0,0,6,1,170,151,8,141,1,0,0,0,1,19,11,2,0,0,0,6,0,110010092041003,5,502,502,5,psa_40,5D1
1000000US110010081001004,"Block 1004, Block Group 1, Census Tract 81, District of Columbia, District of Columbia",201,156,38,0,3,1,0,3,201,195,150,38,0,3,1,0,3,6,6,0,0,0,0,0,0,110010081001004,1,108,108,1,psa_17,1D2
1000000US110010083011004,"Block 1004, Block Group 1, Census Tract 83.01, District of Columbia, District of Columbia",91,64,23,0,2,0,0,2,91,90,63,23,0,2,0,0,2,1,1,0,0,0,0,0,0,110010083011004,1,104,104,1,psa_21,1D2
1000000US110010013022007,"Block 2007, Block Group 2, Census Tract 13.02, District of Columbia, District of Columbia",523,426,15,2,54,0,7,19,523,493,402,15,2,53,0,4,17,30,24,0,0,1,0,3,2,110010013022007,2,203,203,2,psa_50,2D1
1000000US110010105002010,"Block 2010, Block Group 2, Census Tract 105, District of Columbia, District of Columbia",0,0,0,0,0,0,0,0,0,0,0,0,0,0,0,0,0,0,0,0,0,0,0,0,0,110010105002010,1,103,103,1,psa_12,1D1
1000000US110010082001002,"Block 1002, Block Group 1, Census Tract 82, District of Columbia, District of Columbia",122,108,7,2,1,0,3,1,122,117,106,7,2,1,0,0,1,5,2,0,0,0,0,3,0,110010082001002,1,108,108,1,psa_17,1D2
1000000US110010097001012,"Block 1012, Block Group 1, Census Tract 97, District of Columbia, District of Columbia",739,7,713,1,1,5,5,7,739,720,1,709,1,0,5,0,4,19,6,4,0,1,0,5,3,110010097001012,7,706,706,7,psa_2,7D3
1000000US110010021022003,"Block 2003, Block Group 2, Census Tract 21.02, District of Columbia, District of Columbia",0,0,0,0,0,0,0,0,0,0,0,0,0,0,0,0,0,0,0,0,0,0,0,0,0,110010021022003,4,406,406,4,psa_54,4D2
1000000US110010014023001,"Block 3001, Block Group 3, Census Tract 14.02, District of Columbia, District of Columbia",221,157,21,1,36,0,4,2,221,193,131,21,1,36,0,2,2,28,26,0,0,0,0,2,0,110010014023001,2,201,201,2,psa_55,2D1
1000000US110010013013005,"Block 3005, Block Group 3, Census Tract 13.01, District of Columbia, District of Columbia",67,64,1,0,0,0,0,2,67,61,58,1,0,0,0,0,2,6,6,0,0,0,0,0,0,110010013013005,2,203,203,2,psa_50,2D1
1000000US110010062021170,"Block 1170, Block Group 1, Census Tract 62.02, District of Columbia, District of Columbia",0,0,0,0,0,0,0,0,0,0,0,0,0,0,0,0,0,0,0,0,0,0,0,0,0,110010062021170,2,207,207,2,psa_24,2D3
1000000US110010077082021,"Block 2021, Block Group 2, Census Tract 77.08, District of Columbia, District of Columbia",0,0,0,0,0,0,0,0,0,0,0,0,0,0,0,0,0,0,0,0,0,0,0,0,0,110010077082021,6,605,605,6,psa_11,6D2
1000000US110010016002008,"Block 2008, Block Group 2, Census Tract 16, District of Columbia, District of Columbia",57,10,43,0,2,0,0,2,57,56,10,42,0,2,0,0,2,1,0,1,0,0,0,0,0,110010016002008,4,401,401,4,psa_56,4D1
1000000US110010102002005,"Block 2005, Block Group 2, Census Tract 102, District of Columbia, District of Columbia",0,0,0,0,0,0,0,0,0,0,0,0,0,0,0,0,0,0,0,0,0,0,0,0,0,110010102002005,1,103,103,1,psa_12,1D1
1000000US110010003003012,"Block 3012, Block Group 3, Census Tract 3, District of Columbia, District of Columbia",121,97,4,0,7,0,3,10,121,104,83,4,0,7,0,0,10,17,14,0,0,0,0,3,0,110010003003012,2,206,206,2,psa_29,2D2
1000000US110010026001001,"Block 1001, Block Group 1, Census Tract 26, District of Columbia, District of Columbia",88,42,31,0,5,0,2,8,88,81,40,31,0,5,0,1,4,7,2,0,0,0,0,1,4,110010026001001,4,404,404,4,psa_48,4D3
1000000US110010047012010,"Block 2010, Block Group 2, Census Tract 47.01, District of Columbia, District of Columbia",1580,532,486,8,496,1,13,44,1580,1512,493,479,7,493,1,1,38,68,39,7,1,3,0,12,6,110010047012010,1,101,101,1,psa_20,1D1
1000000US110010074011028,"Block 1028, Block Group 1, Census Tract 74.01, District of Columbia, District of Columbia",0,0,0,0,0,0,0,0,0,0,0,0,0,0,0,0,0,0,0,0,0,0,0,0,0,110010074011028,7,703,703,7,psa_8,7D1
1000000US110010016004030,"Block 4030, Block Group 4, Census Tract 16, District of Columbia, District of Columbia",0,0,0,0,0,0,0,0,0,0,0,0,0,0,0,0,0,0,0,0,0,0,0,0,0,110010016004030,2,201,201,2,psa_55,2D1
1000000US110010024003004,"Block 3004, Block Group 3, Census Tract 24, District of Columbia, District of Columbia",129,45,71,1,2,0,9,1,129,110,36,70,1,2,0,0,1,19,9,1,0,0,0,9,0,110010024003004,4,407,407,4,psa_47,4D2
1000000US110010078083000,"Block 3000, Block Group 3, Census Tract 78.08, District of Columbia, District of Columbia",35,0,29,0,0,0,1,5,35,34,0,29,0,0,0,0,5,1,0,0,0,0,0,1,0,110010078083000,6,608,608,6,psa_19,6D1
1000000US110010091021011,"Block 1011, Block Group 1, Census Tract 91.02, District of Columbia, District of Columbia",33,0,33,0,0,0,0,0,33,33,0,33,0,0,0,0,0,0,0,0,0,0,0,0,0,110010091021011,5,505,505,5,psa_34,5D2
1000000US110010098011013,"Block 1013, Block Group 1, Census Tract 98.01, District of Columbia, District of Columbia",214,5,206,1,0,0,0,2,214,206,3,201,1,0,0,0,1,8,2,5,0,0,0,0,1,110010098011013,7,706,706,7,psa_2,7D3
1000000US110010092041004,"Block 1004, Block Group 1, Census Tract 92.04, District of Columbia, District of Columbia",114,23,76,0,3,0,9,3,114,101,21,75,0,3,0,0,2,13,2,1,0,0,0,9,1,110010092041004,5,502,502,5,psa_40,5D1
1000000US110010102001000,"Block 1000, Block Group 1, Census Tract 102, District of Columbia, District of Columbia",0,0,0,0,0,0,0,0,0,0,0,0,0,0,0,0,0,0,0,0,0,0,0,0,0,110010102001000,1,103,103,1,psa_12,1D1
1000000US110010107001021,"Block 1021, Block Group 1, Census Tract 107, District of Columbia, District of Columbia",0,0,0,0,0,0,0,0,0,0,0,0,0,0,0,0,0,0,0,0,0,0,0,0,0,110010107001021,2,207,207,2,psa_24,2D3
1000000US110010013023004,"Block 3004, Block Group 3, Census Tract 13.02, District of Columbia, District of Columbia",0,0,0,0,0,0,0,0,0,0,0,0,0,0,0,0,0,0,0,0,0,0,0,0,0,110010013023004,2,203,203,2,psa_50,2D1
1000000US110010099042002,"Block 2002, Block Group 2, Census Tract 99.04, District of Columbia, District of Columbia",96,1,89,0,0,0,0,6,96,90,1,87,0,0,0,0,2,6,0,2,0,0,0,0,4,110010099042002,6,604,604,6,psa_14,6D3
1000000US110010077091029,"Block 1029, Block Group 1, Census Tract 77.09, District of Columbia, District of Columbia",107,7,96,0,0,0,3,1,107,101,4,96,0,0,0,0,1,6,3,0,0,0,0,3,0,110010077091029,6,605,605,6,psa_11,6D2
1000000US110010008022005,"Block 2005, Block Group 2, Census Tract 8.02, District of Columbia, District of Columbia",6,6,0,0,0,0,0,0,6,6,6,0,0,0,0,0,0,0,0,0,0,0,0,0,0,110010008022005,2,205,205,2,psa_46,2D2
1000000US110010010016010,"Block 6010, Block Group 6, Census Tract 10.01, District of Columbia, District of Columbia",59,54,1,0,3,0,1,0,59,53,49,1,0,3,0,0,0,6,5,0,0,0,0,1,0,110010010016010,2,202,202,2,psa_52,2D1
1000000US110010042022006,"Block 2006, Block Group 2, Census Tract 42.02, District of Columbia, District of Columbia",0,0,0,0,0,0,0,0,0,0,0,0,0,0,0,0,0,0,0,0,0,0,0,0,0,110010042022006,2,208,208,2,psa_33,2D3
1000000US110010099012015,"Block 2015, Block Group 2, Census Tract 99.01, District of Columbia, District of Columbia",73,6,63,4,0,0,0,0,73,73,6,63,4,0,0,0,0,0,0,0,0,0,0,0,0,110010099012015,6,605,605,6,psa_11,6D2
1000000US110010067001004,"Block 1004, Block Group 1, Census Tract 67, District of Columbia, District of Columbia",264,219,31,2,2,1,8,1,264,246,206,31,2,2,1,3,1,18,13,0,0,0,0,5,0,110010067001004,1,107,107,1,psa_16,1D2
1000000US110010087012001,"Block 2001, Block Group 2, Census Tract 87.01, District of Columbia, District of Columbia",120,12,105,0,0,1,0,2,120,118,11,105,0,0,0,0,2,2,1,0,0,0,1,0,0,110010087012001,5,502,502,5,psa_40,5D1
1000000US110010079014006,"Block 4006, Block Group 4, Census Tract 79.01, District of Columbia, District of Columbia",5,4,0,0,0,0,1,0,5,5,4,0,0,0,0,1,0,0,0,0,0,0,0,0,0,110010079014006,5,507,507,5,psa_23,5D3
1000000US110010020023009,"Block 3009, Block Group 3, Census Tract 20.02, District of Columbia, District of Columbia",61,13,42,1,1,0,1,3,61,59,13,42,0,1,0,0,3,2,0,0,1,0,0,1,0,110010020023009,4,404,404,4,psa_48,4D3
1000000US110010041002011,"Block 2011, Block Group 2, Census Tract 41, District of Columbia, District of Columbia",0,0,0,0,0,0,0,0,0,0,0,0,0,0,0,0,0,0,0,0,0,0,0,0,0,110010041002011,2,208,208,2,psa_33,2D3
1000000US110010073011049,"Block 1049, Block Group 1, Census Tract 73.01, District of Columbia, District of Columbia",0,0,0,0,0,0,0,0,0,0,0,0,0,0,0,0,0,0,0,0,0,0,0,0,0,110010073011049,7,708,708,7,psa_1,7D3
1000000US110010093012016,"Block 2016, Block Group 2, Census Tract 93.01, District of Columbia, District of Columbia",10,4,5,0,0,0,0,1,10,10,4,5,0,0,0,0,1,0,0,0,0,0,0,0,0,110010093012016,5,504,504,5,psa_43,5D2
1000000US110010110001001,"Block 1001, Block Group 1, Census Tract 110, District of Columbia, District of Columbia",0,0,0,0,0,0,0,0,0,0,0,0,0,0,0,0,0,0,0,0,0,0,0,0,0,110010110001001,1,105,105,1,psa_22,1D3
1000000US110010020021018,"Block 1018, Block Group 1, Census Tract 20.02, District of Columbia, District of Columbia",0,0,0,0,0,0,0,0,0,0,0,0,0,0,0,0,0,0,0,0,0,0,0,0,0,110010020021018,4,404,404,4,psa_48,4D3
1000000US110010010014006,"Block 4006, Block Group 4, Census Tract 10.01, District of Columbia, District of Columbia",76,61,0,0,10,0,1,4,76,73,60,0,0,10,0,0,3,3,1,0,0,0,0,1,1,110010010014006,2,202,202,2,psa_52,2D1
1000000US110010010022003,"Block 2003, Block Group 2, Census Tract 10.02, District of Columbia, District of Columbia",350,313,12,0,12,0,5,8,350,330,294,12,0,12,0,4,8,20,19,0,0,0,0,1,0,110010010022003,2,204,204,2,psa_44,2D2
1000000US110010041001003,"Block 1003, Block Group 1, Census Tract 41, District of Columbia, District of Columbia",139,123,3,0,9,0,1,3,139,130,116,3,0,9,0,0,2,9,7,0,0,0,0,1,1,110010041001003,2,208,208,2,psa_33,2D3
1000000US110010074011009,"Block 1009, Block Group 1, Census Tract 74.01, District of Columbia, District of Columbia",0,0,0,0,0,0,0,0,0,0,0,0,0,0,0,0,0,0,0,0,0,0,0,0,0,110010074011009,7,701,701,7,psa_9,7D1
1000000US110010093012020,"Block 2020, Block Group 2, Census Tract 93.01, District of Columbia, District of Columbia",54,12,41,1,0,0,0,0,54,54,12,41,1,0,0,0,0,0,0,0,0,0,0,0,0,110010093012020,5,504,504,5,psa_43,5D2
1000000US110010096011025,"Block 1025, Block Group 1, Census Tract 96.01, District of Columbia, District of Columbia",70,7,62,0,0,0,0,1,70,63,0,62,0,0,0,0,1,7,7,0,0,0,0,0,0,110010096011025,6,601,601,6,psa_30,6D1
1000000US110010077091015,"Block 1015, Block Group 1, Census Tract 77.09, District of Columbia, District of Columbia",28,0,28,0,0,0,0,0,28,28,0,28,0,0,0,0,0,0,0,0,0,0,0,0,0,110010077091015,6,605,605,6,psa_11,6D2
1000000US110010096033000,"Block 3000, Block Group 3, Census Tract 96.03, District of Columbia, District of Columbia",258,1,256,0,0,0,1,0,258,256,0,256,0,0,0,0,0,2,1,0,0,0,0,1,0,110010096033000,6,603,603,6,psa_15,6D3
1000000US110010104002028,"Block 2028, Block Group 2, Census Tract 104, District of Columbia, District of Columbia",0,0,0,0,0,0,0,0,0,0,0,0,0,0,0,0,0,0,0,0,0,0,0,0,0,110010104002028,7,703,703,7,psa_8,7D1
1000000US110010013011008,"Block 1008, Block Group 1, Census Tract 13.01, District of Columbia, District of Columbia",29,26,0,0,2,0,0,1,29,28,25,0,0,2,0,0,1,1,1,0,0,0,0,0,0,110010013011008,2,203,203,2,psa_50,2D1
1000000US110010078061013,"Block 1013, Block Group 1, Census Tract 78.06, District of Columbia, District of Columbia",94,6,86,1,0,0,0,1,94,84,0,82,1,0,0,0,1,10,6,4,0,0,0,0,0,110010078061013,6,602,602,6,psa_25,6D1
1000000US110010008014010,"Block 4010, Block Group 4, Census Tract 8.01, District of Columbia, District of Columbia",0,0,0,0,0,0,0,0,0,0,0,0,0,0,0,0,0,0,0,0,0,0,0,0,0,110010008014010,2,205,205,2,psa_46,2D2
1000000US110010073011115,"Block 1115, Block Group 1, Census Tract 73.01, District of Columbia, District of Columbia",0,0,0,0,0,0,0,0,0,0,0,0,0,0,0,0,0,0,0,0,0,0,0,0,0,110010073011115,7,708,708,7,psa_1,7D3
1000000US110010010012005,"Block 2005, Block Group 2, Census Tract 10.01, District of Columbia, District of Columbia",96,79,9,0,4,0,0,4,96,92,75,9,0,4,0,0,4,4,4,0,0,0,0,0,0,110010010012005,2,202,202,2,psa_52,2D1
1000000US110010003004005,"Block 4005, Block Group 4, Census Tract 3, District of Columbia, District of Columbia",166,159,2,0,4,0,1,0,166,158,152,2,0,4,0,0,0,8,7,0,0,0,0,1,0,110010003004005,2,204,204,2,psa_44,2D2
1000000US110010012001010,"Block 1010, Block Group 1, Census Tract 12, District of Columbia, District of Columbia",112,93,5,0,6,0,3,5,112,106,92,5,0,6,0,0,3,6,1,0,0,0,0,3,2,110010012001010,2,203,203,2,psa_50,2D1
1000000US110010062021117,"Block 1117, Block Group 1, Census Tract 62.02, District of Columbia, District of Columbia",0,0,0,0,0,0,0,0,0,0,0,0,0,0,0,0,0,0,0,0,0,0,0,0,0,110010062021117,1,102,102,1,psa_18,1D1
1000000US110010073011035,"Block 1035, Block Group 1, Census Tract 73.01, District of Columbia, District of Columbia",31,17,4,0,0,0,0,10,31,27,14,4,0,0,0,0,9,4,3,0,0,0,0,0,1,110010073011035,7,707,707,7,psa_4,7D2
1000000US110010028022001,"Block 2001, Block Group 2, Census Tract 28.02, District of Columbia, District of Columbia",772,288,78,19,30,0,305,52,772,250,138,71,2,30,0,0,9,522,150,7,17,0,0,305,43,110010028022001,3,302,302,3,psa_42,3D1
1000000US110010031001016,"Block 1016, Block Group 1, Census Tract 31, District of Columbia, District of Columbia",193,57,94,10,2,0,18,12,193,149,52,89,0,2,0,0,6,44,5,5,10,0,0,18,6,110010031001016,3,304,304,3,psa_36,3D1
1000000US110010018032003,"Block 2003, Block Group 2, Census Tract 18.03, District of Columbia, District of Columbia",429,41,295,0,12,0,59,22,429,356,34,291,0,12,0,5,14,73,7,4,0,0,0,54,8,110010018032003,4,402,402,4,psa_53,4D1
1000000US110010073011060,"Block 1060, Block Group 1, Census Tract 73.01, District of Columbia, District of Columbia",0,0,0,0,0,0,0,0,0,0,0,0,0,0,0,0,0,0,0,0,0,0,0,0,0,110010073011060,7,708,708,7,psa_1,7D3
1000000US110010053011002,"Block 1002, Block Group 1, Census Tract 53.01, District of Columbia, District of Columbia",276,230,22,0,9,0,9,6,276,250,215,20,0,9,0,0,6,26,15,2,0,0,0,9,0,110010053011002,3,301,301,3,psa_31,3D3
1000000US110010084101000,"Block 1000, Block Group 1, Census Tract 84.10, District of Columbia, District of Columbia",0,0,0,0,0,0,0,0,0,0,0,0,0,0,0,0,0,0,0,0,0,0,0,0,0,110010084101000,1,104,104,1,psa_21,1D2
1000000US110010095081003,"Block 1003, Block Group 1, Census Tract 95.08, District of Columbia, District of Columbia",188,55,115,1,5,0,2,10,188,176,48,115,1,4,0,0,8,12,7,0,0,1,0,2,2,110010095081003,4,406,406,4,psa_54,4D2
1000000US110010077072019,"Block 2019, Block Group 2, Census Tract 77.07, District of Columbia, District of Columbia",52,8,44,0,0,0,0,0,52,52,8,44,0,0,0,0,0,0,0,0,0,0,0,0,0,110010077072019,6,604,604,6,psa_14,6D3
1000000US110010058002017,"Block 2017, Block Group 2, Census Tract 58, District of Columbia, District of Columbia",0,0,0,0,0,0,0,0,0,0,0,0,0,0,0,0,0,0,0,0,0,0,0,0,0,110010058002017,1,102,102,1,psa_18,1D1
1000000US110010103001004,"Block 1004, Block Group 1, Census Tract 103, District of Columbia, District of Columbia",0,0,0,0,0,0,0,0,0,0,0,0,0,0,0,0,0,0,0,0,0,0,0,0,0,110010103001004,4,401,401,4,psa_56,4D1
1000000US110010019021017,"Block 1017, Block Group 1, Census Tract 19.02, District of Columbia, District of Columbia",71,6,65,0,0,0,0,0,71,71,6,65,0,0,0,0,0,0,0,0,0,0,0,0,0,110010019021017,4,402,402,4,psa_53,4D1
1000000US110010020023013,"Block 3013, Block Group 3, Census Tract 20.02, District of Columbia, District of Columbia",0,0,0,0,0,0,0,0,0,0,0,0,0,0,0,0,0,0,0,0,0,0,0,0,0,110010020023013,4,404,404,4,psa_48,4D3
1000000US110010109002037,"Block 2037, Block Group 2, Census Tract 109, District of Columbia, District of Columbia",0,0,0,0,0,0,0,0,0,0,0,0,0,0,0,0,0,0,0,0,0,0,0,0,0,110010109002037,7,708,708,7,psa_1,7D3
1000000US110010074071012,"Block 1012, Block Group 1, Census Tract 74.07, District of Columbia, District of Columbia",23,2,21,0,0,0,0,0,23,23,2,21,0,0,0,0,0,0,0,0,0,0,0,0,0,110010074071012,7,702,702,7,psa_6,7D1
1000000US110010103001000,"Block 1000, Block Group 1, Census Tract 103, District of Columbia, District of Columbia",0,0,0,0,0,0,0,0,0,0,0,0,0,0,0,0,0,0,0,0,0,0,0,0,0,110010103001000,4,401,401,4,psa_56,4D1
1000000US110010002024011,"Block 4011, Block Group 4, Census Tract 2.02, District of Columbia, District of Columbia",0,0,0,0,0,0,0,0,0,0,0,0,0,0,0,0,0,0,0,0,0,0,0,0,0,110010002024011,2,205,205,2,psa_46,2D2
1000000US110010013011005,"Block 1005, Block Group 1, Census Tract 13.01, District of Columbia, District of Columbia",33,23,4,0,3,0,0,3,33,28,18,4,0,3,0,0,3,5,5,0,0,0,0,0,0,110010013011005,2,203,203,2,psa_50,2D1
1000000US110010084022005,"Block 2005, Block Group 2, Census Tract 84.02, District of Columbia, District of Columbia",110,80,16,0,5,0,0,9,110,107,78,15,0,5,0,0,9,3,2,1,0,0,0,0,0,110010084022005,1,104,104,1,psa_21,1D2
1000000US110010096033001,"Block 3001, Block Group 3, Census Tract 96.03, District of Columbia, District of Columbia",261,0,257,1,0,0,0,3,261,250,0,249,0,0,0,0,1,11,0,8,1,0,0,0,2,110010096033001,6,603,603,6,psa_15,6D3
1000000US110010008021005,"Block 1005, Block Group 1, Census Tract 8.02, District of Columbia, District of Columbia",0,0,0,0,0,0,0,0,0,0,0,0,0,0,0,0,0,0,0,0,0,0,0,0,0,110010008021005,2,205,205,2,psa_46,2D2
1000000US110010010012016,"Block 2016, Block Group 2, Census Tract 10.01, District of Columbia, District of Columbia",13,12,0,0,1,0,0,0,13,12,11,0,0,1,0,0,0,1,1,0,0,0,0,0,0,110010010012016,2,202,202,2,psa_52,2D1
1000000US110010062021041,"Block 1041, Block Group 1, Census Tract 62.02, District of Columbia, District of Columbia",0,0,0,0,0,0,0,0,0,0,0,0,0,0,0,0,0,0,0,0,0,0,0,0,0,110010062021041,2,207,207,2,psa_24,2D3
1000000US110010010016002,"Block 6002, Block Group 6, Census Tract 10.01, District of Columbia, District of Columbia",43,43,0,0,0,0,0,0,43,39,39,0,0,0,0,0,0,4,4,0,0,0,0,0,0,110010010016002,2,202,202,2,psa_52,2D1
1000000US110010068022014,"Block 2014, Block Group 2, Census Tract 68.02, District of Columbia, District of Columbia",96,29,61,0,6,0,0,0,96,92,25,61,0,6,0,0,0,4,4,0,0,0,0,0,0,110010068022014,1,107,107,1,psa_16,1D2
1000000US110010073011061,"Block 1061, Block Group 1, Census Tract 73.01, District of Columbia, District of Columbia",0,0,0,0,0,0,0,0,0,0,0,0,0,0,0,0,0,0,0,0,0,0,0,0,0,110010073011061,7,708,708,7,psa_1,7D3
1000000US110010043001006,"Block 1006, Block Group 1, Census Tract 43, District of Columbia, District of Columbia",389,30,325,8,4,0,15,7,389,369,28,323,8,4,0,0,6,20,2,2,0,0,0,15,1,110010043001006,3,301,301,3,psa_31,3D3
1000000US110010004002017,"Block 2017, Block Group 2, Census Tract 4, District of Columbia, District of Columbia",0,0,0,0,0,0,0,0,0,0,0,0,0,0,0,0,0,0,0,0,0,0,0,0,0,110010004002017,2,204,204,2,psa_44,2D2
1000000US110010062021148,"Block 1148, Block Group 1, Census Tract 62.02, District of Columbia, District of Columbia",0,0,0,0,0,0,0,0,0,0,0,0,0,0,0,0,0,0,0,0,0,0,0,0,0,110010062021148,1,103,103,1,psa_12,1D1
1000000US110010022022003,"Block 2003, Block Group 2, Census Tract 22.02, District of Columbia, District of Columbia",90,9,51,0,2,0,25,3,90,59,4,51,0,2,0,0,2,31,5,0,0,0,0,25,1,110010022022003,4,407,407,4,psa_47,4D2
1000000US110010042012005,"Block 2005, Block Group 2, Census Tract 42.01, District of Columbia, District of Columbia",438,367,22,1,29,0,8,11,438,411,347,22,1,29,0,1,11,27,20,0,0,0,0,7,0,110010042012005,3,301,301,3,psa_31,3D3
1000000US110010062021222,"Block 1222, Block Group 1, Census Tract 62.02, District of Columbia, District of Columbia",0,0,0,0,0,0,0,0,0,0,0,0,0,0,0,0,0,0,0,0,0,0,0,0,0,110010062021222,2,207,207,2,psa_24,2D3
1000000US110010078072004,"Block 2004, Block Group 2, Census Tract 78.07, District of Columbia, District of Columbia",17,0,17,0,0,0,0,0,17,17,0,17,0,0,0,0,0,0,0,0,0,0,0,0,0,110010078072004,6,608,608,6,psa_19,6D1
1000000US110010059001002,"Block 1002, Block Group 1, Census Tract 59, District of Columbia, District of Columbia",0,0,0,0,0,0,0,0,0,0,0,0,0,0,0,0,0,0,0,0,0,0,0,0,0,110010059001002,1,102,102,1,psa_18,1D1
1000000US110010062021174,"Block 1174, Block Group 1, Census Tract 62.02, District of Columbia, District of Columbia",0,0,0,0,0,0,0,0,0,0,0,0,0,0,0,0,0,0,0,0,0,0,0,0,0,110010062021174,2,207,207,2,psa_24,2D3
1000000US110010091023001,"Block 3001, Block Group 3, Census Tract 91.02, District of Columbia, District of Columbia",359,3,345,1,1,0,1,8,359,357,2,345,1,1,0,0,8,2,1,0,0,0,0,1,0,110010091023001,5,505,505,5,psa_34,5D2
1000000US110010065002019,"Block 2019, Block Group 2, Census Tract 65, District of Columbia, District of Columbia",0,0,0,0,0,0,0,0,0,0,0,0,0,0,0,0,0,0,0,0,0,0,0,0,0,110010065002019,1,106,106,1,psa_13,1D3
1000000US110010094004007,"Block 4007, Block Group 4, Census Tract 94, District of Columbia, District of Columbia",30,0,30,0,0,0,0,0,30,30,0,30,0,0,0,0,0,0,0,0,0,0,0,0,0,110010094004007,5,503,503,5,psa_45,5D2
1000000US110010098102003,"Block 2003, Block Group 2, Census Tract 98.10, District of Columbia, District of Columbia",131,1,130,0,0,0,0,0,131,130,1,129,0,0,0,0,0,1,0,1,0,0,0,0,0,110010098102003,7,708,708,7,psa_1,7D3
1000000US110010049022004,"Block 2004, Block Group 2, Census Tract 49.02, District of Columbia, District of Columbia",247,149,32,1,20,0,33,12,247,187,128,32,1,20,0,0,6,60,21,0,0,0,0,33,6,110010049022004,3,307,307,3,psa_28,3D3
1000000US110010015002004,"Block 2004, Block Group 2, Census Tract 15, District of Columbia, District of Columbia",45,44,1,0,0,0,0,0,45,38,37,1,0,0,0,0,0,7,7,0,0,0,0,0,0,110010015002004,2,201,201,2,psa_55,2D1
1000000US110010033013002,"Block 3002, Block Group 3, Census Tract 33.01, District of Columbia, District of Columbia",161,47,106,0,0,0,2,6,161,157,44,106,0,0,0,2,5,4,3,0,0,0,0,0,1,110010033013002,3,306,306,3,psa_38,3D2
1000000US110010088022007,"Block 2007, Block Group 2, Census Tract 88.02, District of Columbia, District of Columbia",74,11,63,0,0,0,0,0,74,74,11,63,0,0,0,0,0,0,0,0,0,0,0,0,0,110010088022007,5,506,506,5,psa_26,5D3
1000000US110010102002018,"Block 2018, Block Group 2, Census Tract 102, District of Columbia, District of Columbia",0,0,0,0,0,0,0,0,0,0,0,0,0,0,0,0,0,0,0,0,0,0,0,0,0,110010102002018,1,103,103,1,psa_12,1D1
1000000US110010078071009,"Block 1009, Block Group 1, Census Tract 78.07, District of Columbia, District of Columbia",94,0,94,0,0,0,0,0,94,94,0,94,0,0,0,0,0,0,0,0,0,0,0,0,0,110010078071009,6,608,608,6,psa_19,6D1
1000000US110010076012002,"Block 2002, Block Group 2, Census Tract 76.01, District of Columbia, District of Columbia",71,0,70,0,0,0,0,1,71,71,0,70,0,0,0,0,1,0,0,0,0,0,0,0,0,110010076012002,6,607,607,6,psa_10,6D2
1000000US110010017021000,"Block 1000, Block Group 1, Census Tract 17.02, District of Columbia, District of Columbia",16,3,4,0,9,0,0,0,16,16,3,4,0,9,0,0,0,0,0,0,0,0,0,0,0,110010017021000,4,401,401,4,psa_56,4D1
1000000US110010021025002,"Block 5002, Block Group 5, Census Tract 21.02, District of Columbia, District of Columbia",184,13,133,0,0,0,33,5,184,136,4,132,0,0,0,0,0,48,9,1,0,0,0,33,5,110010021025002,4,403,403,4,psa_51,4D1
1000000US110010021022005,"Block 2005, Block Group 2, Census Tract 21.02, District of Columbia, District of Columbia",87,0,70,1,0,0,16,0,87,58,0,57,1,0,0,0,0,29,0,13,0,0,0,16,0,110010021022005,4,403,403,4,psa_51,4D1
1000000US110010029002008,"Block 2008, Block Group 2, Census Tract 29, District of Columbia, District of Columbia",172,74,43,0,7,0,41,7,172,98,47,41,0,7,0,0,3,74,27,2,0,0,0,41,4,110010029002008,4,408,408,4,psa_39,4D3
1000000US110010052014000,"Block 4000, Block Group 4, Census Tract 52.01, District of Columbia, District of Columbia",152,118,8,0,14,0,4,8,152,142,110,8,0,14,0,2,8,10,8,0,0,0,0,2,0,110010052014000,3,301,301,3,psa_31,3D3
1000000US110010095053011,"Block 3011, Block Group 3, Census Tract 95.05, District of Columbia, District of Columbia",21,0,21,0,0,0,0,0,21,21,0,21,0,0,0,0,0,0,0,0,0,0,0,0,0,110010095053011,4,406,406,4,psa_54,4D2
1000000US110010008014011,"Block 4011, Block Group 4, Census Tract 8.01, District of Columbia, District of Columbia",115,100,3,0,7,0,0,5,115,107,94,1,0,7,0,0,5,8,6,2,0,0,0,0,0,110010008014011,2,205,205,2,psa_46,2D2
1000000US110010103003003,"Block 3003, Block Group 3, Census Tract 103, District of Columbia, District of Columbia",44,17,23,0,0,0,0,4,44,41,14,23,0,0,0,0,4,3,3,0,0,0,0,0,0,110010103003003,4,401,401,4,psa_56,4D1
1000000US110010111001030,"Block 1030, Block Group 1, Census Tract 111, District of Columbia, District of Columbia",0,0,0,0,0,0,0,0,0,0,0,0,0,0,0,0,0,0,0,0,0,0,0,0,0,110010111001030,5,503,503,5,psa_45,5D2
1000000US110010016004032,"Block 4032, Block Group 4, Census Tract 16, District of Columbia, District of Columbia",33,18,12,0,0,0,0,3,33,30,18,9,0,0,0,0,3,3,0,3,0,0,0,0,0,110010016004032,4,401,401,4,psa_56,4D1
1000000US110010066001009,"Block 1009, Block Group 1, Census Tract 66, District of Columbia, District of Columbia",104,90,5,1,2,0,2,4,104,96,85,5,0,2,0,0,4,8,5,0,1,0,0,2,0,110010066001009,1,107,107,1,psa_16,1D2
1000000US110010073011102,"Block 1102, Block Group 1, Census Tract 73.01, District of Columbia, District of Columbia",0,0,0,0,0,0,0,0,0,0,0,0,0,0,0,0,0,0,0,0,0,0,0,0,0,110010073011102,7,708,708,7,psa_1,7D3
1000000US110010095092012,"Block 2012, Block Group 2, Census Tract 95.09, District of Columbia, District of Columbia",111,15,96,0,0,0,0,0,111,106,10,96,0,0,0,0,0,5,5,0,0,0,0,0,0,110010095092012,4,405,405,4,psa_49,4D2
1000000US110010111003053,"Block 3053, Block Group 3, Census Tract 111, District of Columbia, District of Columbia",0,0,0,0,0,0,0,0,0,0,0,0,0,0,0,0,0,0,0,0,0,0,0,0,0,110010111003053,5,507,507,5,psa_23,5D3
1000000US110010006001001,"Block 1001, Block Group 1, Census Tract 6, District of Columbia, District of Columbia",207,190,4,1,8,0,1,3,207,191,176,4,0,8,0,0,3,16,14,0,1,0,0,1,0,110010006001001,2,203,203,2,psa_50,2D1
1000000US110010024004006,"Block 4006, Block Group 4, Census Tract 24, District of Columbia, District of Columbia",46,6,36,0,0,0,3,1,46,42,6,36,0,0,0,0,0,4,0,0,0,0,0,3,1,110010024004006,4,407,407,4,psa_47,4D2
1000000US110010039002002,"Block 2002, Block Group 2, Census Tract 39, District of Columbia, District of Columbia",60,47,10,0,0,0,0,3,60,57,45,10,0,0,0,0,2,3,2,0,0,0,0,0,1,110010039002002,3,303,303,3,psa_37,3D3
1000000US110010093011003,"Block 1003, Block Group 1, Census Tract 93.01, District of Columbia, District of Columbia",37,4,33,0,0,0,0,0,37,37,4,33,0,0,0,0,0,0,0,0,0,0,0,0,0,110010093011003,5,504,504,5,psa_43,5D2
1000000US110010111003033,"Block 3033, Block Group 3, Census Tract 111, District of Columbia, District of Columbia",0,0,0,0,0,0,0,0,0,0,0,0,0,0,0,0,0,0,0,0,0,0,0,0,0,110010111003033,5,503,503,5,psa_45,5D2
1000000US110010062021048,"Block 1048, Block Group 1, Census Tract 62.02, District of Columbia, District of Columbia",0,0,0,0,0,0,0,0,0,0,0,0,0,0,0,0,0,0,0,0,0,0,0,0,0,110010062021048,2,207,207,2,psa_24,2D3
1000000US110010088022005,"Block 2005, Block Group 2, Census Tract 88.02, District of Columbia, District of Columbia",78,0,77,0,0,0,0,1,78,78,0,77,0,0,0,0,1,0,0,0,0,0,0,0,0,110010088022005,5,506,506,5,psa_26,5D3
1000000US110010005011012,"Block 1012, Block Group 1, Census Tract 5.01, District of Columbia, District of Columbia",672,543,51,5,39,1,18,15,672,622,517,49,1,39,1,3,12,50,26,2,4,0,0,15,3,110010005011012,2,204,204,2,psa_44,2D2
1000000US110010022011001,"Block 1001, Block Group 1, Census Tract 22.01, District of Columbia, District of Columbia",95,20,51,1,0,0,16,7,95,52,2,50,0,0,0,0,0,43,18,1,1,0,0,16,7,110010022011001,4,407,407,4,psa_47,4D2
1000000US110010077071008,"Block 1008, Block Group 1, Census Tract 77.07, District of Columbia, District of Columbia",179,0,179,0,0,0,0,0,179,176,0,176,0,0,0,0,0,3,0,3,0,0,0,0,0,110010077071008,6,604,604,6,psa_14,6D3
1000000US110010101001017,"Block 1017, Block Group 1, Census Tract 101, District of Columbia, District of Columbia",0,0,0,0,0,0,0,0,0,0,0,0,0,0,0,0,0,0,0,0,0,0,0,0,0,110010101001017,2,207,207,2,psa_24,2D3
1000000US110010096011018,"Block 1018, Block Group 1, Census Tract 96.01, District of Columbia, District of Columbia",87,0,87,0,0,0,0,0,87,86,0,86,0,0,0,0,0,1,0,1,0,0,0,0,0,110010096011018,6,601,601,6,psa_30,6D1
1000000US110010009012012,"Block 2012, Block Group 2, Census Tract 9.01, District of Columbia, District of Columbia",65,62,2,0,0,0,0,1,65,58,55,2,0,0,0,0,1,7,7,0,0,0,0,0,0,110010009012012,2,205,205,2,psa_46,2D2
1000000US110010010014013,"Block 4013, Block Group 4, Census Tract 10.01, District of Columbia, District of Columbia",21,18,1,0,2,0,0,0,21,19,16,1,0,2,0,0,0,2,2,0,0,0,0,0,0,110010010014013,2,202,202,2,psa_52,2D1
1000000US110010015001032,"Block 1032, Block Group 1, Census Tract 15, District of Columbia, District of Columbia",56,39,9,0,4,0,0,4,56,55,38,9,0,4,0,0,4,1,1,0,0,0,0,0,0,110010015001032,2,201,201,2,psa_55,2D1
1000000US110010080022005,"Block 2005, Block Group 2, Census Tract 80.02, District of Columbia, District of Columbia",82,31,41,1,1,0,0,8,82,80,30,41,0,1,0,0,8,2,1,0,1,0,0,0,0,110010080022005,1,108,108,1,psa_17,1D2
1000000US110010019014008,"Block 4008, Block Group 4, Census Tract 19.01, District of Columbia, District of Columbia",96,14,61,1,2,0,16,2,96,81,13,61,1,2,0,3,1,15,1,0,0,0,0,13,1,110010019014008,4,402,402,4,psa_53,4D1
1000000US110010093012007,"Block 2007, Block Group 2, Census Tract 93.01, District of Columbia, District of Columbia",0,0,0,0,0,0,0,0,0,0,0,0,0,0,0,0,0,0,0,0,0,0,0,0,0,110010093012007,5,504,504,5,psa_43,5D2
1000000US110010043001004,"Block 1004, Block Group 1, Census Tract 43, District of Columbia, District of Columbia",81,70,9,0,0,0,0,2,81,74,63,9,0,0,0,0,2,7,7,0,0,0,0,0,0,110010043001004,3,301,301,3,psa_31,3D3
1000000US110010069001015,"Block 1015, Block Group 1, Census Tract 69, District of Columbia, District of Columbia",18,16,0,0,1,0,0,1,18,16,15,0,0,1,0,0,0,2,1,0,0,0,0,0,1,110010069001015,1,107,107,1,psa_16,1D2
1000000US110010074011015,"Block 1015, Block Group 1, Census Tract 74.01, District of Columbia, District of Columbia",1,0,1,0,0,0,0,0,1,1,0,1,0,0,0,0,0,0,0,0,0,0,0,0,0,110010074011015,7,703,703,7,psa_8,7D1
1000000US110010022013006,"Block 3006, Block Group 3, Census Tract 22.01, District of Columbia, District of Columbia",101,7,79,0,11,0,4,0,101,100,7,79,0,11,0,3,0,1,0,0,0,0,0,1,0,110010022013006,4,407,407,4,psa_47,4D2
1000000US110010072002041,"Block 2041, Block Group 2, Census Tract 72, District of Columbia, District of Columbia",0,0,0,0,0,0,0,0,0,0,0,0,0,0,0,0,0,0,0,0,0,0,0,0,0,110010072002041,1,106,106,1,psa_13,1D3
1000000US110010001004001,"Block 4001, Block Group 4, Census Tract 1, District of Columbia, District of Columbia",72,61,5,0,4,0,0,2,72,63,55,4,0,4,0,0,0,9,6,1,0,0,0,0,2,110010001004001,2,206,206,2,psa_29,2D2
1000000US110010099051008,"Block 1008, Block Group 1, Census Tract 99.05, District of Columbia, District of Columbia",156,0,147,3,0,0,0,6,156,148,0,144,3,0,0,0,1,8,0,3,0,0,0,0,5,110010099051008,6,604,604,6,psa_14,6D3
1000000US110010034002020,"Block 2020, Block Group 2, Census Tract 34, District of Columbia, District of Columbia",61,30,27,1,2,0,0,1,61,58,30,26,0,2,0,0,0,3,0,1,1,0,0,0,1,110010034002020,3,306,306,3,psa_38,3D2
1000000US110010007021002,"Block 1002, Block Group 1, Census Tract 7.02, District of Columbia, District of Columbia",184,152,10,1,10,0,5,6,184,160,136,9,1,10,0,0,4,24,16,1,0,0,0,5,2,110010007021002,2,204,204,2,psa_44,2D2
1000000US110010059001040,"Block 1040, Block Group 1, Census Tract 59, District of Columbia, District of Columbia",0,0,0,0,0,0,0,0,0,0,0,0,0,0,0,0,0,0,0,0,0,0,0,0,0,110010059001040,1,102,102,1,psa_18,1D1
1000000US110010071001001,"Block 1001, Block Group 1, Census Tract 71, District of Columbia, District of Columbia",50,13,36,0,0,0,0,1,50,46,12,33,0,0,0,0,1,4,1,3,0,0,0,0,0,110010071001001,1,106,106,1,psa_13,1D3
1000000US110010031001008,"Block 1008, Block Group 1, Census Tract 31, District of Columbia, District of Columbia",226,61,92,2,6,0,62,3,226,136,40,89,0,6,0,0,1,90,21,3,2,0,0,62,2,110010031001008,4,409,409,4,psa_41,4D3
1000000US110010084021009,"Block 1009, Block Group 1, Census Tract 84.02, District of Columbia, District of Columbia",31,16,15,0,0,0,0,0,31,30,15,15,0,0,0,0,0,1,1,0,0,0,0,0,0,110010084021009,1,104,104,1,psa_21,1D2
1000000US110010009021006,"Block 1006, Block Group 1, Census Tract 9.02, District of Columbia, District of Columbia",44,44,0,0,0,0,0,0,44,42,42,0,0,0,0,0,0,2,2,0,0,0,0,0,0,110010009021006,2,205,205,2,psa_46,2D2
1000000US110010083011005,"Block 1005, Block Group 1, Census Tract 83.01, District of Columbia, District of Columbia",287,216,56,1,4,0,4,6,287,268,206,52,1,4,0,0,5,19,10,4,0,0,0,4,1,110010083011005,1,104,104,1,psa_21,1D2
1000000US110010002024004,"Block 4004, Block Group 4, Census Tract 2.02, District of Columbia, District of Columbia",774,606,51,0,87,1,9,20,774,725,569,50,0,87,1,3,15,49,37,1,0,0,0,6,5,110010002024004,2,206,206,2,psa_29,2D2
1000000US110010009012022,"Block 2022, Block Group 2, Census Tract 9.01, District of Columbia, District of Columbia",81,76,5,0,0,0,0,0,81,80,75,5,0,0,0,0,0,1,1,0,0,0,0,0,0,110010009012022,2,205,205,2,psa_46,2D2
1000000US110010033012000,"Block 2000, Block Group 2, Census Tract 33.01, District of Columbia, District of Columbia",271,83,165,1,5,1,9,7,271,259,81,164,1,5,0,1,7,12,2,1,0,0,1,8,0,110010033012000,3,306,306,3,psa_38,3D2
1000000US110010047021000,"Block 1000, Block Group 1, Census Tract 47.02, District of Columbia, District of Columbia",336,65,243,0,8,0,8,12,336,322,63,240,0,8,0,0,11,14,2,3,0,0,0,8,1,110010047021000,1,102,102,1,psa_18,1D1
1000000US110010076014009,"Block 4009, Block Group 4, Census Tract 76.01, District of Columbia, District of Columbia",0,0,0,0,0,0,0,0,0,0,0,0,0,0,0,0,0,0,0,0,0,0,0,0,0,110010076014009,6,607,607,6,psa_10,6D2
1000000US110010079031001,"Block 1001, Block Group 1, Census Tract 79.03, District of Columbia, District of Columbia",148,15,121,0,1,0,5,6,148,136,8,121,0,1,0,0,6,12,7,0,0,0,0,5,0,110010079031001,5,507,507,5,psa_23,5D3
1000000US110010081002001,"Block 2001, Block Group 2, Census Tract 81, District of Columbia, District of Columbia",147,110,15,0,10,0,1,11,147,141,106,15,0,10,0,0,10,6,4,0,0,0,0,1,1,110010081002001,1,108,108,1,psa_17,1D2
1000000US110010109002027,"Block 2027, Block Group 2, Census Tract 109, District of Columbia, District of Columbia",0,0,0,0,0,0,0,0,0,0,0,0,0,0,0,0,0,0,0,0,0,0,0,0,0,110010109002027,7,708,708,7,psa_1,7D3
1000000US110010075021005,"Block 1005, Block Group 1, Census Tract 75.02, District of Columbia, District of Columbia",625,0,625,0,0,0,0,0,625,625,0,625,0,0,0,0,0,0,0,0,0,0,0,0,0,110010075021005,7,702,702,7,psa_6,7D1
1000000US110010024002011,"Block 2011, Block Group 2, Census Tract 24, District of Columbia, District of Columbia",68,14,51,0,1,0,0,2,68,58,6,51,0,1,0,0,0,10,8,0,0,0,0,0,2,110010024002011,4,407,407,4,psa_47,4D2
1000000US110010025023004,"Block 3004, Block Group 3, Census Tract 25.02, District of Columbia, District of Columbia",273,72,120,0,6,0,54,21,273,161,35,114,0,5,0,2,5,112,37,6,0,1,0,52,16,110010025023004,4,404,404,4,psa_48,4D3
1000000US110010062021226,"Block 1226, Block Group 1, Census Tract 62.02, District of Columbia, District of Columbia",0,0,0,0,0,0,0,0,0,0,0,0,0,0,0,0,0,0,0,0,0,0,0,0,0,110010062021226,1,103,103,1,psa_12,1D1
1000000US110010011001006,"Block 1006, Block Group 1, Census Tract 11, District of Columbia, District of Columbia",98,96,0,0,2,0,0,0,98,98,96,0,0,2,0,0,0,0,0,0,0,0,0,0,0,110010011001006,2,201,201,2,psa_55,2D1
1000000US110010095081002,"Block 1002, Block Group 1, Census Tract 95.08, District of Columbia, District of Columbia",2,0,1,0,0,0,1,0,2,1,0,1,0,0,0,0,0,1,0,0,0,0,0,1,0,110010095081002,4,406,406,4,psa_54,4D2
1000000US110010095082003,"Block 2003, Block Group 2, Census Tract 95.08, District of Columbia, District of Columbia",26,0,26,0,0,0,0,0,26,26,0,26,0,0,0,0,0,0,0,0,0,0,0,0,0,110010095082003,4,406,406,4,psa_54,4D2
1000000US110010099022008,"Block 2008, Block Group 2, Census Tract 99.02, District of Columbia, District of Columbia",154,0,154,0,0,0,0,0,154,153,0,153,0,0,0,0,0,1,0,1,0,0,0,0,0,110010099022008,6,605,605,6,psa_11,6D2
1000000US110010110002008,"Block 2008, Block Group 2, Census Tract 110, District of Columbia, District of Columbia",0,0,0,0,0,0,0,0,0,0,0,0,0,0,0,0,0,0,0,0,0,0,0,0,0,110010110002008,1,105,105,1,psa_22,1D3
1000000US110010028012001,"Block 2001, Block Group 2, Census Tract 28.01, District of Columbia, District of Columbia",241,74,116,0,21,0,19,11,241,195,48,116,0,21,0,0,10,46,26,0,0,0,0,19,1,110010028012001,4,408,408,4,psa_39,4D3
1000000US110010107001010,"Block 1010, Block Group 1, Census Tract 107, District of Columbia, District of Columbia",0,0,0,0,0,0,0,0,0,0,0,0,0,0,0,0,0,0,0,0,0,0,0,0,0,110010107001010,2,207,207,2,psa_24,2D3
1000000US110010074071003,"Block 1003, Block Group 1, Census Tract 74.07, District of Columbia, District of Columbia",49,1,48,0,0,0,0,0,49,49,1,48,0,0,0,0,0,0,0,0,0,0,0,0,0,110010074071003,7,702,702,7,psa_6,7D1
1000000US110010055001001,"Block 1001, Block Group 1, Census Tract 55, District of Columbia, District of Columbia",78,74,2,0,1,0,1,0,78,74,70,2,0,1,0,1,0,4,4,0,0,0,0,0,0,110010055001001,2,208,208,2,psa_33,2D3
1000000US110010073011031,"Block 1031, Block Group 1, Census Tract 73.01, District of Columbia, District of Columbia",0,0,0,0,0,0,0,0,0,0,0,0,0,0,0,0,0,0,0,0,0,0,0,0,0,110010073011031,7,703,703,7,psa_8,7D1
1000000US110010077071004,"Block 1004, Block Group 1, Census Tract 77.07, District of Columbia, District of Columbia",106,0,100,0,0,0,3,3,106,102,0,99,0,0,0,0,3,4,0,1,0,0,0,3,0,110010077071004,6,604,604,6,psa_14,6D3
1000000US110010099042004,"Block 2004, Block Group 2, Census Tract 99.04, District of Columbia, District of Columbia",136,0,129,1,0,0,1,5,136,134,0,129,0,0,0,1,4,2,0,0,1,0,0,0,1,110010099042004,6,604,604,6,psa_14,6D3
1000000US110010062021215,"Block 1215, Block Group 1, Census Tract 62.02, District of Columbia, District of Columbia",0,0,0,0,0,0,0,0,0,0,0,0,0,0,0,0,0,0,0,0,0,0,0,0,0,110010062021215,1,103,103,1,psa_12,1D1
1000000US110010101002004,"Block 2004, Block Group 2, Census Tract 101, District of Columbia, District of Columbia",0,0,0,0,0,0,0,0,0,0,0,0,0,0,0,0,0,0,0,0,0,0,0,0,0,110010101002004,2,207,207,2,psa_24,2D3
1000000US110010026001022,"Block 1022, Block Group 1, Census Tract 26, District of Columbia, District of Columbia",0,0,0,0,0,0,0,0,0,0,0,0,0,0,0,0,0,0,0,0,0,0,0,0,0,110010026001022,4,404,404,4,psa_48,4D3
1000000US110010111003050,"Block 3050, Block Group 3, Census Tract 111, District of Columbia, District of Columbia",0,0,0,0,0,0,0,0,0,0,0,0,0,0,0,0,0,0,0,0,0,0,0,0,0,110010111003050,5,503,503,5,psa_45,5D2
1000000US110010001002002,"Block 2002, Block Group 2, Census Tract 1, District of Columbia, District of Columbia",102,95,1,0,3,0,0,3,102,99,92,1,0,3,0,0,3,3,3,0,0,0,0,0,0,110010001002002,2,206,206,2,psa_29,2D2
1000000US110010014011017,"Block 1017, Block Group 1, Census Tract 14.01, District of Columbia, District of Columbia",32,24,0,0,8,0,0,0,32,28,20,0,0,8,0,0,0,4,4,0,0,0,0,0,0,110010014011017,2,201,201,2,psa_55,2D1
1000000US110010087012000,"Block 2000, Block Group 2, Census Tract 87.01, District of Columbia, District of Columbia",34,0,25,0,0,0,9,0,34,25,0,25,0,0,0,0,0,9,0,0,0,0,0,9,0,110010087012000,5,502,502,5,psa_40,5D1
1000000US110010095053012,"Block 3012, Block Group 3, Census Tract 95.05, District of Columbia, District of Columbia",59,3,49,0,0,0,0,7,59,54,2,48,0,0,0,0,4,5,1,1,0,0,0,0,3,110010095053012,4,406,406,4,psa_54,4D2
1000000US110010028012002,"Block 2002, Block Group 2, Census Tract 28.01, District of Columbia, District of Columbia",748,194,178,5,28,0,293,50,748,268,57,169,2,28,0,1,11,480,137,9,3,0,0,292,39,110010028012002,4,408,408,4,psa_39,4D3
1000000US110010093013001,"Block 3001, Block Group 3, Census Tract 93.01, District of Columbia, District of Columbia",4,1,2,0,1,0,0,0,4,4,1,2,0,1,0,0,0,0,0,0,0,0,0,0,0,110010093013001,5,504,504,5,psa_43,5D2
1000000US110010012003004,"Block 3004, Block Group 3, Census Tract 12, District of Columbia, District of Columbia",55,53,0,0,0,1,0,1,55,53,51,0,0,0,1,0,1,2,2,0,0,0,0,0,0,110010012003004,2,202,202,2,psa_52,2D1
1000000US110010001004013,"Block 4013, Block Group 4, Census Tract 1, District of Columbia, District of Columbia",6,6,0,0,0,0,0,0,6,6,6,0,0,0,0,0,0,0,0,0,0,0,0,0,0,110010001004013,2,206,206,2,psa_29,2D2
1000000US110010099071004,"Block 1004, Block Group 1, Census Tract 99.07, District of Columbia, District of Columbia",84,0,84,0,0,0,0,0,84,84,0,84,0,0,0,0,0,0,0,0,0,0,0,0,0,110010099071004,6,605,605,6,psa_11,6D2
1000000US110010111002026,"Block 2026, Block Group 2, Census Tract 111, District of Columbia, District of Columbia",50,0,47,0,0,0,0,3,50,49,0,47,0,0,0,0,2,1,0,0,0,0,0,0,1,110010111002026,5,503,503,5,psa_45,5D2
1000000US110010020023011,"Block 3011, Block Group 3, Census Tract 20.02, District of Columbia, District of Columbia",65,8,34,0,3,0,14,6,65,47,3,34,0,2,0,4,4,18,5,0,0,1,0,10,2,110010020023011,4,404,404,4,psa_48,4D3
1000000US110010022012001,"Block 2001, Block Group 2, Census Tract 22.01, District of Columbia, District of Columbia",0,0,0,0,0,0,0,0,0,0,0,0,0,0,0,0,0,0,0,0,0,0,0,0,0,110010022012001,4,407,407,4,psa_47,4D2
1000000US110010111003035,"Block 3035, Block Group 3, Census Tract 111, District of Columbia, District of Columbia",0,0,0,0,0,0,0,0,0,0,0,0,0,0,0,0,0,0,0,0,0,0,0,0,0,110010111003035,5,503,503,5,psa_45,5D2
1000000US110010075031005,"Block 1005, Block Group 1, Census Tract 75.03, District of Columbia, District of Columbia",0,0,0,0,0,0,0,0,0,0,0,0,0,0,0,0,0,0,0,0,0,0,0,0,0,110010075031005,7,701,701,7,psa_9,7D1
1000000US110010099052001,"Block 2001, Block Group 2, Census Tract 99.05, District of Columbia, District of Columbia",0,0,0,0,0,0,0,0,0,0,0,0,0,0,0,0,0,0,0,0,0,0,0,0,0,110010099052001,6,604,604,6,psa_14,6D3
1000000US110010011004029,"Block 4029, Block Group 4, Census Tract 11, District of Columbia, District of Columbia",0,0,0,0,0,0,0,0,0,0,0,0,0,0,0,0,0,0,0,0,0,0,0,0,0,110010011004029,2,202,202,2,psa_52,2D1
1000000US110010077072023,"Block 2023, Block Group 2, Census Tract 77.07, District of Columbia, District of Columbia",34,0,34,0,0,0,0,0,34,33,0,33,0,0,0,0,0,1,0,1,0,0,0,0,0,110010077072023,6,604,604,6,psa_14,6D3
1000000US110010076015014,"Block 5014, Block Group 5, Census Tract 76.01, District of Columbia, District of Columbia",0,0,0,0,0,0,0,0,0,0,0,0,0,0,0,0,0,0,0,0,0,0,0,0,0,110010076015014,6,607,607,6,psa_10,6D2
1000000US110010093013002,"Block 3002, Block Group 3, Census Tract 93.01, District of Columbia, District of Columbia",12,0,12,0,0,0,0,0,12,11,0,11,0,0,0,0,0,1,0,1,0,0,0,0,0,110010093013002,5,504,504,5,psa_43,5D2
1000000US110010004002002,"Block 2002, Block Group 2, Census Tract 4, District of Columbia, District of Columbia",19,17,0,0,2,0,0,0,19,16,14,0,0,2,0,0,0,3,3,0,0,0,0,0,0,110010004002002,2,204,204,2,psa_44,2D2
1000000US110010006004001,"Block 4001, Block Group 4, Census Tract 6, District of Columbia, District of Columbia",78,73,0,0,2,0,1,2,78,73,69,0,0,2,0,0,2,5,4,0,0,0,0,1,0,110010006004001,2,203,203,2,psa_50,2D1
1000000US110010009012023,"Block 2023, Block Group 2, Census Tract 9.01, District of Columbia, District of Columbia",46,44,0,0,2,0,0,0,46,45,43,0,0,2,0,0,0,1,1,0,0,0,0,0,0,110010009012023,2,205,205,2,psa_46,2D2
1000000US110010015001021,"Block 1021, Block Group 1, Census Tract 15, District of Columbia, District of Columbia",0,0,0,0,0,0,0,0,0,0,0,0,0,0,0,0,0,0,0,0,0,0,0,0,0,110010015001021,2,201,201,2,psa_55,2D1
1000000US110010073011062,"Block 1062, Block Group 1, Census Tract 73.01, District of Columbia, District of Columbia",0,0,0,0,0,0,0,0,0,0,0,0,0,0,0,0,0,0,0,0,0,0,0,0,0,110010073011062,7,708,708,7,psa_1,7D3
1000000US110010011004012,"Block 4012, Block Group 4, Census Tract 11, District of Columbia, District of Columbia",0,0,0,0,0,0,0,0,0,0,0,0,0,0,0,0,0,0,0,0,0,0,0,0,0,110010011004012,2,202,202,2,psa_52,2D1
1000000US110010062021181,"Block 1181, Block Group 1, Census Tract 62.02, District of Columbia, District of Columbia",0,0,0,0,0,0,0,0,0,0,0,0,0,0,0,0,0,0,0,0,0,0,0,0,0,110010062021181,2,207,207,2,psa_24,2D3
1000000US110010072002016,"Block 2016, Block Group 2, Census Tract 72, District of Columbia, District of Columbia",0,0,0,0,0,0,0,0,0,0,0,0,0,0,0,0,0,0,0,0,0,0,0,0,0,110010072002016,1,106,106,1,psa_13,1D3
1000000US110010073011121,"Block 1121, Block Group 1, Census Tract 73.01, District of Columbia, District of Columbia",0,0,0,0,0,0,0,0,0,0,0,0,0,0,0,0,0,0,0,0,0,0,0,0,0,110010073011121,7,708,708,7,psa_1,7D3
1000000US110010073011045,"Block 1045, Block Group 1, Census Tract 73.01, District of Columbia, District of Columbia",0,0,0,0,0,0,0,0,0,0,0,0,0,0,0,0,0,0,0,0,0,0,0,0,0,110010073011045,7,707,707,7,psa_4,7D2
1000000US110010076042014,"Block 2014, Block Group 2, Census Tract 76.04, District of Columbia, District of Columbia",25,0,21,0,0,0,4,0,25,22,0,21,0,0,0,1,0,3,0,0,0,0,0,3,0,110010076042014,6,606,606,6,psa_7,6D2
1000000US110010094004015,"Block 4015, Block Group 4, Census Tract 94, District of Columbia, District of Columbia",31,0,26,0,0,0,1,4,31,30,0,26,0,0,0,0,4,1,0,0,0,0,0,1,0,110010094004015,5,503,503,5,psa_45,5D2
1000000US110010095013007,"Block 3007, Block Group 3, Census Tract 95.01, District of Columbia, District of Columbia",81,0,81,0,0,0,0,0,81,81,0,81,0,0,0,0,0,0,0,0,0,0,0,0,0,110010095013007,4,405,405,4,psa_49,4D2
1000000US110010062021091,"Block 1091, Block Group 1, Census Tract 62.02, District of Columbia, District of Columbia",0,0,0,0,0,0,0,0,0,0,0,0,0,0,0,0,0,0,0,0,0,0,0,0,0,110010062021091,2,207,207,2,psa_24,2D3
1000000US110010076012008,"Block 2008, Block Group 2, Census Tract 76.01, District of Columbia, District of Columbia",5,2,3,0,0,0,0,0,5,5,2,3,0,0,0,0,0,0,0,0,0,0,0,0,0,110010076012008,6,607,607,6,psa_10,6D2
1000000US110010040013001,"Block 3001, Block Group 3, Census Tract 40.01, District of Columbia, District of Columbia",0,0,0,0,0,0,0,0,0,0,0,0,0,0,0,0,0,0,0,0,0,0,0,0,0,110010040013001,2,204,204,2,psa_44,2D2
1000000US110010062021001,"Block 1001, Block Group 1, Census Tract 62.02, District of Columbia, District of Columbia",0,0,0,0,0,0,0,0,0,0,0,0,0,0,0,0,0,0,0,0,0,0,0,0,0,110010062021001,1,102,102,1,psa_18,1D1
1000000US110010025023005,"Block 3005, Block Group 3, Census Tract 25.02, District of Columbia, District of Columbia",0,0,0,0,0,0,0,0,0,0,0,0,0,0,0,0,0,0,0,0,0,0,0,0,0,110010025023005,4,404,404,4,psa_48,4D3
1000000US110010088024005,"Block 4005, Block Group 4, Census Tract 88.02, District of Columbia, District of Columbia",192,0,182,3,1,0,0,6,192,188,0,179,3,1,0,0,5,4,0,3,0,0,0,0,1,110010088024005,5,506,506,5,psa_26,5D3
1000000US110010094002014,"Block 2014, Block Group 2, Census Tract 94, District of Columbia, District of Columbia",80,5,75,0,0,0,0,0,80,80,5,75,0,0,0,0,0,0,0,0,0,0,0,0,0,110010094002014,5,503,503,5,psa_45,5D2
1000000US110010078062001,"Block 2001, Block Group 2, Census Tract 78.06, District of Columbia, District of Columbia",0,0,0,0,0,0,0,0,0,0,0,0,0,0,0,0,0,0,0,0,0,0,0,0,0,110010078062001,6,602,602,6,psa_25,6D1
1000000US110010095042000,"Block 2000, Block Group 2, Census Tract 95.04, District of Columbia, District of Columbia",60,8,52,0,0,0,0,0,60,60,8,52,0,0,0,0,0,0,0,0,0,0,0,0,0,110010095042000,4,405,405,4,psa_49,4D2
1000000US110010095053007,"Block 3007, Block Group 3, Census Tract 95.05, District of Columbia, District of Columbia",82,9,66,0,1,0,6,0,82,68,9,58,0,1,0,0,0,14,0,8,0,0,0,6,0,110010095053007,4,406,406,4,psa_54,4D2
1000000US110010025012008,"Block 2008, Block Group 2, Census Tract 25.01, District of Columbia, District of Columbia",75,29,37,0,3,0,3,3,75,70,28,37,0,3,0,0,2,5,1,0,0,0,0,3,1,110010025012008,4,404,404,4,psa_48,4D3
1000000US110010026001007,"Block 1007, Block Group 1, Census Tract 26, District of Columbia, District of Columbia",19,9,10,0,0,0,0,0,19,19,9,10,0,0,0,0,0,0,0,0,0,0,0,0,0,110010026001007,4,404,404,4,psa_48,4D3
1000000US110010077032000,"Block 2000, Block Group 2, Census Tract 77.03, District of Columbia, District of Columbia",16,0,16,0,0,0,0,0,16,16,0,16,0,0,0,0,0,0,0,0,0,0,0,0,0,110010077032000,6,603,603,6,psa_15,6D3
1000000US110010076033010,"Block 3010, Block Group 3, Census Tract 76.03, District of Columbia, District of Columbia",61,8,52,0,0,0,1,0,61,60,8,52,0,0,0,0,0,1,0,0,0,0,0,1,0,110010076033010,6,606,606,6,psa_7,6D2
1000000US110010111001019,"Block 1019, Block Group 1, Census Tract 111, District of Columbia, District of Columbia",81,9,72,0,0,0,0,0,81,81,9,72,0,0,0,0,0,0,0,0,0,0,0,0,0,110010111001019,5,503,503,5,psa_45,5D2
1000000US110010017021019,"Block 1019, Block Group 1, Census Tract 17.02, District of Columbia, District of Columbia",103,46,49,1,2,0,2,3,103,97,42,49,1,2,0,0,3,6,4,0,0,0,0,2,0,110010017021019,4,401,401,4,psa_56,4D1
1000000US110010047021016,"Block 1016, Block Group 1, Census Tract 47.02, District of Columbia, District of Columbia",0,0,0,0,0,0,0,0,0,0,0,0,0,0,0,0,0,0,0,0,0,0,0,0,0,110010047021016,1,101,101,1,psa_20,1D1
1000000US110010099011004,"Block 1004, Block Group 1, Census Tract 99.01, District of Columbia, District of Columbia",21,0,21,0,0,0,0,0,21,21,0,21,0,0,0,0,0,0,0,0,0,0,0,0,0,110010099011004,6,605,605,6,psa_11,6D2
1000000US110010011003002,"Block 3002, Block Group 3, Census Tract 11, District of Columbia, District of Columbia",27,26,1,0,0,0,0,0,27,25,24,1,0,0,0,0,0,2,2,0,0,0,0,0,0,110010011003002,2,201,201,2,psa_55,2D1
1000000US110010058001014,"Block 1014, Block Group 1, Census Tract 58, District of Columbia, District of Columbia",0,0,0,0,0,0,0,0,0,0,0,0,0,0,0,0,0,0,0,0,0,0,0,0,0,110010058001014,1,101,101,1,psa_20,1D1
1000000US110010101001003,"Block 1003, Block Group 1, Census Tract 101, District of Columbia, District of Columbia",0,0,0,0,0,0,0,0,0,0,0,0,0,0,0,0,0,0,0,0,0,0,0,0,0,110010101001003,2,209,209,2,psa_57,2D3
1000000US110010080021012,"Block 1012, Block Group 1, Census Tract 80.02, District of Columbia, District of Columbia",115,39,73,0,2,0,0,1,115,114,39,73,0,2,0,0,0,1,0,0,0,0,0,0,1,110010080021012,1,108,108,1,psa_17,1D2
1000000US110010096032002,"Block 2002, Block Group 2, Census Tract 96.03, District of Columbia, District of Columbia",34,0,34,0,0,0,0,0,34,34,0,34,0,0,0,0,0,0,0,0,0,0,0,0,0,110010096032002,6,603,603,6,psa_15,6D3
1000000US110010015001024,"Block 1024, Block Group 1, Census Tract 15, District of Columbia, District of Columbia",51,24,24,0,3,0,0,0,51,49,22,24,0,3,0,0,0,2,2,0,0,0,0,0,0,110010015001024,2,201,201,2,psa_55,2D1
1000000US110010074042009,"Block 2009, Block Group 2, Census Tract 74.04, District of Columbia, District of Columbia",131,4,125,0,0,0,0,2,131,125,0,123,0,0,0,0,2,6,4,2,0,0,0,0,0,110010074042009,7,704,704,7,psa_5,7D2
1000000US110010075031003,"Block 1003, Block Group 1, Census Tract 75.03, District of Columbia, District of Columbia",0,0,0,0,0,0,0,0,0,0,0,0,0,0,0,0,0,0,0,0,0,0,0,0,0,110010075031003,7,701,701,7,psa_9,7D1
1000000US110010091022025,"Block 2025, Block Group 2, Census Tract 91.02, District of Columbia, District of Columbia",0,0,0,0,0,0,0,0,0,0,0,0,0,0,0,0,0,0,0,0,0,0,0,0,0,110010091022025,5,505,505,5,psa_34,5D2
1000000US110010073011081,"Block 1081, Block Group 1, Census Tract 73.01, District of Columbia, District of Columbia",14,10,4,0,0,0,0,0,14,10,6,4,0,0,0,0,0,4,4,0,0,0,0,0,0,110010073011081,7,707,707,7,psa_4,7D2
1000000US110010074031007,"Block 1007, Block Group 1, Census Tract 74.03, District of Columbia, District of Columbia",101,0,98,1,1,0,0,1,101,101,0,98,1,1,0,0,1,0,0,0,0,0,0,0,0,110010074031007,7,704,704,7,psa_5,7D2
1000000US110010044002004,"Block 2004, Block Group 2, Census Tract 44, District of Columbia, District of Columbia",76,28,38,0,5,0,4,1,76,70,27,37,0,5,0,0,1,6,1,1,0,0,0,4,0,110010044002004,3,305,305,3,psa_32,3D2
1000000US110010093014002,"Block 4002, Block Group 4, Census Tract 93.01, District of Columbia, District of Columbia",66,33,24,0,4,0,0,5,66,63,30,24,0,4,0,0,5,3,3,0,0,0,0,0,0,110010093014002,5,504,504,5,psa_43,5D2
1000000US110010105002016,"Block 2016, Block Group 2, Census Tract 105, District of Columbia, District of Columbia",0,0,0,0,0,0,0,0,0,0,0,0,0,0,0,0,0,0,0,0,0,0,0,0,0,110010105002016,1,103,103,1,psa_12,1D1
1000000US110010019022017,"Block 2017, Block Group 2, Census Tract 19.02, District of Columbia, District of Columbia",64,10,51,0,0,0,0,3,64,62,9,50,0,0,0,0,3,2,1,1,0,0,0,0,0,110010019022017,4,402,402,4,psa_53,4D1
1000000US110010099012022,"Block 2022, Block Group 2, Census Tract 99.01, District of Columbia, District of Columbia",68,3,65,0,0,0,0,0,68,68,3,65,0,0,0,0,0,0,0,0,0,0,0,0,0,110010099012022,6,605,605,6,psa_11,6D2
1000000US110010003001001,"Block 1001, Block Group 1, Census Tract 3, District of Columbia, District of Columbia",137,132,0,1,2,0,2,0,137,134,130,0,1,2,0,1,0,3,2,0,0,0,0,1,0,110010003001001,2,204,204,2,psa_44,2D2
1000000US110010070002018,"Block 2018, Block Group 2, Census Tract 70, District of Columbia, District of Columbia",14,11,3,0,0,0,0,0,14,14,11,3,0,0,0,0,0,0,0,0,0,0,0,0,0,110010070002018,1,106,106,1,psa_13,1D3
1000000US110010041003029,"Block 3029, Block Group 3, Census Tract 41, District of Columbia, District of Columbia",8,8,0,0,0,0,0,0,8,8,8,0,0,0,0,0,0,0,0,0,0,0,0,0,0,110010041003029,2,208,208,2,psa_33,2D3
1000000US110010099012014,"Block 2014, Block Group 2, Census Tract 99.01, District of Columbia, District of Columbia",175,7,160,0,0,0,1,7,175,170,3,159,0,0,0,1,7,5,4,1,0,0,0,0,0,110010099012014,6,605,605,6,psa_11,6D2
1000000US110010007014001,"Block 4001, Block Group 4, Census Tract 7.01, District of Columbia, District of Columbia",80,63,0,0,16,0,0,1,80,77,60,0,0,16,0,0,1,3,3,0,0,0,0,0,0,110010007014001,2,204,204,2,psa_44,2D2
1000000US110010040012003,"Block 2003, Block Group 2, Census Tract 40.01, District of Columbia, District of Columbia",0,0,0,0,0,0,0,0,0,0,0,0,0,0,0,0,0,0,0,0,0,0,0,0,0,110010040012003,3,303,303,3,psa_37,3D3
1000000US110010008021013,"Block 1013, Block Group 1, Census Tract 8.02, District of Columbia, District of Columbia",325,238,22,0,42,0,8,15,325,302,222,20,0,42,0,4,14,23,16,2,0,0,0,4,1,110010008021013,2,205,205,2,psa_46,2D2
1000000US110010088042001,"Block 2001, Block Group 2, Census Tract 88.04, District of Columbia, District of Columbia",0,0,0,0,0,0,0,0,0,0,0,0,0,0,0,0,0,0,0,0,0,0,0,0,0,110010088042001,5,506,506,5,psa_26,5D3
1000000US110010021011000,"Block 1000, Block Group 1, Census Tract 21.01, District of Columbia, District of Columbia",0,0,0,0,0,0,0,0,0,0,0,0,0,0,0,0,0,0,0,0,0,0,0,0,0,110010021011000,4,402,402,4,psa_53,4D1
1000000US110010076033002,"Block 3002, Block Group 3, Census Tract 76.03, District of Columbia, District of Columbia",53,4,45,0,0,0,0,4,53,50,4,45,0,0,0,0,1,3,0,0,0,0,0,0,3,110010076033002,6,606,606,6,psa_7,6D2
1000000US110010095041018,"Block 1018, Block Group 1, Census Tract 95.04, District of Columbia, District of Columbia",86,45,38,0,1,0,0,2,86,84,43,38,0,1,0,0,2,2,2,0,0,0,0,0,0,110010095041018,5,504,504,5,psa_43,5D2
1000000US110010027012005,"Block 2005, Block Group 2, Census Tract 27.01, District of Columbia, District of Columbia",122,83,26,0,6,0,0,7,122,119,80,26,0,6,0,0,7,3,3,0,0,0,0,0,0,110010027012005,3,302,302,3,psa_42,3D1
1000000US110010105001005,"Block 1005, Block Group 1, Census Tract 105, District of Columbia, District of Columbia",0,0,0,0,0,0,0,0,0,0,0,0,0,0,0,0,0,0,0,0,0,0,0,0,0,110010105001005,1,105,105,1,psa_22,1D3
1000000US110010062021078,"Block 1078, Block Group 1, Census Tract 62.02, District of Columbia, District of Columbia",0,0,0,0,0,0,0,0,0,0,0,0,0,0,0,0,0,0,0,0,0,0,0,0,0,110010062021078,2,207,207,2,psa_24,2D3
1000000US110010065002012,"Block 2012, Block Group 2, Census Tract 65, District of Columbia, District of Columbia",142,116,11,1,9,0,0,5,142,136,111,11,0,9,0,0,5,6,5,0,1,0,0,0,0,110010065002012,1,106,106,1,psa_13,1D3
1000000US110010077072004,"Block 2004, Block Group 2, Census Tract 77.07, District of Columbia, District of Columbia",62,0,62,0,0,0,0,0,62,62,0,62,0,0,0,0,0,0,0,0,0,0,0,0,0,110010077072004,6,605,605,6,psa_11,6D2
1000000US110010015003003,"Block 3003, Block Group 3, Census Tract 15, District of Columbia, District of Columbia",89,84,4,0,0,0,1,0,89,83,79,4,0,0,0,0,0,6,5,0,0,0,0,1,0,110010015003003,2,201,201,2,psa_55,2D1
1000000US110010088042014,"Block 2014, Block Group 2, Census Tract 88.04, District of Columbia, District of Columbia",91,6,84,0,0,0,0,1,91,88,3,84,0,0,0,0,1,3,3,0,0,0,0,0,0,110010088042014,5,506,506,5,psa_26,5D3
1000000US110010004002019,"Block 2019, Block Group 2, Census Tract 4, District of Columbia, District of Columbia",4,3,0,0,1,0,0,0,4,4,3,0,0,1,0,0,0,0,0,0,0,0,0,0,0,110010004002019,2,204,204,2,psa_44,2D2
1000000US110010095041003,"Block 1003, Block Group 1, Census Tract 95.04, District of Columbia, District of Columbia",97,16,80,1,0,0,0,0,97,96,16,79,1,0,0,0,0,1,0,1,0,0,0,0,0,110010095041003,4,405,405,4,psa_49,4D2
1000000US110010001004029,"Block 4029, Block Group 4, Census Tract 1, District of Columbia, District of Columbia",0,0,0,0,0,0,0,0,0,0,0,0,0,0,0,0,0,0,0,0,0,0,0,0,0,110010001004029,2,206,206,2,psa_29,2D2
1000000US110010009022012,"Block 2012, Block Group 2, Census Tract 9.02, District of Columbia, District of Columbia",0,0,0,0,0,0,0,0,0,0,0,0,0,0,0,0,0,0,0,0,0,0,0,0,0,110010009022012,2,205,205,2,psa_46,2D2
1000000US110010016004001,"Block 4001, Block Group 4, Census Tract 16, District of Columbia, District of Columbia",14,1,10,0,0,0,0,3,14,14,1,10,0,0,0,0,3,0,0,0,0,0,0,0,0,110010016004001,4,401,401,4,psa_56,4D1
1000000US110010028022005,"Block 2005, Block Group 2, Census Tract 28.02, District of Columbia, District of Columbia",0,0,0,0,0,0,0,0,0,0,0,0,0,0,0,0,0,0,0,0,0,0,0,0,0,110010028022005,3,302,302,3,psa_42,3D1
1000000US110010039002004,"Block 2004, Block Group 2, Census Tract 39, District of Columbia, District of Columbia",0,0,0,0,0,0,0,0,0,0,0,0,0,0,0,0,0,0,0,0,0,0,0,0,0,110010039002004,3,303,303,3,psa_37,3D3
1000000US110010062021185,"Block 1185, Block Group 1, Census Tract 62.02, District of Columbia, District of Columbia",0,0,0,0,0,0,0,0,0,0,0,0,0,0,0,0,0,0,0,0,0,0,0,0,0,110010062021185,2,207,207,2,psa_24,2D3
1000000US110010026001002,"Block 1002, Block Group 1, Census Tract 26, District of Columbia, District of Columbia",54,27,26,1,0,0,0,0,54,53,26,26,1,0,0,0,0,1,1,0,0,0,0,0,0,110010026001002,4,404,404,4,psa_48,4D3
1000000US110010031001012,"Block 1012, Block Group 1, Census Tract 31, District of Columbia, District of Columbia",212,65,51,4,12,0,52,28,212,119,52,50,0,12,0,1,4,93,13,1,4,0,0,51,24,110010031001012,3,302,302,3,psa_42,3D1
1000000US110010002021008,"Block 1008, Block Group 1, Census Tract 2.02, District of Columbia, District of Columbia",112,106,2,0,3,0,1,0,112,110,105,2,0,3,0,0,0,2,1,0,0,0,0,1,0,110010002021008,2,206,206,2,psa_29,2D2
1000000US110010042012000,"Block 2000, Block Group 2, Census Tract 42.01, District of Columbia, District of Columbia",13,11,2,0,0,0,0,0,13,13,11,2,0,0,0,0,0,0,0,0,0,0,0,0,0,110010042012000,3,301,301,3,psa_31,3D3
1000000US110010074081004,"Block 1004, Block Group 1, Census Tract 74.08, District of Columbia, District of Columbia",188,6,181,0,0,0,0,1,188,186,6,179,0,0,0,0,1,2,0,2,0,0,0,0,0,110010074081004,7,702,702,7,psa_6,7D1
1000000US110010096021020,"Block 1020, Block Group 1, Census Tract 96.02, District of Columbia, District of Columbia",0,0,0,0,0,0,0,0,0,0,0,0,0,0,0,0,0,0,0,0,0,0,0,0,0,110010096021020,6,602,602,6,psa_25,6D1
1000000US110010076034006,"Block 4006, Block Group 4, Census Tract 76.03, District of Columbia, District of Columbia",23,1,22,0,0,0,0,0,23,23,1,22,0,0,0,0,0,0,0,0,0,0,0,0,0,110010076034006,6,606,606,6,psa_7,6D2
1000000US110010072001001,"Block 1001, Block Group 1, Census Tract 72, District of Columbia, District of Columbia",0,0,0,0,0,0,0,0,0,0,0,0,0,0,0,0,0,0,0,0,0,0,0,0,0,110010072001001,1,106,106,1,psa_13,1D3
1000000US110010091022012,"Block 2012, Block Group 2, Census Tract 91.02, District of Columbia, District of Columbia",0,0,0,0,0,0,0,0,0,0,0,0,0,0,0,0,0,0,0,0,0,0,0,0,0,110010091022012,5,505,505,5,psa_34,5D2
1000000US110010052012000,"Block 2000, Block Group 2, Census Tract 52.01, District of Columbia, District of Columbia",338,278,16,1,28,1,0,14,338,325,265,16,1,28,1,0,14,13,13,0,0,0,0,0,0,110010052012000,3,301,301,3,psa_31,3D3
1000000US110010077072017,"Block 2017, Block Group 2, Census Tract 77.07, District of Columbia, District of Columbia",0,0,0,0,0,0,0,0,0,0,0,0,0,0,0,0,0,0,0,0,0,0,0,0,0,110010077072017,6,604,604,6,psa_14,6D3
1000000US110010076034005,"Block 4005, Block Group 4, Census Tract 76.03, District of Columbia, District of Columbia",165,13,147,0,3,0,0,2,165,160,8,147,0,3,0,0,2,5,5,0,0,0,0,0,0,110010076034005,6,606,606,6,psa_7,6D2
1000000US110010068041007,"Block 1007, Block Group 1, Census Tract 68.04, District of Columbia, District of Columbia",0,0,0,0,0,0,0,0,0,0,0,0,0,0,0,0,0,0,0,0,0,0,0,0,0,110010068041007,1,108,108,1,psa_17,1D2
1000000US110010073011072,"Block 1072, Block Group 1, Census Tract 73.01, District of Columbia, District of Columbia",0,0,0,0,0,0,0,0,0,0,0,0,0,0,0,0,0,0,0,0,0,0,0,0,0,110010073011072,7,703,703,7,psa_8,7D1
1000000US110010093014009,"Block 4009, Block Group 4, Census Tract 93.01, District of Columbia, District of Columbia",72,15,51,0,0,0,0,6,72,70,14,51,0,0,0,0,5,2,1,0,0,0,0,0,1,110010093014009,5,504,504,5,psa_43,5D2
1000000US110010004002028,"Block 2028, Block Group 2, Census Tract 4, District of Columbia, District of Columbia",0,0,0,0,0,0,0,0,0,0,0,0,0,0,0,0,0,0,0,0,0,0,0,0,0,110010004002028,2,204,204,2,psa_44,2D2
1000000US110010027023009,"Block 3009, Block Group 3, Census Tract 27.02, District of Columbia, District of Columbia",144,123,15,0,2,0,3,1,144,132,115,14,0,2,0,0,1,12,8,1,0,0,0,3,0,110010027023009,3,302,302,3,psa_42,3D1
1000000US110010095053005,"Block 3005, Block Group 3, Census Tract 95.05, District of Columbia, District of Columbia",93,4,83,1,0,0,3,2,93,87,1,83,1,0,0,0,2,6,3,0,0,0,0,3,0,110010095053005,4,406,406,4,psa_54,4D2
1000000US110010010023005,"Block 3005, Block Group 3, Census Tract 10.02, District of Columbia, District of Columbia",0,0,0,0,0,0,0,0,0,0,0,0,0,0,0,0,0,0,0,0,0,0,0,0,0,110010010023005,2,202,202,2,psa_52,2D1
1000000US110010107002009,"Block 2009, Block Group 2, Census Tract 107, District of Columbia, District of Columbia",0,0,0,0,0,0,0,0,0,0,0,0,0,0,0,0,0,0,0,0,0,0,0,0,0,110010107002009,2,208,208,2,psa_33,2D3
1000000US110010002023006,"Block 3006, Block Group 3, Census Tract 2.02, District of Columbia, District of Columbia",71,63,2,0,5,0,0,1,71,70,62,2,0,5,0,0,1,1,1,0,0,0,0,0,0,110010002023006,2,206,206,2,psa_29,2D2
1000000US110010084022000,"Block 2000, Block Group 2, Census Tract 84.02, District of Columbia, District of Columbia",154,87,56,0,2,0,7,2,154,142,82,56,0,2,0,1,1,12,5,0,0,0,0,6,1,110010084022000,1,104,104,1,psa_21,1D2
1000000US110010003004004,"Block 4004, Block Group 4, Census Tract 3, District of Columbia, District of Columbia",97,75,1,0,16,0,1,4,97,91,71,1,0,16,0,0,3,6,4,0,0,0,0,1,1,110010003004004,2,204,204,2,psa_44,2D2
1000000US110010026002007,"Block 2007, Block Group 2, Census Tract 26, District of Columbia, District of Columbia",21,3,18,0,0,0,0,0,21,21,3,18,0,0,0,0,0,0,0,0,0,0,0,0,0,110010026002007,4,404,404,4,psa_48,4D3
1000000US110010058001042,"Block 1042, Block Group 1, Census Tract 58, District of Columbia, District of Columbia",0,0,0,0,0,0,0,0,0,0,0,0,0,0,0,0,0,0,0,0,0,0,0,0,0,110010058001042,2,209,209,2,psa_57,2D3
1000000US110010070002011,"Block 2011, Block Group 2, Census Tract 70, District of Columbia, District of Columbia",98,59,30,1,3,0,0,5,98,90,52,30,0,3,0,0,5,8,7,0,1,0,0,0,0,110010070002011,1,106,106,1,psa_13,1D3
1000000US110010072002061,"Block 2061, Block Group 2, Census Tract 72, District of Columbia, District of Columbia",0,0,0,0,0,0,0,0,0,0,0,0,0,0,0,0,0,0,0,0,0,0,0,0,0,110010072002061,1,106,106,1,psa_13,1D3
1000000US110010016002005,"Block 2005, Block Group 2, Census Tract 16, District of Columbia, District of Columbia",45,14,31,0,0,0,0,0,45,45,14,31,0,0,0,0,0,0,0,0,0,0,0,0,0,110010016002005,4,401,401,4,psa_56,4D1
1000000US110010016003001,"Block 3001, Block Group 3, Census Tract 16, District of Columbia, District of Columbia",43,12,31,0,0,0,0,0,43,42,11,31,0,0,0,0,0,1,1,0,0,0,0,0,0,110010016003001,4,401,401,4,psa_56,4D1
1000000US110010076015000,"Block 5000, Block Group 5, Census Tract 76.01, District of Columbia, District of Columbia",0,0,0,0,0,0,0,0,0,0,0,0,0,0,0,0,0,0,0,0,0,0,0,0,0,110010076015000,1,106,106,1,psa_13,1D3
1000000US110010006002005,"Block 2005, Block Group 2, Census Tract 6, District of Columbia, District of Columbia",175,152,7,0,4,0,0,12,175,169,146,7,0,4,0,0,12,6,6,0,0,0,0,0,0,110010006002005,2,203,203,2,psa_50,2D1
1000000US110010026002001,"Block 2001, Block Group 2, Census Tract 26, District of Columbia, District of Columbia",0,0,0,0,0,0,0,0,0,0,0,0,0,0,0,0,0,0,0,0,0,0,0,0,0,110010026002001,4,403,403,4,psa_51,4D1
1000000US110010075031000,"Block 1000, Block Group 1, Census Tract 75.03, District of Columbia, District of Columbia",6,0,6,0,0,0,0,0,6,6,0,6,0,0,0,0,0,0,0,0,0,0,0,0,0,110010075031000,7,701,701,7,psa_9,7D1
1000000US110010076042025,"Block 2025, Block Group 2, Census Tract 76.04, District of Columbia, District of Columbia",31,0,31,0,0,0,0,0,31,31,0,31,0,0,0,0,0,0,0,0,0,0,0,0,0,110010076042025,6,606,606,6,psa_7,6D2
1000000US110010078031007,"Block 1007, Block Group 1, Census Tract 78.03, District of Columbia, District of Columbia",33,0,33,0,0,0,0,0,33,33,0,33,0,0,0,0,0,0,0,0,0,0,0,0,0,110010078031007,6,602,602,6,psa_25,6D1
1000000US110010078082005,"Block 2005, Block Group 2, Census Tract 78.08, District of Columbia, District of Columbia",54,0,48,0,0,0,5,1,54,53,0,48,0,0,0,5,0,1,0,0,0,0,0,0,1,110010078082005,6,608,608,6,psa_19,6D1
1000000US110010095071002,"Block 1002, Block Group 1, Census Tract 95.07, District of Columbia, District of Columbia",0,0,0,0,0,0,0,0,0,0,0,0,0,0,0,0,0,0,0,0,0,0,0,0,0,110010095071002,4,406,406,4,psa_54,4D2
1000000US110010108003004,"Block 3004, Block Group 3, Census Tract 108.00, District of Columbia, District of Columbia",517,373,17,2,98,3,7,17,517,486,350,17,2,97,2,3,15,31,23,0,0,1,1,4,2,110010108003004,2,207,207,2,psa_24,2D3
1000000US110010068041008,"Block 1008, Block Group 1, Census Tract 68.04, District of Columbia, District of Columbia",0,0,0,0,0,0,0,0,0,0,0,0,0,0,0,0,0,0,0,0,0,0,0,0,0,110010068041008,1,108,108,1,psa_17,1D2
1000000US110010062021217,"Block 1217, Block Group 1, Census Tract 62.02, District of Columbia, District of Columbia",0,0,0,0,0,0,0,0,0,0,0,0,0,0,0,0,0,0,0,0,0,0,0,0,0,110010062021217,1,103,103,1,psa_12,1D1
1000000US110010047021011,"Block 1011, Block Group 1, Census Tract 47.02, District of Columbia, District of Columbia",21,1,19,0,0,0,0,1,21,19,1,17,0,0,0,0,1,2,0,2,0,0,0,0,0,110010047021011,1,101,101,1,psa_20,1D1
1000000US110010049012012,"Block 2012, Block Group 2, Census Tract 49.01, District of Columbia, District of Columbia",0,0,0,0,0,0,0,0,0,0,0,0,0,0,0,0,0,0,0,0,0,0,0,0,0,110010049012012,3,307,307,3,psa_28,3D3
1000000US110010059001033,"Block 1033, Block Group 1, Census Tract 59, District of Columbia, District of Columbia",0,0,0,0,0,0,0,0,0,0,0,0,0,0,0,0,0,0,0,0,0,0,0,0,0,110010059001033,1,102,102,1,psa_18,1D1
1000000US110010103001008,"Block 1008, Block Group 1, Census Tract 103, District of Columbia, District of Columbia",0,0,0,0,0,0,0,0,0,0,0,0,0,0,0,0,0,0,0,0,0,0,0,0,0,110010103001008,4,401,401,4,psa_56,4D1
1000000US110010109002010,"Block 2010, Block Group 2, Census Tract 109, District of Columbia, District of Columbia",0,0,0,0,0,0,0,0,0,0,0,0,0,0,0,0,0,0,0,0,0,0,0,0,0,110010109002010,7,708,708,7,psa_1,7D3
1000000US110010044001006,"Block 1006, Block Group 1, Census Tract 44, District of Columbia, District of Columbia",535,410,50,1,48,0,18,8,535,493,383,50,1,48,0,3,8,42,27,0,0,0,0,15,0,110010044001006,3,305,305,3,psa_32,3D2
1000000US110010072002006,"Block 2006, Block Group 2, Census Tract 72, District of Columbia, District of Columbia",0,0,0,0,0,0,0,0,0,0,0,0,0,0,0,0,0,0,0,0,0,0,0,0,0,110010072002006,1,106,106,1,psa_13,1D3
1000000US110010073011026,"Block 1026, Block Group 1, Census Tract 73.01, District of Columbia, District of Columbia",0,0,0,0,0,0,0,0,0,0,0,0,0,0,0,0,0,0,0,0,0,0,0,0,0,110010073011026,7,703,703,7,psa_8,7D1
1000000US110010016004008,"Block 4008, Block Group 4, Census Tract 16, District of Columbia, District of Columbia",53,1,52,0,0,0,0,0,53,53,1,52,0,0,0,0,0,0,0,0,0,0,0,0,0,110010016004008,4,401,401,4,psa_56,4D1
1000000US110010026002025,"Block 2025, Block Group 2, Census Tract 26, District of Columbia, District of Columbia",0,0,0,0,0,0,0,0,0,0,0,0,0,0,0,0,0,0,0,0,0,0,0,0,0,110010026002025,4,404,404,4,psa_48,4D3
1000000US110010077082001,"Block 2001, Block Group 2, Census Tract 77.08, District of Columbia, District of Columbia",0,0,0,0,0,0,0,0,0,0,0,0,0,0,0,0,0,0,0,0,0,0,0,0,0,110010077082001,6,603,603,6,psa_15,6D3
1000000US110010015001015,"Block 1015, Block Group 1, Census Tract 15, District of Columbia, District of Columbia",30,19,7,0,1,0,0,3,30,27,17,6,0,1,0,0,3,3,2,1,0,0,0,0,0,110010015001015,2,201,201,2,psa_55,2D1
1000000US110010007012001,"Block 2001, Block Group 2, Census Tract 7.01, District of Columbia, District of Columbia",250,218,5,0,18,0,7,2,250,222,196,4,0,18,0,2,2,28,22,1,0,0,0,5,0,110010007012001,2,204,204,2,psa_44,2D2
1000000US110010016002004,"Block 2004, Block Group 2, Census Tract 16, District of Columbia, District of Columbia",0,0,0,0,0,0,0,0,0,0,0,0,0,0,0,0,0,0,0,0,0,0,0,0,0,110010016002004,4,401,401,4,psa_56,4D1
1000000US110010034002002,"Block 2002, Block Group 2, Census Tract 34, District of Columbia, District of Columbia",0,0,0,0,0,0,0,0,0,0,0,0,0,0,0,0,0,0,0,0,0,0,0,0,0,110010034002002,3,306,306,3,psa_38,3D2
1000000US110010089042008,"Block 2008, Block Group 2, Census Tract 89.04, District of Columbia, District of Columbia",113,6,106,0,0,0,1,0,113,109,3,106,0,0,0,0,0,4,3,0,0,0,0,1,0,110010089042008,5,507,507,5,psa_23,5D3
1000000US110010071001032,"Block 1032, Block Group 1, Census Tract 71, District of Columbia, District of Columbia",0,0,0,0,0,0,0,0,0,0,0,0,0,0,0,0,0,0,0,0,0,0,0,0,0,110010071001032,1,106,106,1,psa_13,1D3
1000000US110010010014007,"Block 4007, Block Group 4, Census Tract 10.01, District of Columbia, District of Columbia",57,54,3,0,0,0,0,0,57,55,53,2,0,0,0,0,0,2,1,1,0,0,0,0,0,110010010014007,2,202,202,2,psa_52,2D1
1000000US110010018042014,"Block 2014, Block Group 2, Census Tract 18.04, District of Columbia, District of Columbia",163,16,58,0,0,0,74,15,163,65,0,58,0,0,0,3,4,98,16,0,0,0,0,71,11,110010018042014,4,402,402,4,psa_53,4D1
1000000US110010087011004,"Block 1004, Block Group 1, Census Tract 87.01, District of Columbia, District of Columbia",19,5,13,0,0,1,0,0,19,19,5,13,0,0,1,0,0,0,0,0,0,0,0,0,0,110010087011004,5,502,502,5,psa_40,5D1
1000000US110010019012009,"Block 2009, Block Group 2, Census Tract 19.01, District of Columbia, District of Columbia",78,6,60,0,0,0,9,3,78,63,1,60,0,0,0,0,2,15,5,0,0,0,0,9,1,110010019012009,4,402,402,4,psa_53,4D1
1000000US110010095052006,"Block 2006, Block Group 2, Census Tract 95.05, District of Columbia, District of Columbia",0,0,0,0,0,0,0,0,0,0,0,0,0,0,0,0,0,0,0,0,0,0,0,0,0,110010095052006,4,406,406,4,psa_54,4D2
1000000US110010096042002,"Block 2002, Block Group 2, Census Tract 96.04, District of Columbia, District of Columbia",74,0,72,0,0,0,0,2,74,73,0,72,0,0,0,0,1,1,0,0,0,0,0,0,1,110010096042002,6,603,603,6,psa_15,6D3
1000000US110010025012007,"Block 2007, Block Group 2, Census Tract 25.01, District of Columbia, District of Columbia",88,24,44,1,4,0,4,11,88,76,20,44,1,4,0,0,7,12,4,0,0,0,0,4,4,110010025012007,4,404,404,4,psa_48,4D3
1000000US110010094001010,"Block 1010, Block Group 1, Census Tract 94, District of Columbia, District of Columbia",27,3,24,0,0,0,0,0,27,27,3,24,0,0,0,0,0,0,0,0,0,0,0,0,0,110010094001010,5,503,503,5,psa_45,5D2
1000000US110010092031002,"Block 1002, Block Group 1, Census Tract 92.03, District of Columbia, District of Columbia",247,24,206,1,1,0,0,15,247,229,20,205,1,1,0,0,2,18,4,1,0,0,0,0,13,110010092031002,5,502,502,5,psa_40,5D1
1000000US110010010011006,"Block 1006, Block Group 1, Census Tract 10.01, District of Columbia, District of Columbia",76,66,4,0,1,0,0,5,76,64,54,4,0,1,0,0,5,12,12,0,0,0,0,0,0,110010010011006,2,202,202,2,psa_52,2D1
1000000US110010106002045,"Block 2045, Block Group 2, Census Tract 106, District of Columbia, District of Columbia",100,42,50,0,0,0,3,5,100,90,35,50,0,0,0,0,5,10,7,0,0,0,0,3,0,110010106002045,5,501,501,5,psa_35,5D1
1000000US110010009012007,"Block 2007, Block Group 2, Census Tract 9.01, District of Columbia, District of Columbia",43,40,1,0,0,0,2,0,43,42,40,1,0,0,0,1,0,1,0,0,0,0,0,1,0,110010009012007,2,205,205,2,psa_46,2D2
1000000US110010023021001,"Block 1001, Block Group 1, Census Tract 23.02, District of Columbia, District of Columbia",0,0,0,0,0,0,0,0,0,0,0,0,0,0,0,0,0,0,0,0,0,0,0,0,0,110010023021001,4,405,405,4,psa_49,4D2
1000000US110010068022011,"Block 2011, Block Group 2, Census Tract 68.02, District of Columbia, District of Columbia",0,0,0,0,0,0,0,0,0,0,0,0,0,0,0,0,0,0,0,0,0,0,0,0,0,110010068022011,1,107,107,1,psa_16,1D2
1000000US110010074093003,"Block 3003, Block Group 3, Census Tract 74.09, District of Columbia, District of Columbia",361,0,358,1,0,0,0,2,361,359,0,357,1,0,0,0,1,2,0,1,0,0,0,0,1,110010074093003,7,704,704,7,psa_5,7D2
1000000US110010093013016,"Block 3016, Block Group 3, Census Tract 93.01, District of Columbia, District of Columbia",37,9,28,0,0,0,0,0,37,37,9,28,0,0,0,0,0,0,0,0,0,0,0,0,0,110010093013016,5,504,504,5,psa_43,5D2
1000000US110010026001016,"Block 1016, Block Group 1, Census Tract 26, District of Columbia, District of Columbia",0,0,0,0,0,0,0,0,0,0,0,0,0,0,0,0,0,0,0,0,0,0,0,0,0,110010026001016,4,404,404,4,psa_48,4D3
1000000US110010082002013,"Block 2013, Block Group 2, Census Tract 82, District of Columbia, District of Columbia",101,93,3,0,3,0,0,2,101,101,93,3,0,3,0,0,2,0,0,0,0,0,0,0,0,110010082002013,1,108,108,1,psa_17,1D2
1000000US110010104002016,"Block 2016, Block Group 2, Census Tract 104, District of Columbia, District of Columbia",166,3,162,0,0,0,1,0,166,157,3,154,0,0,0,0,0,9,0,8,0,0,0,1,0,110010104002016,7,707,707,7,psa_4,7D2
1000000US110010095041012,"Block 1012, Block Group 1, Census Tract 95.04, District of Columbia, District of Columbia",25,4,20,0,1,0,0,0,25,24,3,20,0,1,0,0,0,1,1,0,0,0,0,0,0,110010095041012,5,504,504,5,psa_43,5D2
1000000US110010011001023,"Block 1023, Block Group 1, Census Tract 11, District of Columbia, District of Columbia",22,16,5,0,0,0,1,0,22,20,14,5,0,0,0,1,0,2,2,0,0,0,0,0,0,110010011001023,2,201,201,2,psa_55,2D1
1000000US110010072002026,"Block 2026, Block Group 2, Census Tract 72, District of Columbia, District of Columbia",337,185,107,0,22,0,4,19,337,309,169,106,0,22,0,0,12,28,16,1,0,0,0,4,7,110010072002026,1,106,106,1,psa_13,1D3
1000000US110010076042026,"Block 2026, Block Group 2, Census Tract 76.04, District of Columbia, District of Columbia",23,1,22,0,0,0,0,0,23,23,1,22,0,0,0,0,0,0,0,0,0,0,0,0,0,110010076042026,6,606,606,6,psa_7,6D2
1000000US110010106001001,"Block 1001, Block Group 1, Census Tract 106, District of Columbia, District of Columbia",103,21,80,1,0,0,1,0,103,102,21,80,1,0,0,0,0,1,0,0,0,0,0,1,0,110010106001001,5,501,501,5,psa_35,5D1
1000000US110010008022021,"Block 2021, Block Group 2, Census Tract 8.02, District of Columbia, District of Columbia",87,74,4,0,4,0,0,5,87,81,68,4,0,4,0,0,5,6,6,0,0,0,0,0,0,110010008022021,2,205,205,2,psa_46,2D2
1000000US110010104002037,"Block 2037, Block Group 2, Census Tract 104, District of Columbia, District of Columbia",0,0,0,0,0,0,0,0,0,0,0,0,0,0,0,0,0,0,0,0,0,0,0,0,0,110010104002037,7,703,703,7,psa_8,7D1
1000000US110010062021135,"Block 1135, Block Group 1, Census Tract 62.02, District of Columbia, District of Columbia",0,0,0,0,0,0,0,0,0,0,0,0,0,0,0,0,0,0,0,0,0,0,0,0,0,110010062021135,1,102,102,1,psa_18,1D1
1000000US110010088023005,"Block 3005, Block Group 3, Census Tract 88.02, District of Columbia, District of Columbia",224,41,158,5,9,0,6,5,224,207,40,153,2,9,0,0,3,17,1,5,3,0,0,6,2,110010088023005,5,506,506,5,psa_26,5D3
1000000US110010008013016,"Block 3016, Block Group 3, Census Tract 8.01, District of Columbia, District of Columbia",45,43,1,0,1,0,0,0,45,45,43,1,0,1,0,0,0,0,0,0,0,0,0,0,0,110010008013016,2,205,205,2,psa_46,2D2
1000000US110010014021004,"Block 1004, Block Group 1, Census Tract 14.02, District of Columbia, District of Columbia",60,57,3,0,0,0,0,0,60,56,53,3,0,0,0,0,0,4,4,0,0,0,0,0,0,110010014021004,2,201,201,2,psa_55,2D1
1000000US110010015004013,"Block 4013, Block Group 4, Census Tract 15, District of Columbia, District of Columbia",86,72,8,0,5,0,0,1,86,84,70,8,0,5,0,0,1,2,2,0,0,0,0,0,0,110010015004013,2,201,201,2,psa_55,2D1
1000000US110010088042006,"Block 2006, Block Group 2, Census Tract 88.04, District of Columbia, District of Columbia",106,0,104,2,0,0,0,0,106,106,0,104,2,0,0,0,0,0,0,0,0,0,0,0,0,110010088042006,5,506,506,5,psa_26,5D3
1000000US110010091022023,"Block 2023, Block Group 2, Census Tract 91.02, District of Columbia, District of Columbia",0,0,0,0,0,0,0,0,0,0,0,0,0,0,0,0,0,0,0,0,0,0,0,0,0,110010091022023,5,505,505,5,psa_34,5D2
1000000US110010095033017,"Block 3017, Block Group 3, Census Tract 95.03, District of Columbia, District of Columbia",0,0,0,0,0,0,0,0,0,0,0,0,0,0,0,0,0,0,0,0,0,0,0,0,0,110010095033017,5,504,504,5,psa_43,5D2
1000000US110010098022003,"Block 2003, Block Group 2, Census Tract 98.02, District of Columbia, District of Columbia",365,5,357,0,0,0,1,2,365,357,4,350,0,0,0,1,2,8,1,7,0,0,0,0,0,110010098022003,7,706,706,7,psa_2,7D3
1000000US110010047021023,"Block 1023, Block Group 1, Census Tract 47.02, District of Columbia, District of Columbia",0,0,0,0,0,0,0,0,0,0,0,0,0,0,0,0,0,0,0,0,0,0,0,0,0,110010047021023,1,102,102,1,psa_18,1D1
1000000US110010049012004,"Block 2004, Block Group 2, Census Tract 49.01, District of Columbia, District of Columbia",5,3,2,0,0,0,0,0,5,5,3,2,0,0,0,0,0,0,0,0,0,0,0,0,0,110010049012004,3,307,307,3,psa_28,3D3
1000000US110010071002005,"Block 2005, Block Group 2, Census Tract 71, District of Columbia, District of Columbia",26,20,6,0,0,0,0,0,26,23,17,6,0,0,0,0,0,3,3,0,0,0,0,0,0,110010071002005,1,106,106,1,psa_13,1D3
1000000US110010035002002,"Block 2002, Block Group 2, Census Tract 35, District of Columbia, District of Columbia",500,32,452,0,2,0,0,14,500,487,28,451,0,2,0,0,6,13,4,1,0,0,0,0,8,110010035002002,3,304,304,3,psa_36,3D1
1000000US110010015005009,"Block 5009, Block Group 5, Census Tract 15, District of Columbia, District of Columbia",136,120,0,0,0,0,4,12,136,128,113,0,0,0,0,4,11,8,7,0,0,0,0,0,1,110010015005009,2,201,201,2,psa_55,2D1
1000000US110010016003013,"Block 3013, Block Group 3, Census Tract 16, District of Columbia, District of Columbia",66,22,44,0,0,0,0,0,66,66,22,44,0,0,0,0,0,0,0,0,0,0,0,0,0,110010016003013,4,401,401,4,psa_56,4D1
1000000US110010012003007,"Block 3007, Block Group 3, Census Tract 12, District of Columbia, District of Columbia",65,56,0,0,4,1,1,3,65,63,55,0,0,4,1,0,3,2,1,0,0,0,0,1,0,110010012003007,2,202,202,2,psa_52,2D1
1000000US110010088022002,"Block 2002, Block Group 2, Census Tract 88.02, District of Columbia, District of Columbia",130,3,112,0,0,0,14,1,130,115,3,111,0,0,0,0,1,15,0,1,0,0,0,14,0,110010088022002,5,506,506,5,psa_26,5D3
1000000US110010011003004,"Block 3004, Block Group 3, Census Tract 11, District of Columbia, District of Columbia",61,58,2,0,0,0,1,0,61,54,52,2,0,0,0,0,0,7,6,0,0,0,0,1,0,110010011003004,2,201,201,2,psa_55,2D1
1000000US110010012003001,"Block 3001, Block Group 3, Census Tract 12, District of Columbia, District of Columbia",95,84,6,1,0,0,0,4,95,90,80,6,1,0,0,0,3,5,4,0,0,0,0,0,1,110010012003001,2,203,203,2,psa_50,2D1
1000000US110010018031008,"Block 1008, Block Group 1, Census Tract 18.03, District of Columbia, District of Columbia",0,0,0,0,0,0,0,0,0,0,0,0,0,0,0,0,0,0,0,0,0,0,0,0,0,110010018031008,4,402,402,4,psa_53,4D1
1000000US110010024004001,"Block 4001, Block Group 4, Census Tract 24, District of Columbia, District of Columbia",136,33,97,1,0,0,0,5,136,136,33,97,1,0,0,0,5,0,0,0,0,0,0,0,0,110010024004001,4,407,407,4,psa_47,4D2
1000000US110010099021000,"Block 1000, Block Group 1, Census Tract 99.02, District of Columbia, District of Columbia",2,0,2,0,0,0,0,0,2,2,0,2,0,0,0,0,0,0,0,0,0,0,0,0,0,110010099021000,6,605,605,6,psa_11,6D2
1000000US110010104002020,"Block 2020, Block Group 2, Census Tract 104, District of Columbia, District of Columbia",121,0,115,0,0,0,6,0,121,115,0,115,0,0,0,0,0,6,0,0,0,0,0,6,0,110010104002020,7,707,707,7,psa_4,7D2
1000000US110010107002012,"Block 2012, Block Group 2, Census Tract 107, District of Columbia, District of Columbia",0,0,0,0,0,0,0,0,0,0,0,0,0,0,0,0,0,0,0,0,0,0,0,0,0,110010107002012,2,208,208,2,psa_33,2D3
1000000US110010109002026,"Block 2026, Block Group 2, Census Tract 109, District of Columbia, District of Columbia",0,0,0,0,0,0,0,0,0,0,0,0,0,0,0,0,0,0,0,0,0,0,0,0,0,110010109002026,7,708,708,7,psa_1,7D3
1000000US110010048011021,"Block 1021, Block Group 1, Census Tract 48.01, District of Columbia, District of Columbia",0,0,0,0,0,0,0,0,0,0,0,0,0,0,0,0,0,0,0,0,0,0,0,0,0,110010048011021,3,308,308,3,psa_27,3D2
1000000US110010015002010,"Block 2010, Block Group 2, Census Tract 15, District of Columbia, District of Columbia",83,74,5,0,4,0,0,0,83,83,74,5,0,4,0,0,0,0,0,0,0,0,0,0,0,110010015002010,2,201,201,2,psa_55,2D1
1000000US110010002022007,"Block 2007, Block Group 2, Census Tract 2.02, District of Columbia, District of Columbia",115,103,0,1,5,0,2,4,115,108,99,0,1,5,0,0,3,7,4,0,0,0,0,2,1,110010002022007,2,206,206,2,psa_29,2D2
1000000US110010077092002,"Block 2002, Block Group 2, Census Tract 77.09, District of Columbia, District of Columbia",94,0,91,0,0,0,1,2,94,92,0,91,0,0,0,0,1,2,0,0,0,0,0,1,1,110010077092002,6,605,605,6,psa_11,6D2
1000000US110010094002005,"Block 2005, Block Group 2, Census Tract 94, District of Columbia, District of Columbia",217,14,196,1,0,0,0,6,217,214,12,196,1,0,0,0,5,3,2,0,0,0,0,0,1,110010094002005,5,504,504,5,psa_43,5D2
1000000US110010062021043,"Block 1043, Block Group 1, Census Tract 62.02, District of Columbia, District of Columbia",0,0,0,0,0,0,0,0,0,0,0,0,0,0,0,0,0,0,0,0,0,0,0,0,0,110010062021043,2,207,207,2,psa_24,2D3
1000000US110010062021051,"Block 1051, Block Group 1, Census Tract 62.02, District of Columbia, District of Columbia",0,0,0,0,0,0,0,0,0,0,0,0,0,0,0,0,0,0,0,0,0,0,0,0,0,110010062021051,2,207,207,2,psa_24,2D3
1000000US110010009013016,"Block 3016, Block Group 3, Census Tract 9.01, District of Columbia, District of Columbia",60,57,1,0,0,0,0,2,60,56,53,1,0,0,0,0,2,4,4,0,0,0,0,0,0,110010009013016,2,205,205,2,psa_46,2D2
1000000US110010015004002,"Block 4002, Block Group 4, Census Tract 15, District of Columbia, District of Columbia",6,6,0,0,0,0,0,0,6,6,6,0,0,0,0,0,0,0,0,0,0,0,0,0,0,110010015004002,2,201,201,2,psa_55,2D1
1000000US110010096021024,"Block 1024, Block Group 1, Census Tract 96.02, District of Columbia, District of Columbia",0,0,0,0,0,0,0,0,0,0,0,0,0,0,0,0,0,0,0,0,0,0,0,0,0,110010096021024,6,601,601,6,psa_30,6D1
1000000US110010073011129,"Block 1129, Block Group 1, Census Tract 73.01, District of Columbia, District of Columbia",0,0,0,0,0,0,0,0,0,0,0,0,0,0,0,0,0,0,0,0,0,0,0,0,0,110010073011129,7,703,703,7,psa_8,7D1
1000000US110010098101007,"Block 1007, Block Group 1, Census Tract 98.10, District of Columbia, District of Columbia",0,0,0,0,0,0,0,0,0,0,0,0,0,0,0,0,0,0,0,0,0,0,0,0,0,110010098101007,7,708,708,7,psa_1,7D3
1000000US110010093021001,"Block 1001, Block Group 1, Census Tract 93.02, District of Columbia, District of Columbia",76,10,58,0,0,0,0,8,76,76,10,58,0,0,0,0,8,0,0,0,0,0,0,0,0,110010093021001,5,504,504,5,psa_43,5D2
1000000US110010084021002,"Block 1002, Block Group 1, Census Tract 84.02, District of Columbia, District of Columbia",75,55,15,0,1,0,2,2,75,75,55,15,0,1,0,2,2,0,0,0,0,0,0,0,0,110010084021002,1,104,104,1,psa_21,1D2
1000000US110010107001006,"Block 1006, Block Group 1, Census Tract 107, District of Columbia, District of Columbia",382,297,11,4,44,0,5,21,382,353,273,11,4,44,0,1,20,29,24,0,0,0,0,4,1,110010107001006,2,207,207,2,psa_24,2D3
1000000US110010014012019,"Block 2019, Block Group 2, Census Tract 14.01, District of Columbia, District of Columbia",79,73,0,0,4,0,0,2,79,76,72,0,0,4,0,0,0,3,1,0,0,0,0,0,2,110010014012019,2,201,201,2,psa_55,2D1
1000000US110010062021093,"Block 1093, Block Group 1, Census Tract 62.02, District of Columbia, District of Columbia",0,0,0,0,0,0,0,0,0,0,0,0,0,0,0,0,0,0,0,0,0,0,0,0,0,110010062021093,2,207,207,2,psa_24,2D3
1000000US110010013011003,"Block 1003, Block Group 1, Census Tract 13.01, District of Columbia, District of Columbia",0,0,0,0,0,0,0,0,0,0,0,0,0,0,0,0,0,0,0,0,0,0,0,0,0,110010013011003,2,203,203,2,psa_50,2D1
1000000US110010064002032,"Block 2032, Block Group 2, Census Tract 64, District of Columbia, District of Columbia",0,0,0,0,0,0,0,0,0,0,0,0,0,0,0,0,0,0,0,0,0,0,0,0,0,110010064002032,1,105,105,1,psa_22,1D3
1000000US110010075022002,"Block 2002, Block Group 2, Census Tract 75.02, District of Columbia, District of Columbia",304,0,293,0,0,0,4,7,304,301,0,292,0,0,0,2,7,3,0,1,0,0,0,2,0,110010075022002,7,702,702,7,psa_6,7D1
1000000US110010091023002,"Block 3002, Block Group 3, Census Tract 91.02, District of Columbia, District of Columbia",431,4,422,1,1,0,0,3,431,419,1,413,1,1,0,0,3,12,3,9,0,0,0,0,0,110010091023002,5,505,505,5,psa_34,5D2
1000000US110010021011004,"Block 1004, Block Group 1, Census Tract 21.01, District of Columbia, District of Columbia",127,8,100,0,0,0,13,6,127,112,6,100,0,0,0,0,6,15,2,0,0,0,0,13,0,110010021011004,4,403,403,4,psa_51,4D1
1000000US110010072002018,"Block 2018, Block Group 2, Census Tract 72, District of Columbia, District of Columbia",0,0,0,0,0,0,0,0,0,0,0,0,0,0,0,0,0,0,0,0,0,0,0,0,0,110010072002018,1,106,106,1,psa_13,1D3
1000000US110010098101006,"Block 1006, Block Group 1, Census Tract 98.10, District of Columbia, District of Columbia",0,0,0,0,0,0,0,0,0,0,0,0,0,0,0,0,0,0,0,0,0,0,0,0,0,110010098101006,7,708,708,7,psa_1,7D3
1000000US110010029001003,"Block 1003, Block Group 1, Census Tract 29, District of Columbia, District of Columbia",288,97,116,1,3,0,67,4,288,193,73,112,1,3,0,1,3,95,24,4,0,0,0,66,1,110010029001003,4,408,408,4,psa_39,4D3
1000000US110010104002011,"Block 2011, Block Group 2, Census Tract 104, District of Columbia, District of Columbia",0,0,0,0,0,0,0,0,0,0,0,0,0,0,0,0,0,0,0,0,0,0,0,0,0,110010104002011,7,703,703,7,psa_8,7D1
1000000US110010078042005,"Block 2005, Block Group 2, Census Tract 78.04, District of Columbia, District of Columbia",68,0,66,0,0,0,0,2,68,67,0,65,0,0,0,0,2,1,0,1,0,0,0,0,0,110010078042005,6,602,602,6,psa_25,6D1
1000000US110010099051007,"Block 1007, Block Group 1, Census Tract 99.05, District of Columbia, District of Columbia",44,0,44,0,0,0,0,0,44,44,0,44,0,0,0,0,0,0,0,0,0,0,0,0,0,110010099051007,6,604,604,6,psa_14,6D3
1000000US110010107001025,"Block 1025, Block Group 1, Census Tract 107, District of Columbia, District of Columbia",0,0,0,0,0,0,0,0,0,0,0,0,0,0,0,0,0,0,0,0,0,0,0,0,0,110010107001025,2,207,207,2,psa_24,2D3
1000000US110010102002016,"Block 2016, Block Group 2, Census Tract 102, District of Columbia, District of Columbia",0,0,0,0,0,0,0,0,0,0,0,0,0,0,0,0,0,0,0,0,0,0,0,0,0,110010102002016,1,103,103,1,psa_12,1D1
1000000US110010027023004,"Block 3004, Block Group 3, Census Tract 27.02, District of Columbia, District of Columbia",0,0,0,0,0,0,0,0,0,0,0,0,0,0,0,0,0,0,0,0,0,0,0,0,0,110010027023004,3,302,302,3,psa_42,3D1
1000000US110010055003002,"Block 3002, Block Group 3, Census Tract 55, District of Columbia, District of Columbia",0,0,0,0,0,0,0,0,0,0,0,0,0,0,0,0,0,0,0,0,0,0,0,0,0,110010055003002,2,208,208,2,psa_33,2D3
1000000US110010079013006,"Block 3006, Block Group 3, Census Tract 79.01, District of Columbia, District of Columbia",192,38,144,0,3,0,3,4,192,185,33,144,0,3,0,1,4,7,5,0,0,0,0,2,0,110010079013006,5,507,507,5,psa_23,5D3
1000000US110010111003047,"Block 3047, Block Group 3, Census Tract 111, District of Columbia, District of Columbia",0,0,0,0,0,0,0,0,0,0,0,0,0,0,0,0,0,0,0,0,0,0,0,0,0,110010111003047,5,503,503,5,psa_45,5D2
1000000US110010001004002,"Block 4002, Block Group 4, Census Tract 1, District of Columbia, District of Columbia",86,83,3,0,0,0,0,0,86,82,79,3,0,0,0,0,0,4,4,0,0,0,0,0,0,110010001004002,2,206,206,2,psa_29,2D2
1000000US110010107001000,"Block 1000, Block Group 1, Census Tract 107, District of Columbia, District of Columbia",0,0,0,0,0,0,0,0,0,0,0,0,0,0,0,0,0,0,0,0,0,0,0,0,0,110010107001000,2,207,207,2,psa_24,2D3
1000000US110010108002005,"Block 2005, Block Group 2, Census Tract 108.00, District of Columbia, District of Columbia",5,3,2,0,0,0,0,0,5,5,3,2,0,0,0,0,0,0,0,0,0,0,0,0,0,110010108002005,2,207,207,2,psa_24,2D3
1000000US110010111002024,"Block 2024, Block Group 2, Census Tract 111, District of Columbia, District of Columbia",0,0,0,0,0,0,0,0,0,0,0,0,0,0,0,0,0,0,0,0,0,0,0,0,0,110010111002024,5,503,503,5,psa_45,5D2
1000000US110010083021008,"Block 1008, Block Group 1, Census Tract 83.02, District of Columbia, District of Columbia",141,80,37,0,8,0,8,8,141,134,80,37,0,8,0,2,7,7,0,0,0,0,0,6,1,110010083021008,1,108,108,1,psa_17,1D2
1000000US110010078062020,"Block 2020, Block Group 2, Census Tract 78.06, District of Columbia, District of Columbia",34,0,33,0,0,0,0,1,34,34,0,33,0,0,0,0,1,0,0,0,0,0,0,0,0,110010078062020,6,602,602,6,psa_25,6D1
1000000US110010091022016,"Block 2016, Block Group 2, Census Tract 91.02, District of Columbia, District of Columbia",2,0,2,0,0,0,0,0,2,2,0,2,0,0,0,0,0,0,0,0,0,0,0,0,0,110010091022016,5,505,505,5,psa_34,5D2
1000000US110010015003006,"Block 3006, Block Group 3, Census Tract 15, District of Columbia, District of Columbia",76,62,1,0,0,0,9,4,76,67,60,1,0,0,0,2,4,9,2,0,0,0,0,7,0,110010015003006,2,201,201,2,psa_55,2D1
1000000US110010026001005,"Block 1005, Block Group 1, Census Tract 26, District of Columbia, District of Columbia",48,24,20,0,1,0,0,3,48,45,24,20,0,1,0,0,0,3,0,0,0,0,0,0,3,110010026001005,4,404,404,4,psa_48,4D3
1000000US110010008012000,"Block 2000, Block Group 2, Census Tract 8.01, District of Columbia, District of Columbia",60,48,3,0,0,0,2,7,60,48,38,3,0,0,0,1,6,12,10,0,0,0,0,1,1,110010008012000,2,205,205,2,psa_46,2D2
1000000US110010022022001,"Block 2001, Block Group 2, Census Tract 22.02, District of Columbia, District of Columbia",164,7,122,0,0,0,16,19,164,132,6,122,0,0,0,0,4,32,1,0,0,0,0,16,15,110010022022001,4,407,407,4,psa_47,4D2
1000000US110010058001043,"Block 1043, Block Group 1, Census Tract 58, District of Columbia, District of Columbia",0,0,0,0,0,0,0,0,0,0,0,0,0,0,0,0,0,0,0,0,0,0,0,0,0,110010058001043,2,209,209,2,psa_57,2D3
1000000US110010071001009,"Block 1009, Block Group 1, Census Tract 71, District of Columbia, District of Columbia",243,44,190,1,3,0,0,5,243,234,35,190,1,3,0,0,5,9,9,0,0,0,0,0,0,110010071001009,1,106,106,1,psa_13,1D3
1000000US110010017021007,"Block 1007, Block Group 1, Census Tract 17.02, District of Columbia, District of Columbia",0,0,0,0,0,0,0,0,0,0,0,0,0,0,0,0,0,0,0,0,0,0,0,0,0,110010017021007,4,401,401,4,psa_56,4D1
1000000US110010023021023,"Block 1023, Block Group 1, Census Tract 23.02, District of Columbia, District of Columbia",95,33,62,0,0,0,0,0,95,94,33,61,0,0,0,0,0,1,0,1,0,0,0,0,0,110010023021023,4,405,405,4,psa_49,4D2
1000000US110010071002006,"Block 2006, Block Group 2, Census Tract 71, District of Columbia, District of Columbia",70,47,12,0,7,0,1,3,70,67,44,12,0,7,0,1,3,3,3,0,0,0,0,0,0,110010071002006,1,106,106,1,psa_13,1D3
1000000US110010013023009,"Block 3009, Block Group 3, Census Tract 13.02, District of Columbia, District of Columbia",474,363,38,0,40,0,13,20,474,427,331,37,0,39,0,2,18,47,32,1,0,1,0,11,2,110010013023009,2,203,203,2,psa_50,2D1
1000000US110010015004005,"Block 4005, Block Group 4, Census Tract 15, District of Columbia, District of Columbia",118,101,8,0,3,0,1,5,118,115,98,8,0,3,0,1,5,3,3,0,0,0,0,0,0,110010015004005,2,201,201,2,psa_55,2D1
1000000US110010078043021,"Block 3021, Block Group 3, Census Tract 78.04, District of Columbia, District of Columbia",0,0,0,0,0,0,0,0,0,0,0,0,0,0,0,0,0,0,0,0,0,0,0,0,0,110010078043021,6,608,608,6,psa_19,6D1
1000000US110010099011011,"Block 1011, Block Group 1, Census Tract 99.01, District of Columbia, District of Columbia",36,0,36,0,0,0,0,0,36,35,0,35,0,0,0,0,0,1,0,1,0,0,0,0,0,110010099011011,6,605,605,6,psa_11,6D2
1000000US110010010016000,"Block 6000, Block Group 6, Census Tract 10.01, District of Columbia, District of Columbia",61,46,2,0,6,0,0,7,61,61,46,2,0,6,0,0,7,0,0,0,0,0,0,0,0,110010010016000,2,202,202,2,psa_52,2D1
1000000US110010098111002,"Block 1002, Block Group 1, Census Tract 98.11, District of Columbia, District of Columbia",0,0,0,0,0,0,0,0,0,0,0,0,0,0,0,0,0,0,0,0,0,0,0,0,0,110010098111002,7,706,706,7,psa_2,7D3
1000000US110010111001002,"Block 1002, Block Group 1, Census Tract 111, District of Columbia, District of Columbia",81,0,78,0,0,0,2,1,81,73,0,72,0,0,0,0,1,8,0,6,0,0,0,2,0,110010111001002,5,503,503,5,psa_45,5D2
1000000US110010010014002,"Block 4002, Block Group 4, Census Tract 10.01, District of Columbia, District of Columbia",24,24,0,0,0,0,0,0,24,23,23,0,0,0,0,0,0,1,1,0,0,0,0,0,0,110010010014002,2,202,202,2,psa_52,2D1
1000000US110010048022000,"Block 2000, Block Group 2, Census Tract 48.02, District of Columbia, District of Columbia",111,9,69,0,18,0,14,1,111,95,8,68,0,18,0,0,1,16,1,1,0,0,0,14,0,110010048022000,3,308,308,3,psa_27,3D2
1000000US110010062021130,"Block 1130, Block Group 1, Census Tract 62.02, District of Columbia, District of Columbia",0,0,0,0,0,0,0,0,0,0,0,0,0,0,0,0,0,0,0,0,0,0,0,0,0,110010062021130,1,102,102,1,psa_18,1D1
1000000US110010073011051,"Block 1051, Block Group 1, Census Tract 73.01, District of Columbia, District of Columbia",0,0,0,0,0,0,0,0,0,0,0,0,0,0,0,0,0,0,0,0,0,0,0,0,0,110010073011051,7,708,708,7,psa_1,7D3
1000000US110010079011003,"Block 1003, Block Group 1, Census Tract 79.01, District of Columbia, District of Columbia",0,0,0,0,0,0,0,0,0,0,0,0,0,0,0,0,0,0,0,0,0,0,0,0,0,110010079011003,5,507,507,5,psa_23,5D3
1000000US110010094001009,"Block 1009, Block Group 1, Census Tract 94, District of Columbia, District of Columbia",34,0,34,0,0,0,0,0,34,30,0,30,0,0,0,0,0,4,0,4,0,0,0,0,0,110010094001009,5,503,503,5,psa_45,5D2
1000000US110010099042007,"Block 2007, Block Group 2, Census Tract 99.04, District of Columbia, District of Columbia",114,0,112,0,0,0,0,2,114,113,0,111,0,0,0,0,2,1,0,1,0,0,0,0,0,110010099042007,6,604,604,6,psa_14,6D3
1000000US110010013023001,"Block 3001, Block Group 3, Census Tract 13.02, District of Columbia, District of Columbia",34,29,0,0,1,0,1,3,34,32,29,0,0,1,0,0,2,2,0,0,0,0,0,1,1,110010013023001,2,203,203,2,psa_50,2D1
1000000US110010076042020,"Block 2020, Block Group 2, Census Tract 76.04, District of Columbia, District of Columbia",167,2,164,0,0,0,0,1,167,167,2,164,0,0,0,0,1,0,0,0,0,0,0,0,0,110010076042020,6,606,606,6,psa_7,6D2
1000000US110010111001023,"Block 1023, Block Group 1, Census Tract 111, District of Columbia, District of Columbia",32,3,22,2,1,0,4,0,32,28,3,22,2,1,0,0,0,4,0,0,0,0,0,4,0,110010111001023,5,503,503,5,psa_45,5D2
1000000US110010062021079,"Block 1079, Block Group 1, Census Tract 62.02, District of Columbia, District of Columbia",0,0,0,0,0,0,0,0,0,0,0,0,0,0,0,0,0,0,0,0,0,0,0,0,0,110010062021079,2,207,207,2,psa_24,2D3
1000000US110010036002001,"Block 2001, Block Group 2, Census Tract 36, District of Columbia, District of Columbia",475,228,150,0,18,0,67,12,475,376,200,145,0,18,0,4,9,99,28,5,0,0,0,63,3,110010036002001,3,304,304,3,psa_36,3D1
1000000US110010047021009,"Block 1009, Block Group 1, Census Tract 47.02, District of Columbia, District of Columbia",0,0,0,0,0,0,0,0,0,0,0,0,0,0,0,0,0,0,0,0,0,0,0,0,0,110010047021009,1,101,101,1,psa_20,1D1
1000000US110010080012002,"Block 2002, Block Group 2, Census Tract 80.01, District of Columbia, District of Columbia",174,93,71,0,2,0,0,8,174,169,89,70,0,2,0,0,8,5,4,1,0,0,0,0,0,110010080012002,1,104,104,1,psa_21,1D2
1000000US110010095053015,"Block 3015, Block Group 3, Census Tract 95.05, District of Columbia, District of Columbia",13,0,13,0,0,0,0,0,13,13,0,13,0,0,0,0,0,0,0,0,0,0,0,0,0,110010095053015,4,406,406,4,psa_54,4D2
1000000US110010005011002,"Block 1002, Block Group 1, Census Tract 5.01, District of Columbia, District of Columbia",0,0,0,0,0,0,0,0,0,0,0,0,0,0,0,0,0,0,0,0,0,0,0,0,0,110010005011002,2,204,204,2,psa_44,2D2
1000000US110010024004002,"Block 4002, Block Group 4, Census Tract 24, District of Columbia, District of Columbia",0,0,0,0,0,0,0,0,0,0,0,0,0,0,0,0,0,0,0,0,0,0,0,0,0,110010024004002,4,407,407,4,psa_47,4D2
1000000US110010069002006,"Block 2006, Block Group 2, Census Tract 69, District of Columbia, District of Columbia",204,127,49,1,11,2,3,11,204,191,120,49,1,11,2,2,6,13,7,0,0,0,0,1,5,110010069002006,1,106,106,1,psa_13,1D3
1000000US110010005012001,"Block 2001, Block Group 2, Census Tract 5.01, District of Columbia, District of Columbia",78,77,0,0,1,0,0,0,78,78,77,0,0,1,0,0,0,0,0,0,0,0,0,0,0,110010005012001,2,204,204,2,psa_44,2D2
1000000US110010064002008,"Block 2008, Block Group 2, Census Tract 64, District of Columbia, District of Columbia",33,2,31,0,0,0,0,0,33,33,2,31,0,0,0,0,0,0,0,0,0,0,0,0,0,110010064002008,1,105,105,1,psa_22,1D3
1000000US110010010023001,"Block 3001, Block Group 3, Census Tract 10.02, District of Columbia, District of Columbia",24,21,0,0,1,0,1,1,24,23,21,0,0,1,0,0,1,1,0,0,0,0,0,1,0,110010010023001,2,202,202,2,psa_52,2D1
1000000US110010019012001,"Block 2001, Block Group 2, Census Tract 19.01, District of Columbia, District of Columbia",71,8,59,0,1,0,0,3,71,68,6,58,0,1,0,0,3,3,2,1,0,0,0,0,0,110010019012001,4,402,402,4,psa_53,4D1
1000000US110010032003005,"Block 3005, Block Group 3, Census Tract 32, District of Columbia, District of Columbia",92,17,45,2,0,0,24,4,92,63,15,45,0,0,0,1,2,29,2,0,2,0,0,23,2,110010032003005,4,409,409,4,psa_41,4D3
1000000US110010030001003,"Block 1003, Block Group 1, Census Tract 30, District of Columbia, District of Columbia",189,104,46,1,7,0,10,21,189,162,94,46,1,7,0,1,13,27,10,0,0,0,0,9,8,110010030001003,3,302,302,3,psa_42,3D1
1000000US110010076032010,"Block 2010, Block Group 2, Census Tract 76.03, District of Columbia, District of Columbia",34,1,33,0,0,0,0,0,34,34,1,33,0,0,0,0,0,0,0,0,0,0,0,0,0,110010076032010,6,606,606,6,psa_7,6D2
1000000US110010076042006,"Block 2006, Block Group 2, Census Tract 76.04, District of Columbia, District of Columbia",13,4,9,0,0,0,0,0,13,13,4,9,0,0,0,0,0,0,0,0,0,0,0,0,0,110010076042006,6,607,607,6,psa_10,6D2
1000000US110010015004008,"Block 4008, Block Group 4, Census Tract 15, District of Columbia, District of Columbia",131,123,7,0,1,0,0,0,131,126,118,7,0,1,0,0,0,5,5,0,0,0,0,0,0,110010015004008,2,201,201,2,psa_55,2D1
1000000US110010024002013,"Block 2013, Block Group 2, Census Tract 24, District of Columbia, District of Columbia",0,0,0,0,0,0,0,0,0,0,0,0,0,0,0,0,0,0,0,0,0,0,0,0,0,110010024002013,4,407,407,4,psa_47,4D2
1000000US110010040022002,"Block 2002, Block Group 2, Census Tract 40.02, District of Columbia, District of Columbia",420,327,52,1,23,0,3,14,420,404,317,52,0,23,0,1,11,16,10,0,1,0,0,2,3,110010040022002,3,303,303,3,psa_37,3D3
1000000US110010024002018,"Block 2018, Block Group 2, Census Tract 24, District of Columbia, District of Columbia",85,50,26,3,0,0,4,2,85,64,38,26,0,0,0,0,0,21,12,0,3,0,0,4,2,110010024002018,4,407,407,4,psa_47,4D2
1000000US110010044002000,"Block 2000, Block Group 2, Census Tract 44, District of Columbia, District of Columbia",10,6,1,0,0,0,2,1,10,5,3,1,0,0,0,1,0,5,3,0,0,0,0,1,1,110010044002000,3,305,305,3,psa_32,3D2
1000000US110010076051000,"Block 1000, Block Group 1, Census Tract 76.05, District of Columbia, District of Columbia",222,0,222,0,0,0,0,0,222,221,0,221,0,0,0,0,0,1,0,1,0,0,0,0,0,110010076051000,6,607,607,6,psa_10,6D2
1000000US110010094003023,"Block 3023, Block Group 3, Census Tract 94, District of Columbia, District of Columbia",0,0,0,0,0,0,0,0,0,0,0,0,0,0,0,0,0,0,0,0,0,0,0,0,0,110010094003023,5,503,503,5,psa_45,5D2
1000000US110010019021012,"Block 1012, Block Group 1, Census Tract 19.02, District of Columbia, District of Columbia",110,5,99,0,0,0,6,0,110,102,4,98,0,0,0,0,0,8,1,1,0,0,0,6,0,110010019021012,4,402,402,4,psa_53,4D1
1000000US110010053013006,"Block 3006, Block Group 3, Census Tract 53.01, District of Columbia, District of Columbia",0,0,0,0,0,0,0,0,0,0,0,0,0,0,0,0,0,0,0,0,0,0,0,0,0,110010053013006,2,208,208,2,psa_33,2D3
1000000US110010096011010,"Block 1010, Block Group 1, Census Tract 96.01, District of Columbia, District of Columbia",367,5,351,0,4,3,0,4,367,366,4,351,0,4,3,0,4,1,1,0,0,0,0,0,0,110010096011010,6,601,601,6,psa_30,6D1
1000000US110010099061004,"Block 1004, Block Group 1, Census Tract 99.06, District of Columbia, District of Columbia",117,2,111,0,0,0,1,3,117,116,2,111,0,0,0,0,3,1,0,0,0,0,0,1,0,110010099061004,6,604,604,6,psa_14,6D3
1000000US110010105001006,"Block 1006, Block Group 1, Census Tract 105, District of Columbia, District of Columbia",0,0,0,0,0,0,0,0,0,0,0,0,0,0,0,0,0,0,0,0,0,0,0,0,0,110010105001006,1,105,105,1,psa_22,1D3
1000000US110010059001011,"Block 1011, Block Group 1, Census Tract 59, District of Columbia, District of Columbia",0,0,0,0,0,0,0,0,0,0,0,0,0,0,0,0,0,0,0,0,0,0,0,0,0,110010059001011,1,101,101,1,psa_20,1D1
1000000US110010074093004,"Block 3004, Block Group 3, Census Tract 74.09, District of Columbia, District of Columbia",214,1,210,0,1,0,0,2,214,214,1,210,0,1,0,0,2,0,0,0,0,0,0,0,0,110010074093004,7,704,704,7,psa_5,7D2
1000000US110010017022013,"Block 2013, Block Group 2, Census Tract 17.02, District of Columbia, District of Columbia",44,16,28,0,0,0,0,0,44,44,16,28,0,0,0,0,0,0,0,0,0,0,0,0,0,110010017022013,4,401,401,4,psa_56,4D1
1000000US110010111003008,"Block 3008, Block Group 3, Census Tract 111, District of Columbia, District of Columbia",18,1,14,0,0,0,3,0,18,15,1,14,0,0,0,0,0,3,0,0,0,0,0,3,0,110010111003008,5,505,505,5,psa_34,5D2
1000000US110010009013030,"Block 3030, Block Group 3, Census Tract 9.01, District of Columbia, District of Columbia",19,15,0,0,3,0,0,1,19,19,15,0,0,3,0,0,1,0,0,0,0,0,0,0,0,110010009013030,2,205,205,2,psa_46,2D2
1000000US110010015001017,"Block 1017, Block Group 1, Census Tract 15, District of Columbia, District of Columbia",0,0,0,0,0,0,0,0,0,0,0,0,0,0,0,0,0,0,0,0,0,0,0,0,0,110010015001017,2,201,201,2,psa_55,2D1
1000000US110010008022020,"Block 2020, Block Group 2, Census Tract 8.02, District of Columbia, District of Columbia",47,43,0,0,2,1,0,1,47,42,38,0,0,2,1,0,1,5,5,0,0,0,0,0,0,110010008022020,2,205,205,2,psa_46,2D2
1000000US110010010013008,"Block 3008, Block Group 3, Census Tract 10.01, District of Columbia, District of Columbia",66,61,1,0,2,0,1,1,66,62,59,1,0,2,0,0,0,4,2,0,0,0,0,1,1,110010010013008,2,202,202,2,psa_52,2D1
1000000US110010009011007,"Block 1007, Block Group 1, Census Tract 9.01, District of Columbia, District of Columbia",41,36,5,0,0,0,0,0,41,41,36,5,0,0,0,0,0,0,0,0,0,0,0,0,0,110010009011007,2,205,205,2,psa_46,2D2
1000000US110010041003025,"Block 3025, Block Group 3, Census Tract 41, District of Columbia, District of Columbia",0,0,0,0,0,0,0,0,0,0,0,0,0,0,0,0,0,0,0,0,0,0,0,0,0,110010041003025,2,206,206,2,psa_29,2D2
1000000US110010073011016,"Block 1016, Block Group 1, Census Tract 73.01, District of Columbia, District of Columbia",14,10,0,3,1,0,0,0,14,11,7,0,3,1,0,0,0,3,3,0,0,0,0,0,0,110010073011016,7,707,707,7,psa_4,7D2
1000000US110010095052017,"Block 2017, Block Group 2, Census Tract 95.05, District of Columbia, District of Columbia",15,0,8,0,1,0,6,0,15,9,0,8,0,1,0,0,0,6,0,0,0,0,0,6,0,110010095052017,4,406,406,4,psa_54,4D2
1000000US110010006003007,"Block 3007, Block Group 3, Census Tract 6, District of Columbia, District of Columbia",40,36,0,0,4,0,0,0,40,40,36,0,0,4,0,0,0,0,0,0,0,0,0,0,0,110010006003007,2,204,204,2,psa_44,2D2
1000000US110010010016018,"Block 6018, Block Group 6, Census Tract 10.01, District of Columbia, District of Columbia",50,48,0,0,1,0,1,0,50,42,40,0,0,1,0,1,0,8,8,0,0,0,0,0,0,110010010016018,2,202,202,2,psa_52,2D1
1000000US110010076041007,"Block 1007, Block Group 1, Census Tract 76.04, District of Columbia, District of Columbia",41,1,40,0,0,0,0,0,41,39,1,38,0,0,0,0,0,2,0,2,0,0,0,0,0,110010076041007,6,607,607,6,psa_10,6D2
1000000US110010017021029,"Block 1029, Block Group 1, Census Tract 17.02, District of Columbia, District of Columbia",0,0,0,0,0,0,0,0,0,0,0,0,0,0,0,0,0,0,0,0,0,0,0,0,0,110010017021029,4,401,401,4,psa_56,4D1
1000000US110010062021245,"Block 1245, Block Group 1, Census Tract 62.02, District of Columbia, District of Columbia",0,0,0,0,0,0,0,0,0,0,0,0,0,0,0,0,0,0,0,0,0,0,0,0,0,110010062021245,2,207,207,2,psa_24,2D3
1000000US110010111002016,"Block 2016, Block Group 2, Census Tract 111, District of Columbia, District of Columbia",29,8,21,0,0,0,0,0,29,29,8,21,0,0,0,0,0,0,0,0,0,0,0,0,0,110010111002016,5,503,503,5,psa_45,5D2
1000000US110010062021190,"Block 1190, Block Group 1, Census Tract 62.02, District of Columbia, District of Columbia",0,0,0,0,0,0,0,0,0,0,0,0,0,0,0,0,0,0,0,0,0,0,0,0,0,110010062021190,1,103,103,1,psa_12,1D1
1000000US110010108002015,"Block 2015, Block Group 2, Census Tract 108.00, District of Columbia, District of Columbia",0,0,0,0,0,0,0,0,0,0,0,0,0,0,0,0,0,0,0,0,0,0,0,0,0,110010108002015,2,207,207,2,psa_24,2D3
1000000US110010022012011,"Block 2011, Block Group 2, Census Tract 22.01, District of Columbia, District of Columbia",0,0,0,0,0,0,0,0,0,0,0,0,0,0,0,0,0,0,0,0,0,0,0,0,0,110010022012011,4,407,407,4,psa_47,4D2
1000000US110010028012005,"Block 2005, Block Group 2, Census Tract 28.01, District of Columbia, District of Columbia",282,131,49,5,7,0,82,8,282,91,32,47,1,7,0,2,2,191,99,2,4,0,0,80,6,110010028012005,4,408,408,4,psa_39,4D3
1000000US110010018031006,"Block 1006, Block Group 1, Census Tract 18.03, District of Columbia, District of Columbia",72,8,64,0,0,0,0,0,72,70,8,62,0,0,0,0,0,2,0,2,0,0,0,0,0,110010018031006,4,402,402,4,psa_53,4D1
1000000US110010107001002,"Block 1002, Block Group 1, Census Tract 107, District of Columbia, District of Columbia",0,0,0,0,0,0,0,0,0,0,0,0,0,0,0,0,0,0,0,0,0,0,0,0,0,110010107001002,2,207,207,2,psa_24,2D3
1000000US110010004002016,"Block 2016, Block Group 2, Census Tract 4, District of Columbia, District of Columbia",12,9,3,0,0,0,0,0,12,9,9,0,0,0,0,0,0,3,0,3,0,0,0,0,0,110010004002016,2,204,204,2,psa_44,2D2
1000000US110010009013021,"Block 3021, Block Group 3, Census Tract 9.01, District of Columbia, District of Columbia",0,0,0,0,0,0,0,0,0,0,0,0,0,0,0,0,0,0,0,0,0,0,0,0,0,110010009013021,2,205,205,2,psa_46,2D2
1000000US110010017022021,"Block 2021, Block Group 2, Census Tract 17.02, District of Columbia, District of Columbia",63,12,47,0,0,0,1,3,63,58,7,47,0,0,0,1,3,5,5,0,0,0,0,0,0,110010017022021,4,401,401,4,psa_56,4D1
1000000US110010094002016,"Block 2016, Block Group 2, Census Tract 94, District of Columbia, District of Columbia",64,2,58,1,0,0,0,3,64,63,1,58,1,0,0,0,3,1,1,0,0,0,0,0,0,110010094002016,5,503,503,5,psa_45,5D2
1000000US110010003002001,"Block 2001, Block Group 2, Census Tract 3, District of Columbia, District of Columbia",227,173,13,0,31,0,5,5,227,203,155,13,0,31,0,0,4,24,18,0,0,0,0,5,1,110010003002001,2,204,204,2,psa_44,2D2
1000000US110010010016016,"Block 6016, Block Group 6, Census Tract 10.01, District of Columbia, District of Columbia",62,59,0,0,3,0,0,0,62,59,56,0,0,3,0,0,0,3,3,0,0,0,0,0,0,110010010016016,2,202,202,2,psa_52,2D1
1000000US110010049011001,"Block 1001, Block Group 1, Census Tract 49.01, District of Columbia, District of Columbia",228,0,215,4,0,0,9,0,228,217,0,207,3,0,0,7,0,11,0,8,1,0,0,2,0,110010049011001,3,307,307,3,psa_28,3D3
1000000US110010058001033,"Block 1033, Block Group 1, Census Tract 58, District of Columbia, District of Columbia",0,0,0,0,0,0,0,0,0,0,0,0,0,0,0,0,0,0,0,0,0,0,0,0,0,110010058001033,2,209,209,2,psa_57,2D3
1000000US110010087012005,"Block 2005, Block Group 2, Census Tract 87.01, District of Columbia, District of Columbia",41,9,30,0,0,0,0,2,41,40,9,30,0,0,0,0,1,1,0,0,0,0,0,0,1,110010087012005,5,502,502,5,psa_40,5D1
1000000US110010027012007,"Block 2007, Block Group 2, Census Tract 27.01, District of Columbia, District of Columbia",0,0,0,0,0,0,0,0,0,0,0,0,0,0,0,0,0,0,0,0,0,0,0,0,0,110010027012007,3,302,302,3,psa_42,3D1
1000000US110010062021094,"Block 1094, Block Group 1, Census Tract 62.02, District of Columbia, District of Columbia",0,0,0,0,0,0,0,0,0,0,0,0,0,0,0,0,0,0,0,0,0,0,0,0,0,110010062021094,2,207,207,2,psa_24,2D3
1000000US110010001001008,"Block 1008, Block Group 1, Census Tract 1, District of Columbia, District of Columbia",50,49,0,0,1,0,0,0,50,46,45,0,0,1,0,0,0,4,4,0,0,0,0,0,0,110010001001008,2,206,206,2,psa_29,2D2
1000000US110010078083009,"Block 3009, Block Group 3, Census Tract 78.08, District of Columbia, District of Columbia",100,0,100,0,0,0,0,0,100,100,0,100,0,0,0,0,0,0,0,0,0,0,0,0,0,110010078083009,6,608,608,6,psa_19,6D1
1000000US110010093013008,"Block 3008, Block Group 3, Census Tract 93.01, District of Columbia, District of Columbia",42,17,22,0,0,0,0,3,42,40,15,22,0,0,0,0,3,2,2,0,0,0,0,0,0,110010093013008,5,504,504,5,psa_43,5D2
1000000US110010008022014,"Block 2014, Block Group 2, Census Tract 8.02, District of Columbia, District of Columbia",0,0,0,0,0,0,0,0,0,0,0,0,0,0,0,0,0,0,0,0,0,0,0,0,0,110010008022014,2,205,205,2,psa_46,2D2
1000000US110010033022004,"Block 2004, Block Group 2, Census Tract 33.02, District of Columbia, District of Columbia",255,103,139,0,7,0,0,6,255,247,96,138,0,7,0,0,6,8,7,1,0,0,0,0,0,110010033022004,3,308,308,3,psa_27,3D2
1000000US110010012004008,"Block 4008, Block Group 4, Census Tract 12, District of Columbia, District of Columbia",0,0,0,0,0,0,0,0,0,0,0,0,0,0,0,0,0,0,0,0,0,0,0,0,0,110010012004008,2,202,202,2,psa_52,2D1
1000000US110010099022001,"Block 2001, Block Group 2, Census Tract 99.02, District of Columbia, District of Columbia",298,0,298,0,0,0,0,0,298,292,0,292,0,0,0,0,0,6,0,6,0,0,0,0,0,110010099022001,6,605,605,6,psa_11,6D2
1000000US110010078082000,"Block 2000, Block Group 2, Census Tract 78.08, District of Columbia, District of Columbia",13,0,9,0,4,0,0,0,13,13,0,9,0,4,0,0,0,0,0,0,0,0,0,0,0,110010078082000,6,608,608,6,psa_19,6D1
1000000US110010094004011,"Block 4011, Block Group 4, Census Tract 94, District of Columbia, District of Columbia",19,0,18,0,0,0,0,1,19,19,0,18,0,0,0,0,1,0,0,0,0,0,0,0,0,110010094004011,5,503,503,5,psa_45,5D2
1000000US110010062021080,"Block 1080, Block Group 1, Census Tract 62.02, District of Columbia, District of Columbia",0,0,0,0,0,0,0,0,0,0,0,0,0,0,0,0,0,0,0,0,0,0,0,0,0,110010062021080,2,207,207,2,psa_24,2D3
1000000US110010104001004,"Block 1004, Block Group 1, Census Tract 104, District of Columbia, District of Columbia",25,9,16,0,0,0,0,0,25,16,0,16,0,0,0,0,0,9,9,0,0,0,0,0,0,110010104001004,7,705,705,7,psa_3,7D2
1000000US110010008021019,"Block 1019, Block Group 1, Census Tract 8.02, District of Columbia, District of Columbia",0,0,0,0,0,0,0,0,0,0,0,0,0,0,0,0,0,0,0,0,0,0,0,0,0,110010008021019,2,205,205,2,psa_46,2D2
1000000US110010012003009,"Block 3009, Block Group 3, Census Tract 12, District of Columbia, District of Columbia",39,29,0,0,7,0,0,3,39,38,28,0,0,7,0,0,3,1,1,0,0,0,0,0,0,110010012003009,2,203,203,2,psa_50,2D1
1000000US110010004002001,"Block 2001, Block Group 2, Census Tract 4, District of Columbia, District of Columbia",39,36,0,0,1,0,2,0,39,35,34,0,0,1,0,0,0,4,2,0,0,0,0,2,0,110010004002001,2,204,204,2,psa_44,2D2
1000000US110010078041002,"Block 1002, Block Group 1, Census Tract 78.04, District of Columbia, District of Columbia",0,0,0,0,0,0,0,0,0,0,0,0,0,0,0,0,0,0,0,0,0,0,0,0,0,110010078041002,6,608,608,6,psa_19,6D1
1000000US110010096042009,"Block 2009, Block Group 2, Census Tract 96.04, District of Columbia, District of Columbia",129,1,124,0,0,0,0,4,129,128,1,124,0,0,0,0,3,1,0,0,0,0,0,0,1,110010096042009,6,603,603,6,psa_15,6D3
1000000US110010014023004,"Block 3004, Block Group 3, Census Tract 14.02, District of Columbia, District of Columbia",88,80,3,0,3,0,0,2,88,78,70,3,0,3,0,0,2,10,10,0,0,0,0,0,0,110010014023004,2,201,201,2,psa_55,2D1
1000000US110010073011099,"Block 1099, Block Group 1, Census Tract 73.01, District of Columbia, District of Columbia",0,0,0,0,0,0,0,0,0,0,0,0,0,0,0,0,0,0,0,0,0,0,0,0,0,110010073011099,7,708,708,7,psa_1,7D3
1000000US110010008021001,"Block 1001, Block Group 1, Census Tract 8.02, District of Columbia, District of Columbia",83,74,3,0,3,0,0,3,83,71,62,3,0,3,0,0,3,12,12,0,0,0,0,0,0,110010008021001,2,205,205,2,psa_46,2D2
1000000US110010062021019,"Block 1019, Block Group 1, Census Tract 62.02, District of Columbia, District of Columbia",0,0,0,0,0,0,0,0,0,0,0,0,0,0,0,0,0,0,0,0,0,0,0,0,0,110010062021019,1,102,102,1,psa_18,1D1
1000000US110010107001004,"Block 1004, Block Group 1, Census Tract 107, District of Columbia, District of Columbia",0,0,0,0,0,0,0,0,0,0,0,0,0,0,0,0,0,0,0,0,0,0,0,0,0,110010107001004,2,207,207,2,psa_24,2D3
1000000US110010018043004,"Block 3004, Block Group 3, Census Tract 18.04, District of Columbia, District of Columbia",487,50,342,2,1,0,72,20,487,365,17,336,2,1,0,6,3,122,33,6,0,0,0,66,17,110010018043004,4,402,402,4,psa_53,4D1
1000000US110010027022002,"Block 2002, Block Group 2, Census Tract 27.02, District of Columbia, District of Columbia",269,191,33,3,7,0,23,12,269,228,178,33,2,6,0,3,6,41,13,0,1,1,0,20,6,110010027022002,3,302,302,3,psa_42,3D1
1000000US110010066001010,"Block 1010, Block Group 1, Census Tract 66, District of Columbia, District of Columbia",230,206,9,1,8,1,4,1,230,225,203,9,1,8,1,2,1,5,3,0,0,0,0,2,0,110010066001010,1,107,107,1,psa_16,1D2
1000000US110010094004002,"Block 4002, Block Group 4, Census Tract 94, District of Columbia, District of Columbia",59,7,42,7,1,0,0,2,59,59,7,42,7,1,0,0,2,0,0,0,0,0,0,0,0,110010094004002,5,503,503,5,psa_45,5D2
1000000US110010015001026,"Block 1026, Block Group 1, Census Tract 15, District of Columbia, District of Columbia",77,69,5,0,0,0,1,2,77,74,67,5,0,0,0,1,1,3,2,0,0,0,0,0,1,110010015001026,2,201,201,2,psa_55,2D1
1000000US110010078081005,"Block 1005, Block Group 1, Census Tract 78.08, District of Columbia, District of Columbia",411,0,398,0,0,0,10,3,411,405,0,397,0,0,0,5,3,6,0,1,0,0,0,5,0,110010078081005,6,608,608,6,psa_19,6D1
1000000US110010039003002,"Block 3002, Block Group 3, Census Tract 39, District of Columbia, District of Columbia",423,285,87,0,14,1,19,17,423,366,259,84,0,14,0,2,7,57,26,3,0,0,1,17,10,110010039003002,3,303,303,3,psa_37,3D3
1000000US110010076042001,"Block 2001, Block Group 2, Census Tract 76.04, District of Columbia, District of Columbia",0,0,0,0,0,0,0,0,0,0,0,0,0,0,0,0,0,0,0,0,0,0,0,0,0,110010076042001,6,607,607,6,psa_10,6D2
1000000US110010004001012,"Block 1012, Block Group 1, Census Tract 4, District of Columbia, District of Columbia",41,37,0,0,1,0,3,0,41,36,32,0,0,1,0,3,0,5,5,0,0,0,0,0,0,110010004001012,2,204,204,2,psa_44,2D2
1000000US110010023011012,"Block 1012, Block Group 1, Census Tract 23.01, District of Columbia, District of Columbia",135,15,100,0,10,0,10,0,135,124,13,100,0,10,0,1,0,11,2,0,0,0,0,9,0,110010023011012,4,407,407,4,psa_47,4D2
1000000US110010095093002,"Block 3002, Block Group 3, Census Tract 95.09, District of Columbia, District of Columbia",129,12,106,0,0,0,11,0,129,110,12,98,0,0,0,0,0,19,0,8,0,0,0,11,0,110010095093002,4,405,405,4,psa_49,4D2
1000000US110010105002020,"Block 2020, Block Group 2, Census Tract 105, District of Columbia, District of Columbia",0,0,0,0,0,0,0,0,0,0,0,0,0,0,0,0,0,0,0,0,0,0,0,0,0,110010105002020,1,103,103,1,psa_12,1D1
1000000US110010111003006,"Block 3006, Block Group 3, Census Tract 111, District of Columbia, District of Columbia",48,7,41,0,0,0,0,0,48,47,6,41,0,0,0,0,0,1,1,0,0,0,0,0,0,110010111003006,5,503,503,5,psa_45,5D2
1000000US110010009011017,"Block 1017, Block Group 1, Census Tract 9.01, District of Columbia, District of Columbia",118,89,13,0,9,0,1,6,118,110,82,13,0,9,0,0,6,8,7,0,0,0,0,1,0,110010009011017,2,205,205,2,psa_46,2D2
1000000US110010012004027,"Block 4027, Block Group 4, Census Tract 12, District of Columbia, District of Columbia",10,8,0,0,1,0,0,1,10,9,7,0,0,1,0,0,1,1,1,0,0,0,0,0,0,110010012004027,2,203,203,2,psa_50,2D1
1000000US110010021026003,"Block 6003, Block Group 6, Census Tract 21.02, District of Columbia, District of Columbia",161,25,107,0,0,0,25,4,161,126,19,105,0,0,0,0,2,35,6,2,0,0,0,25,2,110010021026003,4,403,403,4,psa_51,4D1
1000000US110010002021005,"Block 1005, Block Group 1, Census Tract 2.02, District of Columbia, District of Columbia",78,73,2,0,0,0,0,3,78,76,71,2,0,0,0,0,3,2,2,0,0,0,0,0,0,110010002021005,2,206,206,2,psa_29,2D2
1000000US110010008022022,"Block 2022, Block Group 2, Census Tract 8.02, District of Columbia, District of Columbia",0,0,0,0,0,0,0,0,0,0,0,0,0,0,0,0,0,0,0,0,0,0,0,0,0,110010008022022,2,206,206,2,psa_29,2D2
1000000US110010016001011,"Block 1011, Block Group 1, Census Tract 16, District of Columbia, District of Columbia",62,15,43,0,0,0,0,4,62,59,14,43,0,0,0,0,2,3,1,0,0,0,0,0,2,110010016001011,4,401,401,4,psa_56,4D1
1000000US110010033012002,"Block 2002, Block Group 2, Census Tract 33.01, District of Columbia, District of Columbia",169,62,90,3,9,0,0,5,169,163,59,89,3,9,0,0,3,6,3,1,0,0,0,0,2,110010033012002,3,306,306,3,psa_38,3D2
1000000US110010011003000,"Block 3000, Block Group 3, Census Tract 11, District of Columbia, District of Columbia",54,52,2,0,0,0,0,0,54,54,52,2,0,0,0,0,0,0,0,0,0,0,0,0,0,110010011003000,2,201,201,2,psa_55,2D1
1000000US110010095051004,"Block 1004, Block Group 1, Census Tract 95.05, District of Columbia, District of Columbia",136,6,128,0,0,0,1,1,136,133,4,128,0,0,0,0,1,3,2,0,0,0,0,1,0,110010095051004,4,406,406,4,psa_54,4D2
1000000US110010107001011,"Block 1011, Block Group 1, Census Tract 107, District of Columbia, District of Columbia",0,0,0,0,0,0,0,0,0,0,0,0,0,0,0,0,0,0,0,0,0,0,0,0,0,110010107001011,2,207,207,2,psa_24,2D3
1000000US110010003001010,"Block 1010, Block Group 1, Census Tract 3, District of Columbia, District of Columbia",0,0,0,0,0,0,0,0,0,0,0,0,0,0,0,0,0,0,0,0,0,0,0,0,0,110010003001010,2,206,206,2,psa_29,2D2
1000000US110010075022008,"Block 2008, Block Group 2, Census Tract 75.02, District of Columbia, District of Columbia",43,0,42,0,1,0,0,0,43,41,0,40,0,1,0,0,0,2,0,2,0,0,0,0,0,110010075022008,7,702,702,7,psa_6,7D1
1000000US110010078092009,"Block 2009, Block Group 2, Census Tract 78.09, District of Columbia, District of Columbia",103,6,97,0,0,0,0,0,103,101,4,97,0,0,0,0,0,2,2,0,0,0,0,0,0,110010078092009,6,602,602,6,psa_25,6D1
1000000US110010009022005,"Block 2005, Block Group 2, Census Tract 9.02, District of Columbia, District of Columbia",46,42,3,0,0,0,0,1,46,41,37,3,0,0,0,0,1,5,5,0,0,0,0,0,0,110010009022005,2,205,205,2,psa_46,2D2
1000000US110010083021003,"Block 1003, Block Group 1, Census Tract 83.02, District of Columbia, District of Columbia",155,115,30,1,4,0,2,3,155,145,107,29,1,4,0,1,3,10,8,1,0,0,0,1,0,110010083021003,1,104,104,1,psa_21,1D2
1000000US110010042021006,"Block 1006, Block Group 1, Census Tract 42.02, District of Columbia, District of Columbia",200,173,5,0,8,1,8,5,200,177,157,5,0,8,1,1,5,23,16,0,0,0,0,7,0,110010042021006,2,208,208,2,psa_33,2D3
1000000US110010088031020,"Block 1020, Block Group 1, Census Tract 88.03, District of Columbia, District of Columbia",0,0,0,0,0,0,0,0,0,0,0,0,0,0,0,0,0,0,0,0,0,0,0,0,0,110010088031020,5,501,501,5,psa_35,5D1
1000000US110010092032010,"Block 2010, Block Group 2, Census Tract 92.03, District of Columbia, District of Columbia",119,10,109,0,0,0,0,0,119,119,10,109,0,0,0,0,0,0,0,0,0,0,0,0,0,110010092032010,5,502,502,5,psa_40,5D1
1000000US110010002023011,"Block 3011, Block Group 3, Census Tract 2.02, District of Columbia, District of Columbia",111,103,1,0,2,0,2,3,111,95,90,1,0,2,0,0,2,16,13,0,0,0,0,2,1,110010002023011,2,206,206,2,psa_29,2D2
1000000US110010077082011,"Block 2011, Block Group 2, Census Tract 77.08, District of Columbia, District of Columbia",120,3,114,0,0,0,0,3,120,118,3,112,0,0,0,0,3,2,0,2,0,0,0,0,0,110010077082011,6,603,603,6,psa_15,6D3
1000000US110010013023006,"Block 3006, Block Group 3, Census Tract 13.02, District of Columbia, District of Columbia",0,0,0,0,0,0,0,0,0,0,0,0,0,0,0,0,0,0,0,0,0,0,0,0,0,110010013023006,2,203,203,2,psa_50,2D1
1000000US110010095053014,"Block 3014, Block Group 3, Census Tract 95.05, District of Columbia, District of Columbia",94,0,85,0,0,0,6,3,94,87,0,85,0,0,0,0,2,7,0,0,0,0,0,6,1,110010095053014,4,406,406,4,psa_54,4D2
1000000US110010018031013,"Block 1013, Block Group 1, Census Tract 18.03, District of Columbia, District of Columbia",0,0,0,0,0,0,0,0,0,0,0,0,0,0,0,0,0,0,0,0,0,0,0,0,0,110010018031013,2,201,201,2,psa_55,2D1
1000000US110010095052001,"Block 2001, Block Group 2, Census Tract 95.05, District of Columbia, District of Columbia",51,9,40,0,0,0,0,2,51,51,9,40,0,0,0,0,2,0,0,0,0,0,0,0,0,110010095052001,4,406,406,4,psa_54,4D2
1000000US110010095071010,"Block 1010, Block Group 1, Census Tract 95.07, District of Columbia, District of Columbia",28,0,27,0,0,0,0,1,28,28,0,27,0,0,0,0,1,0,0,0,0,0,0,0,0,110010095071010,4,406,406,4,psa_54,4D2
1000000US110010105002026,"Block 2026, Block Group 2, Census Tract 105, District of Columbia, District of Columbia",0,0,0,0,0,0,0,0,0,0,0,0,0,0,0,0,0,0,0,0,0,0,0,0,0,110010105002026,1,103,103,1,psa_12,1D1
1000000US110010009013004,"Block 3004, Block Group 3, Census Tract 9.01, District of Columbia, District of Columbia",45,41,2,0,0,0,2,0,45,43,39,2,0,0,0,2,0,2,2,0,0,0,0,0,0,110010009013004,2,205,205,2,psa_46,2D2
1000000US110010073011059,"Block 1059, Block Group 1, Census Tract 73.01, District of Columbia, District of Columbia",0,0,0,0,0,0,0,0,0,0,0,0,0,0,0,0,0,0,0,0,0,0,0,0,0,110010073011059,7,708,708,7,psa_1,7D3
1000000US110010028012004,"Block 2004, Block Group 2, Census Tract 28.01, District of Columbia, District of Columbia",241,53,66,1,0,0,116,5,241,96,31,65,0,0,0,0,0,145,22,1,1,0,0,116,5,110010028012004,4,408,408,4,psa_39,4D3
1000000US110010094004012,"Block 4012, Block Group 4, Census Tract 94, District of Columbia, District of Columbia",37,2,35,0,0,0,0,0,37,37,2,35,0,0,0,0,0,0,0,0,0,0,0,0,0,110010094004012,5,503,503,5,psa_45,5D2
1000000US110010078092001,"Block 2001, Block Group 2, Census Tract 78.09, District of Columbia, District of Columbia",80,2,78,0,0,0,0,0,80,79,1,78,0,0,0,0,0,1,1,0,0,0,0,0,0,110010078092001,6,602,602,6,psa_25,6D1
1000000US110010012003005,"Block 3005, Block Group 3, Census Tract 12, District of Columbia, District of Columbia",12,9,0,0,0,0,0,3,12,12,9,0,0,0,0,0,3,0,0,0,0,0,0,0,0,110010012003005,2,202,202,2,psa_52,2D1
1000000US110010013022000,"Block 2000, Block Group 2, Census Tract 13.02, District of Columbia, District of Columbia",8,8,0,0,0,0,0,0,8,8,8,0,0,0,0,0,0,0,0,0,0,0,0,0,0,110010013022000,2,203,203,2,psa_50,2D1
1000000US110010077032005,"Block 2005, Block Group 2, Census Tract 77.03, District of Columbia, District of Columbia",217,1,207,0,5,0,2,2,217,215,1,207,0,5,0,0,2,2,0,0,0,0,0,2,0,110010077032005,6,603,603,6,psa_15,6D3
1000000US110010078043001,"Block 3001, Block Group 3, Census Tract 78.04, District of Columbia, District of Columbia",35,0,34,0,0,0,0,1,35,32,0,32,0,0,0,0,0,3,0,2,0,0,0,0,1,110010078043001,6,602,602,6,psa_25,6D1
1000000US110010053014004,"Block 4004, Block Group 4, Census Tract 53.01, District of Columbia, District of Columbia",252,212,9,0,17,0,5,9,252,224,193,8,0,17,0,0,6,28,19,1,0,0,0,5,3,110010053014004,3,301,301,3,psa_31,3D3
1000000US110010080012013,"Block 2013, Block Group 2, Census Tract 80.01, District of Columbia, District of Columbia",0,0,0,0,0,0,0,0,0,0,0,0,0,0,0,0,0,0,0,0,0,0,0,0,0,110010080012013,1,108,108,1,psa_17,1D2
1000000US110010095032002,"Block 2002, Block Group 2, Census Tract 95.03, District of Columbia, District of Columbia",71,9,55,0,2,0,2,3,71,67,9,53,0,2,0,0,3,4,0,2,0,0,0,2,0,110010095032002,4,405,405,4,psa_49,4D2
1000000US110010031001014,"Block 1014, Block Group 1, Census Tract 31, District of Columbia, District of Columbia",55,16,23,0,0,0,14,2,55,38,16,20,0,0,0,0,2,17,0,3,0,0,0,14,0,110010031001014,4,409,409,4,psa_41,4D3
1000000US110010095091004,"Block 1004, Block Group 1, Census Tract 95.09, District of Columbia, District of Columbia",111,7,86,2,0,0,14,2,111,88,2,84,1,0,0,1,0,23,5,2,1,0,0,13,2,110010095091004,4,405,405,4,psa_49,4D2
1000000US110010032004008,"Block 4008, Block Group 4, Census Tract 32, District of Columbia, District of Columbia",0,0,0,0,0,0,0,0,0,0,0,0,0,0,0,0,0,0,0,0,0,0,0,0,0,110010032004008,3,306,306,3,psa_38,3D2
1000000US110010099041005,"Block 1005, Block Group 1, Census Tract 99.04, District of Columbia, District of Columbia",0,0,0,0,0,0,0,0,0,0,0,0,0,0,0,0,0,0,0,0,0,0,0,0,0,110010099041005,6,604,604,6,psa_14,6D3
1000000US110010078041016,"Block 1016, Block Group 1, Census Tract 78.04, District of Columbia, District of Columbia",77,1,76,0,0,0,0,0,77,77,1,76,0,0,0,0,0,0,0,0,0,0,0,0,0,110010078041016,6,602,602,6,psa_25,6D1
1000000US110010029002007,"Block 2007, Block Group 2, Census Tract 29, District of Columbia, District of Columbia",159,87,35,0,0,0,31,6,159,74,41,33,0,0,0,0,0,85,46,2,0,0,0,31,6,110010029002007,4,408,408,4,psa_39,4D3
1000000US110010058001032,"Block 1032, Block Group 1, Census Tract 58, District of Columbia, District of Columbia",0,0,0,0,0,0,0,0,0,0,0,0,0,0,0,0,0,0,0,0,0,0,0,0,0,110010058001032,2,209,209,2,psa_57,2D3
1000000US110010090001006,"Block 1006, Block Group 1, Census Tract 90, District of Columbia, District of Columbia",0,0,0,0,0,0,0,0,0,0,0,0,0,0,0,0,0,0,0,0,0,0,0,0,0,110010090001006,5,503,503,5,psa_45,5D2
1000000US110010025021003,"Block 1003, Block Group 1, Census Tract 25.02, District of Columbia, District of Columbia",105,3,76,1,2,0,20,3,105,80,3,72,1,2,0,0,2,25,0,4,0,0,0,20,1,110010025021003,4,404,404,4,psa_48,4D3
1000000US110010019014014,"Block 4014, Block Group 4, Census Tract 19.01, District of Columbia, District of Columbia",81,7,68,6,0,0,0,0,81,71,5,66,0,0,0,0,0,10,2,2,6,0,0,0,0,110010019014014,4,402,402,4,psa_53,4D1
1000000US110010018032006,"Block 2006, Block Group 2, Census Tract 18.03, District of Columbia, District of Columbia",0,0,0,0,0,0,0,0,0,0,0,0,0,0,0,0,0,0,0,0,0,0,0,0,0,110010018032006,4,402,402,4,psa_53,4D1
1000000US110010071001013,"Block 1013, Block Group 1, Census Tract 71, District of Columbia, District of Columbia",0,0,0,0,0,0,0,0,0,0,0,0,0,0,0,0,0,0,0,0,0,0,0,0,0,110010071001013,1,106,106,1,psa_13,1D3
1000000US110010077031002,"Block 1002, Block Group 1, Census Tract 77.03, District of Columbia, District of Columbia",189,1,182,0,0,0,1,5,189,188,1,182,0,0,0,0,5,1,0,0,0,0,0,1,0,110010077031002,6,603,603,6,psa_15,6D3
1000000US110010013023007,"Block 3007, Block Group 3, Census Tract 13.02, District of Columbia, District of Columbia",11,11,0,0,0,0,0,0,11,10,10,0,0,0,0,0,0,1,1,0,0,0,0,0,0,110010013023007,2,203,203,2,psa_50,2D1
1000000US110010010012004,"Block 2004, Block Group 2, Census Tract 10.01, District of Columbia, District of Columbia",16,16,0,0,0,0,0,0,16,11,11,0,0,0,0,0,0,5,5,0,0,0,0,0,0,110010010012004,2,202,202,2,psa_52,2D1
1000000US110010095053016,"Block 3016, Block Group 3, Census Tract 95.05, District of Columbia, District of Columbia",35,3,32,0,0,0,0,0,35,35,3,32,0,0,0,0,0,0,0,0,0,0,0,0,0,110010095053016,4,406,406,4,psa_54,4D2
1000000US110010098011003,"Block 1003, Block Group 1, Census Tract 98.01, District of Columbia, District of Columbia",301,0,295,2,0,0,0,4,301,298,0,292,2,0,0,0,4,3,0,3,0,0,0,0,0,110010098011003,7,706,706,7,psa_2,7D3
1000000US110010099021007,"Block 1007, Block Group 1, Census Tract 99.02, District of Columbia, District of Columbia",0,0,0,0,0,0,0,0,0,0,0,0,0,0,0,0,0,0,0,0,0,0,0,0,0,110010099021007,6,605,605,6,psa_11,6D2
1000000US110010103002004,"Block 2004, Block Group 2, Census Tract 103, District of Columbia, District of Columbia",58,3,52,0,2,0,0,1,58,57,3,51,0,2,0,0,1,1,0,1,0,0,0,0,0,110010103002004,4,401,401,4,psa_56,4D1
1000000US110010048011007,"Block 1007, Block Group 1, Census Tract 48.01, District of Columbia, District of Columbia",49,14,34,0,0,0,0,1,49,49,14,34,0,0,0,0,1,0,0,0,0,0,0,0,0,110010048011007,3,308,308,3,psa_27,3D2
1000000US110010062021186,"Block 1186, Block Group 1, Census Tract 62.02, District of Columbia, District of Columbia",0,0,0,0,0,0,0,0,0,0,0,0,0,0,0,0,0,0,0,0,0,0,0,0,0,110010062021186,2,207,207,2,psa_24,2D3
1000000US110010077032006,"Block 2006, Block Group 2, Census Tract 77.03, District of Columbia, District of Columbia",38,0,37,0,0,0,0,1,38,38,0,37,0,0,0,0,1,0,0,0,0,0,0,0,0,110010077032006,6,603,603,6,psa_15,6D3
1000000US110010018043000,"Block 3000, Block Group 3, Census Tract 18.04, District of Columbia, District of Columbia",132,15,109,0,0,0,8,0,132,115,6,109,0,0,0,0,0,17,9,0,0,0,0,8,0,110010018043000,4,402,402,4,psa_53,4D1
1000000US110010093011002,"Block 1002, Block Group 1, Census Tract 93.01, District of Columbia, District of Columbia",73,37,29,0,0,0,0,7,73,67,33,29,0,0,0,0,5,6,4,0,0,0,0,0,2,110010093011002,5,504,504,5,psa_43,5D2
1000000US110010098041003,"Block 1003, Block Group 1, Census Tract 98.04, District of Columbia, District of Columbia",24,0,21,0,2,0,0,1,24,23,0,20,0,2,0,0,1,1,0,1,0,0,0,0,0,110010098041003,7,705,705,7,psa_3,7D2
1000000US110010073043000,"Block 3000, Block Group 3, Census Tract 73.04, District of Columbia, District of Columbia",89,0,84,0,0,0,5,0,89,83,0,83,0,0,0,0,0,6,0,1,0,0,0,5,0,110010073043000,7,705,705,7,psa_3,7D2
1000000US110010033021001,"Block 1001, Block Group 1, Census Tract 33.02, District of Columbia, District of Columbia",0,0,0,0,0,0,0,0,0,0,0,0,0,0,0,0,0,0,0,0,0,0,0,0,0,110010033021001,3,308,308,3,psa_27,3D2
1000000US110010062021027,"Block 1027, Block Group 1, Census Tract 62.02, District of Columbia, District of Columbia",0,0,0,0,0,0,0,0,0,0,0,0,0,0,0,0,0,0,0,0,0,0,0,0,0,110010062021027,2,207,207,2,psa_24,2D3
1000000US110010093012022,"Block 2022, Block Group 2, Census Tract 93.01, District of Columbia, District of Columbia",27,10,17,0,0,0,0,0,27,26,9,17,0,0,0,0,0,1,1,0,0,0,0,0,0,110010093012022,5,504,504,5,psa_43,5D2
1000000US110010102001001,"Block 1001, Block Group 1, Census Tract 102, District of Columbia, District of Columbia",0,0,0,0,0,0,0,0,0,0,0,0,0,0,0,0,0,0,0,0,0,0,0,0,0,110010102001001,1,103,103,1,psa_12,1D1
1000000US110010031001002,"Block 1002, Block Group 1, Census Tract 31, District of Columbia, District of Columbia",155,55,67,0,6,0,23,4,155,101,27,67,0,6,0,0,1,54,28,0,0,0,0,23,3,110010031001002,4,409,409,4,psa_41,4D3
1000000US110010095011009,"Block 1009, Block Group 1, Census Tract 95.01, District of Columbia, District of Columbia",0,0,0,0,0,0,0,0,0,0,0,0,0,0,0,0,0,0,0,0,0,0,0,0,0,110010095011009,4,405,405,4,psa_49,4D2
1000000US110010109002018,"Block 2018, Block Group 2, Census Tract 109, District of Columbia, District of Columbia",0,0,0,0,0,0,0,0,0,0,0,0,0,0,0,0,0,0,0,0,0,0,0,0,0,110010109002018,7,708,708,7,psa_1,7D3
1000000US110010111002000,"Block 2000, Block Group 2, Census Tract 111, District of Columbia, District of Columbia",18,0,18,0,0,0,0,0,18,18,0,18,0,0,0,0,0,0,0,0,0,0,0,0,0,110010111002000,5,503,503,5,psa_45,5D2
1000000US110010012002001,"Block 2001, Block Group 2, Census Tract 12, District of Columbia, District of Columbia",53,45,0,0,0,0,8,0,53,44,44,0,0,0,0,0,0,9,1,0,0,0,0,8,0,110010012002001,2,203,203,2,psa_50,2D1
1000000US110010055004001,"Block 4001, Block Group 4, Census Tract 55, District of Columbia, District of Columbia",269,213,10,0,30,0,5,11,269,246,195,10,0,30,0,1,10,23,18,0,0,0,0,4,1,110010055004001,2,208,208,2,psa_33,2D3
1000000US110010099031002,"Block 1002, Block Group 1, Census Tract 99.03, District of Columbia, District of Columbia",86,2,75,0,0,0,5,4,86,79,2,74,0,0,0,0,3,7,0,1,0,0,0,5,1,110010099031002,6,604,604,6,psa_14,6D3
1000000US110010017022006,"Block 2006, Block Group 2, Census Tract 17.02, District of Columbia, District of Columbia",42,13,26,1,0,0,0,2,42,42,13,26,1,0,0,0,2,0,0,0,0,0,0,0,0,110010017022006,4,401,401,4,psa_56,4D1
1000000US110010015003005,"Block 3005, Block Group 3, Census Tract 15, District of Columbia, District of Columbia",0,0,0,0,0,0,0,0,0,0,0,0,0,0,0,0,0,0,0,0,0,0,0,0,0,110010015003005,2,201,201,2,psa_55,2D1
1000000US110010077091009,"Block 1009, Block Group 1, Census Tract 77.09, District of Columbia, District of Columbia",0,0,0,0,0,0,0,0,0,0,0,0,0,0,0,0,0,0,0,0,0,0,0,0,0,110010077091009,1,107,107,1,psa_16,1D2
1000000US110010028012003,"Block 2003, Block Group 2, Census Tract 28.01, District of Columbia, District of Columbia",97,61,21,2,5,0,0,8,97,86,51,21,2,4,0,0,8,11,10,0,0,1,0,0,0,110010028012003,4,408,408,4,psa_39,4D3
1000000US110010077032003,"Block 2003, Block Group 2, Census Tract 77.03, District of Columbia, District of Columbia",74,0,74,0,0,0,0,0,74,73,0,73,0,0,0,0,0,1,0,1,0,0,0,0,0,110010077032003,6,603,603,6,psa_15,6D3
1000000US110010021013003,"Block 3003, Block Group 3, Census Tract 21.01, District of Columbia, District of Columbia",228,35,158,0,0,0,11,24,228,177,14,158,0,0,0,0,5,51,21,0,0,0,0,11,19,110010021013003,4,403,403,4,psa_51,4D1
1000000US110010101001028,"Block 1028, Block Group 1, Census Tract 101, District of Columbia, District of Columbia",38,7,27,0,0,0,1,3,38,37,7,27,0,0,0,0,3,1,0,0,0,0,0,1,0,110010101001028,2,209,209,2,psa_57,2D3
1000000US110010016004037,"Block 4037, Block Group 4, Census Tract 16, District of Columbia, District of Columbia",48,2,46,0,0,0,0,0,48,46,2,44,0,0,0,0,0,2,0,2,0,0,0,0,0,110010016004037,4,401,401,4,psa_56,4D1
1000000US110010006004006,"Block 4006, Block Group 4, Census Tract 6, District of Columbia, District of Columbia",71,63,0,0,3,0,0,5,71,68,60,0,0,3,0,0,5,3,3,0,0,0,0,0,0,110010006004006,2,203,203,2,psa_50,2D1
1000000US110010078083002,"Block 3002, Block Group 3, Census Tract 78.08, District of Columbia, District of Columbia",8,0,8,0,0,0,0,0,8,8,0,8,0,0,0,0,0,0,0,0,0,0,0,0,0,110010078083002,6,608,608,6,psa_19,6D1
1000000US110010058002004,"Block 2004, Block Group 2, Census Tract 58, District of Columbia, District of Columbia",385,288,24,0,54,0,5,14,385,357,268,24,0,54,0,0,11,28,20,0,0,0,0,5,3,110010058002004,1,101,101,1,psa_20,1D1
1000000US110010065002009,"Block 2009, Block Group 2, Census Tract 65, District of Columbia, District of Columbia",42,40,0,0,1,0,1,0,42,39,38,0,0,1,0,0,0,3,2,0,0,0,0,1,0,110010065002009,1,106,106,1,psa_13,1D3
1000000US110010077092005,"Block 2005, Block Group 2, Census Tract 77.09, District of Columbia, District of Columbia",98,1,97,0,0,0,0,0,98,98,1,97,0,0,0,0,0,0,0,0,0,0,0,0,0,110010077092005,6,605,605,6,psa_11,6D2
1000000US110010007014008,"Block 4008, Block Group 4, Census Tract 7.01, District of Columbia, District of Columbia",34,32,0,0,2,0,0,0,34,31,29,0,0,2,0,0,0,3,3,0,0,0,0,0,0,110010007014008,2,204,204,2,psa_44,2D2
1000000US110010111002011,"Block 2011, Block Group 2, Census Tract 111, District of Columbia, District of Columbia",52,4,46,0,0,0,0,2,52,51,3,46,0,0,0,0,2,1,1,0,0,0,0,0,0,110010111002011,5,503,503,5,psa_45,5D2
1000000US110010044001015,"Block 1015, Block Group 1, Census Tract 44, District of Columbia, District of Columbia",224,166,36,1,17,0,2,2,224,213,158,35,1,17,0,0,2,11,8,1,0,0,0,2,0,110010044001015,3,305,305,3,psa_32,3D2
1000000US110010076042024,"Block 2024, Block Group 2, Census Tract 76.04, District of Columbia, District of Columbia",8,0,8,0,0,0,0,0,8,8,0,8,0,0,0,0,0,0,0,0,0,0,0,0,0,110010076042024,6,606,606,6,psa_7,6D2
1000000US110010005022000,"Block 2000, Block Group 2, Census Tract 5.02, District of Columbia, District of Columbia",224,201,5,0,11,0,2,5,224,217,195,5,0,11,0,1,5,7,6,0,0,0,0,1,0,110010005022000,2,204,204,2,psa_44,2D2
1000000US110010016004007,"Block 4007, Block Group 4, Census Tract 16, District of Columbia, District of Columbia",0,0,0,0,0,0,0,0,0,0,0,0,0,0,0,0,0,0,0,0,0,0,0,0,0,110010016004007,4,401,401,4,psa_56,4D1
1000000US110010059001020,"Block 1020, Block Group 1, Census Tract 59, District of Columbia, District of Columbia",0,0,0,0,0,0,0,0,0,0,0,0,0,0,0,0,0,0,0,0,0,0,0,0,0,110010059001020,1,101,101,1,psa_20,1D1
1000000US110010062021124,"Block 1124, Block Group 1, Census Tract 62.02, District of Columbia, District of Columbia",0,0,0,0,0,0,0,0,0,0,0,0,0,0,0,0,0,0,0,0,0,0,0,0,0,110010062021124,1,102,102,1,psa_18,1D1
1000000US110010080021013,"Block 1013, Block Group 1, Census Tract 80.02, District of Columbia, District of Columbia",136,25,104,0,4,0,0,3,136,135,24,104,0,4,0,0,3,1,1,0,0,0,0,0,0,110010080021013,1,108,108,1,psa_17,1D2
1000000US110010055002012,"Block 2012, Block Group 2, Census Tract 55, District of Columbia, District of Columbia",37,32,3,0,2,0,0,0,37,36,31,3,0,2,0,0,0,1,1,0,0,0,0,0,0,110010055002012,2,207,207,2,psa_24,2D3
1000000US110010093013024,"Block 3024, Block Group 3, Census Tract 93.01, District of Columbia, District of Columbia",0,0,0,0,0,0,0,0,0,0,0,0,0,0,0,0,0,0,0,0,0,0,0,0,0,110010093013024,5,504,504,5,psa_43,5D2
1000000US110010007021006,"Block 1006, Block Group 1, Census Tract 7.02, District of Columbia, District of Columbia",0,0,0,0,0,0,0,0,0,0,0,0,0,0,0,0,0,0,0,0,0,0,0,0,0,110010007021006,2,204,204,2,psa_44,2D2
1000000US110010083012009,"Block 2009, Block Group 2, Census Tract 83.01, District of Columbia, District of Columbia",31,31,0,0,0,0,0,0,31,31,31,0,0,0,0,0,0,0,0,0,0,0,0,0,0,110010083012009,1,108,108,1,psa_17,1D2
1000000US110010096011041,"Block 1041, Block Group 1, Census Tract 96.01, District of Columbia, District of Columbia",0,0,0,0,0,0,0,0,0,0,0,0,0,0,0,0,0,0,0,0,0,0,0,0,0,110010096011041,6,601,601,6,psa_30,6D1
1000000US110010029002003,"Block 2003, Block Group 2, Census Tract 29, District of Columbia, District of Columbia",109,48,41,1,2,0,12,5,109,70,30,35,0,2,0,0,3,39,18,6,1,0,0,12,2,110010029002003,4,408,408,4,psa_39,4D3
1000000US110010105002014,"Block 2014, Block Group 2, Census Tract 105, District of Columbia, District of Columbia",0,0,0,0,0,0,0,0,0,0,0,0,0,0,0,0,0,0,0,0,0,0,0,0,0,110010105002014,1,103,103,1,psa_12,1D1
1000000US110010018031009,"Block 1009, Block Group 1, Census Tract 18.03, District of Columbia, District of Columbia",0,0,0,0,0,0,0,0,0,0,0,0,0,0,0,0,0,0,0,0,0,0,0,0,0,110010018031009,4,402,402,4,psa_53,4D1
1000000US110010010023002,"Block 3002, Block Group 3, Census Tract 10.02, District of Columbia, District of Columbia",50,34,0,2,7,0,0,7,50,50,34,0,2,7,0,0,7,0,0,0,0,0,0,0,0,110010010023002,2,202,202,2,psa_52,2D1
1000000US110010091021000,"Block 1000, Block Group 1, Census Tract 91.02, District of Columbia, District of Columbia",11,4,7,0,0,0,0,0,11,11,4,7,0,0,0,0,0,0,0,0,0,0,0,0,0,110010091021000,5,505,505,5,psa_34,5D2
1000000US110010081003004,"Block 3004, Block Group 3, Census Tract 81, District of Columbia, District of Columbia",40,39,1,0,0,0,0,0,40,39,38,1,0,0,0,0,0,1,1,0,0,0,0,0,0,110010081003004,1,108,108,1,psa_17,1D2
1000000US110010048021003,"Block 1003, Block Group 1, Census Tract 48.02, District of Columbia, District of Columbia",0,0,0,0,0,0,0,0,0,0,0,0,0,0,0,0,0,0,0,0,0,0,0,0,0,110010048021003,3,308,308,3,psa_27,3D2
1000000US110010062021053,"Block 1053, Block Group 1, Census Tract 62.02, District of Columbia, District of Columbia",0,0,0,0,0,0,0,0,0,0,0,0,0,0,0,0,0,0,0,0,0,0,0,0,0,110010062021053,2,207,207,2,psa_24,2D3
1000000US110010075031013,"Block 1013, Block Group 1, Census Tract 75.03, District of Columbia, District of Columbia",64,0,64,0,0,0,0,0,64,64,0,64,0,0,0,0,0,0,0,0,0,0,0,0,0,110010075031013,7,701,701,7,psa_9,7D1
1000000US110010010016014,"Block 6014, Block Group 6, Census Tract 10.01, District of Columbia, District of Columbia",60,51,1,1,2,0,2,3,60,55,50,1,0,2,0,0,2,5,1,0,1,0,0,2,1,110010010016014,2,202,202,2,psa_52,2D1
1000000US110010044002013,"Block 2013, Block Group 2, Census Tract 44, District of Columbia, District of Columbia",86,42,11,2,2,0,26,3,86,59,41,11,2,2,0,1,2,27,1,0,0,0,0,25,1,110010044002013,3,305,305,3,psa_32,3D2
1000000US110010095071006,"Block 1006, Block Group 1, Census Tract 95.07, District of Columbia, District of Columbia",138,4,125,0,0,0,6,3,138,127,3,121,0,0,0,0,3,11,1,4,0,0,0,6,0,110010095071006,4,406,406,4,psa_54,4D2
1000000US110010062021038,"Block 1038, Block Group 1, Census Tract 62.02, District of Columbia, District of Columbia",0,0,0,0,0,0,0,0,0,0,0,0,0,0,0,0,0,0,0,0,0,0,0,0,0,110010062021038,2,207,207,2,psa_24,2D3
1000000US110010015001011,"Block 1011, Block Group 1, Census Tract 15, District of Columbia, District of Columbia",58,39,17,0,2,0,0,0,58,49,30,17,0,2,0,0,0,9,9,0,0,0,0,0,0,110010015001011,2,201,201,2,psa_55,2D1
1000000US110010016004021,"Block 4021, Block Group 4, Census Tract 16, District of Columbia, District of Columbia",41,13,27,0,0,0,1,0,41,40,13,27,0,0,0,0,0,1,0,0,0,0,0,1,0,110010016004021,4,401,401,4,psa_56,4D1
1000000US110010019021016,"Block 1016, Block Group 1, Census Tract 19.02, District of Columbia, District of Columbia",67,9,54,0,0,0,0,4,67,64,6,54,0,0,0,0,4,3,3,0,0,0,0,0,0,110010019021016,4,402,402,4,psa_53,4D1
1000000US110010034002027,"Block 2027, Block Group 2, Census Tract 34, District of Columbia, District of Columbia",0,0,0,0,0,0,0,0,0,0,0,0,0,0,0,0,0,0,0,0,0,0,0,0,0,110010034002027,3,308,308,3,psa_27,3D2
1000000US110010096021027,"Block 1027, Block Group 1, Census Tract 96.02, District of Columbia, District of Columbia",0,0,0,0,0,0,0,0,0,0,0,0,0,0,0,0,0,0,0,0,0,0,0,0,0,110010096021027,6,601,601,6,psa_30,6D1
1000000US110010019014012,"Block 4012, Block Group 4, Census Tract 19.01, District of Columbia, District of Columbia",58,3,54,0,0,0,0,1,58,55,0,54,0,0,0,0,1,3,3,0,0,0,0,0,0,110010019014012,4,402,402,4,psa_53,4D1
1000000US110010047021001,"Block 1001, Block Group 1, Census Tract 47.02, District of Columbia, District of Columbia",358,3,344,0,0,0,4,7,358,349,3,341,0,0,0,0,5,9,0,3,0,0,0,4,2,110010047021001,1,102,102,1,psa_18,1D1
1000000US110010013011000,"Block 1000, Block Group 1, Census Tract 13.01, District of Columbia, District of Columbia",0,0,0,0,0,0,0,0,0,0,0,0,0,0,0,0,0,0,0,0,0,0,0,0,0,110010013011000,2,203,203,2,psa_50,2D1
1000000US110010089031003,"Block 1003, Block Group 1, Census Tract 89.03, District of Columbia, District of Columbia",0,0,0,0,0,0,0,0,0,0,0,0,0,0,0,0,0,0,0,0,0,0,0,0,0,110010089031003,5,507,507,5,psa_23,5D3
1000000US110010056002007,"Block 2007, Block Group 2, Census Tract 56, District of Columbia, District of Columbia",0,0,0,0,0,0,0,0,0,0,0,0,0,0,0,0,0,0,0,0,0,0,0,0,0,110010056002007,2,207,207,2,psa_24,2D3
1000000US110010062021142,"Block 1142, Block Group 1, Census Tract 62.02, District of Columbia, District of Columbia",0,0,0,0,0,0,0,0,0,0,0,0,0,0,0,0,0,0,0,0,0,0,0,0,0,110010062021142,1,106,106,1,psa_13,1D3
1000000US110010094004013,"Block 4013, Block Group 4, Census Tract 94, District of Columbia, District of Columbia",86,9,59,0,0,0,15,3,86,69,9,59,0,0,0,0,1,17,0,0,0,0,0,15,2,110010094004013,5,503,503,5,psa_45,5D2
1000000US110010105002018,"Block 2018, Block Group 2, Census Tract 105, District of Columbia, District of Columbia",0,0,0,0,0,0,0,0,0,0,0,0,0,0,0,0,0,0,0,0,0,0,0,0,0,110010105002018,1,103,103,1,psa_12,1D1
1000000US110010064002018,"Block 2018, Block Group 2, Census Tract 64, District of Columbia, District of Columbia",0,0,0,0,0,0,0,0,0,0,0,0,0,0,0,0,0,0,0,0,0,0,0,0,0,110010064002018,1,105,105,1,psa_22,1D3
1000000US110010001003003,"Block 3003, Block Group 3, Census Tract 1, District of Columbia, District of Columbia",82,78,0,0,4,0,0,0,82,73,69,0,0,4,0,0,0,9,9,0,0,0,0,0,0,110010001003003,2,206,206,2,psa_29,2D2
1000000US110010049022000,"Block 2000, Block Group 2, Census Tract 49.02, District of Columbia, District of Columbia",238,2,230,1,0,0,3,2,238,234,2,229,1,0,0,0,2,4,0,1,0,0,0,3,0,110010049022000,3,307,307,3,psa_28,3D3
1000000US110010103003012,"Block 3012, Block Group 3, Census Tract 103, District of Columbia, District of Columbia",46,26,17,0,0,0,2,1,46,44,26,17,0,0,0,0,1,2,0,0,0,0,0,2,0,110010103003012,4,401,401,4,psa_56,4D1
1000000US110010017022009,"Block 2009, Block Group 2, Census Tract 17.02, District of Columbia, District of Columbia",0,0,0,0,0,0,0,0,0,0,0,0,0,0,0,0,0,0,0,0,0,0,0,0,0,110010017022009,4,401,401,4,psa_56,4D1
1000000US110010016003000,"Block 3000, Block Group 3, Census Tract 16, District of Columbia, District of Columbia",45,6,33,0,0,0,6,0,45,39,6,33,0,0,0,0,0,6,0,0,0,0,0,6,0,110010016003000,4,401,401,4,psa_56,4D1
1000000US110010009012015,"Block 2015, Block Group 2, Census Tract 9.01, District of Columbia, District of Columbia",36,33,1,0,0,0,2,0,36,34,32,0,0,0,0,2,0,2,1,1,0,0,0,0,0,110010009012015,2,205,205,2,psa_46,2D2
1000000US110010062021039,"Block 1039, Block Group 1, Census Tract 62.02, District of Columbia, District of Columbia",0,0,0,0,0,0,0,0,0,0,0,0,0,0,0,0,0,0,0,0,0,0,0,0,0,110010062021039,2,207,207,2,psa_24,2D3
1000000US110010016004023,"Block 4023, Block Group 4, Census Tract 16, District of Columbia, District of Columbia",52,15,32,0,0,0,0,5,52,49,12,32,0,0,0,0,5,3,3,0,0,0,0,0,0,110010016004023,4,401,401,4,psa_56,4D1
1000000US110010065001005,"Block 1005, Block Group 1, Census Tract 65, District of Columbia, District of Columbia",59,38,5,0,15,0,0,1,59,58,37,5,0,15,0,0,1,1,1,0,0,0,0,0,0,110010065001005,1,106,106,1,psa_13,1D3
1000000US110010080012010,"Block 2010, Block Group 2, Census Tract 80.01, District of Columbia, District of Columbia",126,76,36,0,5,0,3,6,126,120,74,36,0,4,0,1,5,6,2,0,0,1,0,2,1,110010080012010,1,108,108,1,psa_17,1D2
1000000US110010017021018,"Block 1018, Block Group 1, Census Tract 17.02, District of Columbia, District of Columbia",55,24,22,0,4,0,0,5,55,54,23,22,0,4,0,0,5,1,1,0,0,0,0,0,0,110010017021018,4,401,401,4,psa_56,4D1
1000000US110010111001026,"Block 1026, Block Group 1, Census Tract 111, District of Columbia, District of Columbia",24,0,24,0,0,0,0,0,24,24,0,24,0,0,0,0,0,0,0,0,0,0,0,0,0,110010111001026,5,503,503,5,psa_45,5D2
1000000US110010062021187,"Block 1187, Block Group 1, Census Tract 62.02, District of Columbia, District of Columbia",0,0,0,0,0,0,0,0,0,0,0,0,0,0,0,0,0,0,0,0,0,0,0,0,0,110010062021187,2,207,207,2,psa_24,2D3
1000000US110010072001024,"Block 1024, Block Group 1, Census Tract 72, District of Columbia, District of Columbia",0,0,0,0,0,0,0,0,0,0,0,0,0,0,0,0,0,0,0,0,0,0,0,0,0,110010072001024,1,106,106,1,psa_13,1D3
1000000US110010073011005,"Block 1005, Block Group 1, Census Tract 73.01, District of Columbia, District of Columbia",0,0,0,0,0,0,0,0,0,0,0,0,0,0,0,0,0,0,0,0,0,0,0,0,0,110010073011005,7,703,703,7,psa_8,7D1
1000000US110010003001004,"Block 1004, Block Group 1, Census Tract 3, District of Columbia, District of Columbia",91,80,0,0,11,0,0,0,91,91,80,0,0,11,0,0,0,0,0,0,0,0,0,0,0,110010003001004,2,206,206,2,psa_29,2D2
1000000US110010083012011,"Block 2011, Block Group 2, Census Tract 83.01, District of Columbia, District of Columbia",5,5,0,0,0,0,0,0,5,5,5,0,0,0,0,0,0,0,0,0,0,0,0,0,0,110010083012011,1,108,108,1,psa_17,1D2
1000000US110010025022008,"Block 2008, Block Group 2, Census Tract 25.02, District of Columbia, District of Columbia",87,27,57,1,1,0,0,1,87,68,9,57,0,1,0,0,1,19,18,0,1,0,0,0,0,110010025022008,4,404,404,4,psa_48,4D3
1000000US110010073011048,"Block 1048, Block Group 1, Census Tract 73.01, District of Columbia, District of Columbia",0,0,0,0,0,0,0,0,0,0,0,0,0,0,0,0,0,0,0,0,0,0,0,0,0,110010073011048,7,708,708,7,psa_1,7D3
1000000US110010077072016,"Block 2016, Block Group 2, Census Tract 77.07, District of Columbia, District of Columbia",58,2,54,0,0,0,2,0,58,56,2,54,0,0,0,0,0,2,0,0,0,0,0,2,0,110010077072016,6,604,604,6,psa_14,6D3
1000000US110010006001003,"Block 1003, Block Group 1, Census Tract 6, District of Columbia, District of Columbia",476,399,17,0,19,1,18,22,476,403,355,14,0,19,1,1,13,73,44,3,0,0,0,17,9,110010006001003,2,203,203,2,psa_50,2D1
1000000US110010099011000,"Block 1000, Block Group 1, Census Tract 99.01, District of Columbia, District of Columbia",61,0,61,0,0,0,0,0,61,61,0,61,0,0,0,0,0,0,0,0,0,0,0,0,0,110010099011000,6,605,605,6,psa_11,6D2
1000000US110010016001020,"Block 1020, Block Group 1, Census Tract 16, District of Columbia, District of Columbia",60,21,39,0,0,0,0,0,60,57,18,39,0,0,0,0,0,3,3,0,0,0,0,0,0,110010016001020,4,401,401,4,psa_56,4D1
1000000US110010006004002,"Block 4002, Block Group 4, Census Tract 6, District of Columbia, District of Columbia",182,79,96,1,3,1,1,1,182,176,74,96,1,3,1,0,1,6,5,0,0,0,0,1,0,110010006004002,2,203,203,2,psa_50,2D1
1000000US110010017021025,"Block 1025, Block Group 1, Census Tract 17.02, District of Columbia, District of Columbia",44,7,36,0,0,0,0,1,44,43,6,36,0,0,0,0,1,1,1,0,0,0,0,0,0,110010017021025,4,401,401,4,psa_56,4D1
1000000US110010022013007,"Block 3007, Block Group 3, Census Tract 22.01, District of Columbia, District of Columbia",118,0,90,0,0,0,24,4,118,91,0,87,0,0,0,0,4,27,0,3,0,0,0,24,0,110010022013007,4,407,407,4,psa_47,4D2
1000000US110010108002016,"Block 2016, Block Group 2, Census Tract 108.00, District of Columbia, District of Columbia",0,0,0,0,0,0,0,0,0,0,0,0,0,0,0,0,0,0,0,0,0,0,0,0,0,110010108002016,2,207,207,2,psa_24,2D3
1000000US110010052012009,"Block 2009, Block Group 2, Census Tract 52.01, District of Columbia, District of Columbia",2,2,0,0,0,0,0,0,2,2,2,0,0,0,0,0,0,0,0,0,0,0,0,0,0,110010052012009,2,208,208,2,psa_33,2D3
1000000US110010071001010,"Block 1010, Block Group 1, Census Tract 71, District of Columbia, District of Columbia",0,0,0,0,0,0,0,0,0,0,0,0,0,0,0,0,0,0,0,0,0,0,0,0,0,110010071001010,1,106,106,1,psa_13,1D3
1000000US110010074011035,"Block 1035, Block Group 1, Census Tract 74.01, District of Columbia, District of Columbia",80,0,78,0,0,0,0,2,80,78,0,77,0,0,0,0,1,2,0,1,0,0,0,0,1,110010074011035,7,703,703,7,psa_8,7D1
1000000US110010034002023,"Block 2023, Block Group 2, Census Tract 34, District of Columbia, District of Columbia",154,63,72,0,3,0,1,15,154,143,60,71,0,3,0,0,9,11,3,1,0,0,0,1,6,110010034002023,3,306,306,3,psa_38,3D2
1000000US110010070002013,"Block 2013, Block Group 2, Census Tract 70, District of Columbia, District of Columbia",23,19,0,1,3,0,0,0,23,23,19,0,1,3,0,0,0,0,0,0,0,0,0,0,0,110010070002013,1,106,106,1,psa_13,1D3
1000000US110010109002024,"Block 2024, Block Group 2, Census Tract 109, District of Columbia, District of Columbia",0,0,0,0,0,0,0,0,0,0,0,0,0,0,0,0,0,0,0,0,0,0,0,0,0,110010109002024,7,708,708,7,psa_1,7D3
1000000US110010021021000,"Block 1000, Block Group 1, Census Tract 21.02, District of Columbia, District of Columbia",90,0,73,0,0,0,10,7,90,79,0,72,0,0,0,0,7,11,0,1,0,0,0,10,0,110010021021000,4,406,406,4,psa_54,4D2
1000000US110010062021014,"Block 1014, Block Group 1, Census Tract 62.02, District of Columbia, District of Columbia",0,0,0,0,0,0,0,0,0,0,0,0,0,0,0,0,0,0,0,0,0,0,0,0,0,110010062021014,1,102,102,1,psa_18,1D1
1000000US110010078032001,"Block 2001, Block Group 2, Census Tract 78.03, District of Columbia, District of Columbia",59,0,59,0,0,0,0,0,59,59,0,59,0,0,0,0,0,0,0,0,0,0,0,0,0,110010078032001,6,602,602,6,psa_25,6D1
1000000US110010078034000,"Block 4000, Block Group 4, Census Tract 78.03, District of Columbia, District of Columbia",164,0,162,0,0,0,0,2,164,164,0,162,0,0,0,0,2,0,0,0,0,0,0,0,0,110010078034000,6,602,602,6,psa_25,6D1
1000000US110010010016019,"Block 6019, Block Group 6, Census Tract 10.01, District of Columbia, District of Columbia",34,34,0,0,0,0,0,0,34,30,30,0,0,0,0,0,0,4,4,0,0,0,0,0,0,110010010016019,2,202,202,2,psa_52,2D1
1000000US110010012004007,"Block 4007, Block Group 4, Census Tract 12, District of Columbia, District of Columbia",0,0,0,0,0,0,0,0,0,0,0,0,0,0,0,0,0,0,0,0,0,0,0,0,0,110010012004007,2,202,202,2,psa_52,2D1
1000000US110010056001013,"Block 1013, Block Group 1, Census Tract 56, District of Columbia, District of Columbia",0,0,0,0,0,0,0,0,0,0,0,0,0,0,0,0,0,0,0,0,0,0,0,0,0,110010056001013,2,207,207,2,psa_24,2D3
1000000US110010004002018,"Block 2018, Block Group 2, Census Tract 4, District of Columbia, District of Columbia",0,0,0,0,0,0,0,0,0,0,0,0,0,0,0,0,0,0,0,0,0,0,0,0,0,110010004002018,2,204,204,2,psa_44,2D2
1000000US110010073011118,"Block 1118, Block Group 1, Census Tract 73.01, District of Columbia, District of Columbia",0,0,0,0,0,0,0,0,0,0,0,0,0,0,0,0,0,0,0,0,0,0,0,0,0,110010073011118,7,708,708,7,psa_1,7D3
1000000US110010096021015,"Block 1015, Block Group 1, Census Tract 96.02, District of Columbia, District of Columbia",0,0,0,0,0,0,0,0,0,0,0,0,0,0,0,0,0,0,0,0,0,0,0,0,0,110010096021015,6,601,601,6,psa_30,6D1
1000000US110010055001015,"Block 1015, Block Group 1, Census Tract 55, District of Columbia, District of Columbia",4,4,0,0,0,0,0,0,4,4,4,0,0,0,0,0,0,0,0,0,0,0,0,0,0,110010055001015,2,208,208,2,psa_33,2D3
1000000US110010079031011,"Block 1011, Block Group 1, Census Tract 79.03, District of Columbia, District of Columbia",138,7,123,0,2,0,0,6,138,138,7,123,0,2,0,0,6,0,0,0,0,0,0,0,0,110010079031011,5,507,507,5,psa_23,5D3
1000000US110010099012005,"Block 2005, Block Group 2, Census Tract 99.01, District of Columbia, District of Columbia",39,0,35,4,0,0,0,0,39,39,0,35,4,0,0,0,0,0,0,0,0,0,0,0,0,110010099012005,6,605,605,6,psa_11,6D2
1000000US110010105002003,"Block 2003, Block Group 2, Census Tract 105, District of Columbia, District of Columbia",0,0,0,0,0,0,0,0,0,0,0,0,0,0,0,0,0,0,0,0,0,0,0,0,0,110010105002003,1,103,103,1,psa_12,1D1
1000000US110010009013019,"Block 3019, Block Group 3, Census Tract 9.01, District of Columbia, District of Columbia",43,42,0,0,1,0,0,0,43,43,42,0,0,1,0,0,0,0,0,0,0,0,0,0,0,110010009013019,2,205,205,2,psa_46,2D2
1000000US110010062021201,"Block 1201, Block Group 1, Census Tract 62.02, District of Columbia, District of Columbia",0,0,0,0,0,0,0,0,0,0,0,0,0,0,0,0,0,0,0,0,0,0,0,0,0,110010062021201,2,207,207,2,psa_24,2D3
1000000US110010008013020,"Block 3020, Block Group 3, Census Tract 8.01, District of Columbia, District of Columbia",39,37,0,0,2,0,0,0,39,36,34,0,0,2,0,0,0,3,3,0,0,0,0,0,0,110010008013020,2,205,205,2,psa_46,2D2
1000000US110010095031010,"Block 1010, Block Group 1, Census Tract 95.03, District of Columbia, District of Columbia",60,7,49,0,1,0,1,2,60,59,7,49,0,1,0,0,2,1,0,0,0,0,0,1,0,110010095031010,4,405,405,4,psa_49,4D2
1000000US110010052011005,"Block 1005, Block Group 1, Census Tract 52.01, District of Columbia, District of Columbia",0,0,0,0,0,0,0,0,0,0,0,0,0,0,0,0,0,0,0,0,0,0,0,0,0,110010052011005,3,307,307,3,psa_28,3D3
1000000US110010025024002,"Block 4002, Block Group 4, Census Tract 25.02, District of Columbia, District of Columbia",1096,265,329,11,12,0,331,148,1096,461,117,320,1,12,0,2,9,635,148,9,10,0,0,329,139,110010025024002,4,404,404,4,psa_48,4D3
1000000US110010077091006,"Block 1006, Block Group 1, Census Tract 77.09, District of Columbia, District of Columbia",0,0,0,0,0,0,0,0,0,0,0,0,0,0,0,0,0,0,0,0,0,0,0,0,0,110010077091006,6,605,605,6,psa_11,6D2
1000000US110010027011000,"Block 1000, Block Group 1, Census Tract 27.01, District of Columbia, District of Columbia",253,182,46,1,14,0,0,10,253,224,159,45,1,14,0,0,5,29,23,1,0,0,0,0,5,110010027011000,3,302,302,3,psa_42,3D1
1000000US110010023011015,"Block 1015, Block Group 1, Census Tract 23.01, District of Columbia, District of Columbia",0,0,0,0,0,0,0,0,0,0,0,0,0,0,0,0,0,0,0,0,0,0,0,0,0,110010023011015,4,407,407,4,psa_47,4D2
1000000US110010024002008,"Block 2008, Block Group 2, Census Tract 24, District of Columbia, District of Columbia",18,2,13,0,0,0,0,3,18,18,2,13,0,0,0,0,3,0,0,0,0,0,0,0,0,110010024002008,4,407,407,4,psa_47,4D2
1000000US110010087021001,"Block 1001, Block Group 1, Census Tract 87.02, District of Columbia, District of Columbia",6,0,6,0,0,0,0,0,6,4,0,4,0,0,0,0,0,2,0,2,0,0,0,0,0,110010087021001,5,502,502,5,psa_40,5D1
1000000US110010094003004,"Block 3004, Block Group 3, Census Tract 94, District of Columbia, District of Columbia",51,4,45,0,1,0,0,1,51,51,4,45,0,1,0,0,1,0,0,0,0,0,0,0,0,110010094003004,5,503,503,5,psa_45,5D2
1000000US110010102001012,"Block 1012, Block Group 1, Census Tract 102, District of Columbia, District of Columbia",0,0,0,0,0,0,0,0,0,0,0,0,0,0,0,0,0,0,0,0,0,0,0,0,0,110010102001012,1,103,103,1,psa_12,1D1
1000000US110010033012003,"Block 2003, Block Group 2, Census Tract 33.01, District of Columbia, District of Columbia",147,64,75,0,0,0,0,8,147,142,62,72,0,0,0,0,8,5,2,3,0,0,0,0,0,110010033012003,3,306,306,3,psa_38,3D2
1000000US110010095091005,"Block 1005, Block Group 1, Census Tract 95.09, District of Columbia, District of Columbia",181,8,154,0,0,0,12,7,181,165,7,153,0,0,0,2,3,16,1,1,0,0,0,10,4,110010095091005,4,405,405,4,psa_49,4D2
1000000US110010076013005,"Block 3005, Block Group 3, Census Tract 76.01, District of Columbia, District of Columbia",16,0,16,0,0,0,0,0,16,16,0,16,0,0,0,0,0,0,0,0,0,0,0,0,0,110010076013005,6,607,607,6,psa_10,6D2
1000000US110010035001003,"Block 1003, Block Group 1, Census Tract 35, District of Columbia, District of Columbia",308,60,204,0,5,0,29,10,308,267,58,198,0,5,0,0,6,41,2,6,0,0,0,29,4,110010035001003,3,304,304,3,psa_36,3D1
1000000US110010043001002,"Block 1002, Block Group 1, Census Tract 43, District of Columbia, District of Columbia",124,80,34,0,6,0,2,2,124,115,73,34,0,6,0,0,2,9,7,0,0,0,0,2,0,110010043001002,3,301,301,3,psa_31,3D3
1000000US110010103001009,"Block 1009, Block Group 1, Census Tract 103, District of Columbia, District of Columbia",353,243,71,6,9,1,13,10,353,308,215,68,4,9,1,1,10,45,28,3,2,0,0,12,0,110010103001009,4,401,401,4,psa_56,4D1
1000000US110010073011078,"Block 1078, Block Group 1, Census Tract 73.01, District of Columbia, District of Columbia",67,36,22,0,1,0,4,4,67,59,35,21,0,0,0,0,3,8,1,1,0,1,0,4,1,110010073011078,7,707,707,7,psa_4,7D2
1000000US110010077091027,"Block 1027, Block Group 1, Census Tract 77.09, District of Columbia, District of Columbia",0,0,0,0,0,0,0,0,0,0,0,0,0,0,0,0,0,0,0,0,0,0,0,0,0,110010077091027,6,605,605,6,psa_11,6D2
1000000US110010010014016,"Block 4016, Block Group 4, Census Tract 10.01, District of Columbia, District of Columbia",64,56,6,0,1,0,1,0,64,54,47,6,0,1,0,0,0,10,9,0,0,0,0,1,0,110010010014016,2,202,202,2,psa_52,2D1
1000000US110010042021002,"Block 1002, Block Group 1, Census Tract 42.02, District of Columbia, District of Columbia",212,147,4,1,46,0,3,11,212,199,137,4,1,46,0,1,10,13,10,0,0,0,0,2,1,110010042021002,2,208,208,2,psa_33,2D3
1000000US110010076034002,"Block 4002, Block Group 4, Census Tract 76.03, District of Columbia, District of Columbia",105,12,89,0,0,0,1,3,105,103,11,89,0,0,0,0,3,2,1,0,0,0,0,1,0,110010076034002,6,606,606,6,psa_7,6D2
1000000US110010087012003,"Block 2003, Block Group 2, Census Tract 87.01, District of Columbia, District of Columbia",0,0,0,0,0,0,0,0,0,0,0,0,0,0,0,0,0,0,0,0,0,0,0,0,0,110010087012003,5,502,502,5,psa_40,5D1
1000000US110010096011029,"Block 1029, Block Group 1, Census Tract 96.01, District of Columbia, District of Columbia",42,0,42,0,0,0,0,0,42,42,0,42,0,0,0,0,0,0,0,0,0,0,0,0,0,110010096011029,6,601,601,6,psa_30,6D1
1000000US110010004002025,"Block 2025, Block Group 2, Census Tract 4, District of Columbia, District of Columbia",47,29,5,0,3,0,10,0,47,39,26,4,0,3,0,6,0,8,3,1,0,0,0,4,0,110010004002025,2,204,204,2,psa_44,2D2
1000000US110010034002005,"Block 2005, Block Group 2, Census Tract 34, District of Columbia, District of Columbia",475,24,394,6,12,0,24,15,475,415,11,376,2,12,0,0,14,60,13,18,4,0,0,24,1,110010034002005,3,306,306,3,psa_38,3D2
1000000US110010095053018,"Block 3018, Block Group 3, Census Tract 95.05, District of Columbia, District of Columbia",0,0,0,0,0,0,0,0,0,0,0,0,0,0,0,0,0,0,0,0,0,0,0,0,0,110010095053018,4,406,406,4,psa_54,4D2
1000000US110010001004011,"Block 4011, Block Group 4, Census Tract 1, District of Columbia, District of Columbia",17,14,0,0,1,0,0,2,17,17,14,0,0,1,0,0,2,0,0,0,0,0,0,0,0,110010001004011,2,206,206,2,psa_29,2D2
1000000US110010087021008,"Block 1008, Block Group 1, Census Tract 87.02, District of Columbia, District of Columbia",0,0,0,0,0,0,0,0,0,0,0,0,0,0,0,0,0,0,0,0,0,0,0,0,0,110010087021008,5,502,502,5,psa_40,5D1
1000000US110010091022021,"Block 2021, Block Group 2, Census Tract 91.02, District of Columbia, District of Columbia",0,0,0,0,0,0,0,0,0,0,0,0,0,0,0,0,0,0,0,0,0,0,0,0,0,110010091022021,5,502,502,5,psa_40,5D1
1000000US110010002024018,"Block 4018, Block Group 4, Census Tract 2.02, District of Columbia, District of Columbia",0,0,0,0,0,0,0,0,0,0,0,0,0,0,0,0,0,0,0,0,0,0,0,0,0,110010002024018,2,205,205,2,psa_46,2D2
1000000US110010093021011,"Block 1011, Block Group 1, Census Tract 93.02, District of Columbia, District of Columbia",68,15,46,0,2,0,0,5,68,67,14,46,0,2,0,0,5,1,1,0,0,0,0,0,0,110010093021011,5,504,504,5,psa_43,5D2
1000000US110010082002014,"Block 2014, Block Group 2, Census Tract 82, District of Columbia, District of Columbia",217,181,13,2,11,0,6,4,217,199,170,13,1,11,0,0,4,18,11,0,1,0,0,6,0,110010082002014,1,108,108,1,psa_17,1D2
1000000US110010008022017,"Block 2017, Block Group 2, Census Tract 8.02, District of Columbia, District of Columbia",148,120,1,0,17,0,1,9,148,140,114,1,0,17,0,0,8,8,6,0,0,0,0,1,1,110010008022017,2,205,205,2,psa_46,2D2
1000000US110010109002031,"Block 2031, Block Group 2, Census Tract 109, District of Columbia, District of Columbia",0,0,0,0,0,0,0,0,0,0,0,0,0,0,0,0,0,0,0,0,0,0,0,0,0,110010109002031,7,708,708,7,psa_1,7D3
1000000US110010088042005,"Block 2005, Block Group 2, Census Tract 88.04, District of Columbia, District of Columbia",0,0,0,0,0,0,0,0,0,0,0,0,0,0,0,0,0,0,0,0,0,0,0,0,0,110010088042005,5,506,506,5,psa_26,5D3
1000000US110010004001019,"Block 1019, Block Group 1, Census Tract 4, District of Columbia, District of Columbia",30,30,0,0,0,0,0,0,30,30,30,0,0,0,0,0,0,0,0,0,0,0,0,0,0,110010004001019,2,204,204,2,psa_44,2D2
1000000US110010021013002,"Block 3002, Block Group 3, Census Tract 21.01, District of Columbia, District of Columbia",191,25,111,5,0,0,40,10,191,126,5,111,2,0,0,0,8,65,20,0,3,0,0,40,2,110010021013002,4,403,403,4,psa_51,4D1
1000000US110010059001019,"Block 1019, Block Group 1, Census Tract 59, District of Columbia, District of Columbia",0,0,0,0,0,0,0,0,0,0,0,0,0,0,0,0,0,0,0,0,0,0,0,0,0,110010059001019,1,101,101,1,psa_20,1D1
1000000US110010062021134,"Block 1134, Block Group 1, Census Tract 62.02, District of Columbia, District of Columbia",0,0,0,0,0,0,0,0,0,0,0,0,0,0,0,0,0,0,0,0,0,0,0,0,0,110010062021134,1,102,102,1,psa_18,1D1
1000000US110010091022019,"Block 2019, Block Group 2, Census Tract 91.02, District of Columbia, District of Columbia",0,0,0,0,0,0,0,0,0,0,0,0,0,0,0,0,0,0,0,0,0,0,0,0,0,110010091022019,5,505,505,5,psa_34,5D2
1000000US110010002024021,"Block 4021, Block Group 4, Census Tract 2.02, District of Columbia, District of Columbia",0,0,0,0,0,0,0,0,0,0,0,0,0,0,0,0,0,0,0,0,0,0,0,0,0,110010002024021,2,206,206,2,psa_29,2D2
1000000US110010048011014,"Block 1014, Block Group 1, Census Tract 48.01, District of Columbia, District of Columbia",134,43,46,1,4,0,23,17,134,108,43,46,1,4,0,0,14,26,0,0,0,0,0,23,3,110010048011014,3,308,308,3,psa_27,3D2
1000000US110010076042007,"Block 2007, Block Group 2, Census Tract 76.04, District of Columbia, District of Columbia",0,0,0,0,0,0,0,0,0,0,0,0,0,0,0,0,0,0,0,0,0,0,0,0,0,110010076042007,6,607,607,6,psa_10,6D2
1000000US110010111001015,"Block 1015, Block Group 1, Census Tract 111, District of Columbia, District of Columbia",0,0,0,0,0,0,0,0,0,0,0,0,0,0,0,0,0,0,0,0,0,0,0,0,0,110010111001015,5,503,503,5,psa_45,5D2
1000000US110010001004009,"Block 4009, Block Group 4, Census Tract 1, District of Columbia, District of Columbia",52,42,8,0,2,0,0,0,52,49,39,8,0,2,0,0,0,3,3,0,0,0,0,0,0,110010001004009,2,206,206,2,psa_29,2D2
1000000US110010003004011,"Block 4011, Block Group 4, Census Tract 3, District of Columbia, District of Columbia",8,8,0,0,0,0,0,0,8,8,8,0,0,0,0,0,0,0,0,0,0,0,0,0,0,110010003004011,2,204,204,2,psa_44,2D2
1000000US110010008012007,"Block 2007, Block Group 2, Census Tract 8.01, District of Columbia, District of Columbia",43,36,1,0,5,0,0,1,43,42,35,1,0,5,0,0,1,1,1,0,0,0,0,0,0,110010008012007,2,205,205,2,psa_46,2D2
1000000US110010078082011,"Block 2011, Block Group 2, Census Tract 78.08, District of Columbia, District of Columbia",100,2,94,2,0,0,0,2,100,99,1,94,2,0,0,0,2,1,1,0,0,0,0,0,0,110010078082011,6,608,608,6,psa_19,6D1
1000000US110010041003019,"Block 3019, Block Group 3, Census Tract 41, District of Columbia, District of Columbia",0,0,0,0,0,0,0,0,0,0,0,0,0,0,0,0,0,0,0,0,0,0,0,0,0,110010041003019,2,206,206,2,psa_29,2D2
1000000US110010092042001,"Block 2001, Block Group 2, Census Tract 92.04, District of Columbia, District of Columbia",0,0,0,0,0,0,0,0,0,0,0,0,0,0,0,0,0,0,0,0,0,0,0,0,0,110010092042001,5,502,502,5,psa_40,5D1
1000000US110010111003034,"Block 3034, Block Group 3, Census Tract 111, District of Columbia, District of Columbia",0,0,0,0,0,0,0,0,0,0,0,0,0,0,0,0,0,0,0,0,0,0,0,0,0,110010111003034,5,503,503,5,psa_45,5D2
1000000US110010027023005,"Block 3005, Block Group 3, Census Tract 27.02, District of Columbia, District of Columbia",0,0,0,0,0,0,0,0,0,0,0,0,0,0,0,0,0,0,0,0,0,0,0,0,0,110010027023005,2,204,204,2,psa_44,2D2
1000000US110010062021193,"Block 1193, Block Group 1, Census Tract 62.02, District of Columbia, District of Columbia",0,0,0,0,0,0,0,0,0,0,0,0,0,0,0,0,0,0,0,0,0,0,0,0,0,110010062021193,1,103,103,1,psa_12,1D1
1000000US110010074072005,"Block 2005, Block Group 2, Census Tract 74.07, District of Columbia, District of Columbia",0,0,0,0,0,0,0,0,0,0,0,0,0,0,0,0,0,0,0,0,0,0,0,0,0,110010074072005,7,703,703,7,psa_8,7D1
1000000US110010076031001,"Block 1001, Block Group 1, Census Tract 76.03, District of Columbia, District of Columbia",92,2,88,0,0,0,2,0,92,87,1,86,0,0,0,0,0,5,1,2,0,0,0,2,0,110010076031001,6,606,606,6,psa_7,6D2
1000000US110010008013014,"Block 3014, Block Group 3, Census Tract 8.01, District of Columbia, District of Columbia",61,46,0,0,8,0,0,7,61,61,46,0,0,8,0,0,7,0,0,0,0,0,0,0,0,110010008013014,2,205,205,2,psa_46,2D2
1000000US110010049012005,"Block 2005, Block Group 2, Census Tract 49.01, District of Columbia, District of Columbia",156,66,62,0,24,0,0,4,156,153,63,62,0,24,0,0,4,3,3,0,0,0,0,0,0,110010049012005,3,307,307,3,psa_28,3D3
1000000US110010001004024,"Block 4024, Block Group 4, Census Tract 1, District of Columbia, District of Columbia",0,0,0,0,0,0,0,0,0,0,0,0,0,0,0,0,0,0,0,0,0,0,0,0,0,110010001004024,2,206,206,2,psa_29,2D2
1000000US110010022011004,"Block 1004, Block Group 1, Census Tract 22.01, District of Columbia, District of Columbia",202,20,146,0,1,0,27,8,202,162,15,141,0,1,0,0,5,40,5,5,0,0,0,27,3,110010022011004,4,407,407,4,psa_47,4D2
1000000US110010091023004,"Block 3004, Block Group 3, Census Tract 91.02, District of Columbia, District of Columbia",101,0,93,0,0,0,6,2,101,94,0,93,0,0,0,1,0,7,0,0,0,0,0,5,2,110010091023004,5,505,505,5,psa_34,5D2
1000000US110010096042008,"Block 2008, Block Group 2, Census Tract 96.04, District of Columbia, District of Columbia",114,4,105,3,0,0,0,2,114,109,4,105,0,0,0,0,0,5,0,0,3,0,0,0,2,110010096042008,6,603,603,6,psa_15,6D3
1000000US110010021015004,"Block 5004, Block Group 5, Census Tract 21.01, District of Columbia, District of Columbia",121,20,38,0,10,0,53,0,121,53,7,36,0,10,0,0,0,68,13,2,0,0,0,53,0,110010021015004,4,403,403,4,psa_51,4D1
1000000US110010073011091,"Block 1091, Block Group 1, Census Tract 73.01, District of Columbia, District of Columbia",0,0,0,0,0,0,0,0,0,0,0,0,0,0,0,0,0,0,0,0,0,0,0,0,0,110010073011091,7,707,707,7,psa_4,7D2
1000000US110010076032011,"Block 2011, Block Group 2, Census Tract 76.03, District of Columbia, District of Columbia",24,0,15,1,0,0,0,8,24,24,0,15,1,0,0,0,8,0,0,0,0,0,0,0,0,110010076032011,6,606,606,6,psa_7,6D2
1000000US110010096011005,"Block 1005, Block Group 1, Census Tract 96.01, District of Columbia, District of Columbia",0,0,0,0,0,0,0,0,0,0,0,0,0,0,0,0,0,0,0,0,0,0,0,0,0,110010096011005,6,601,601,6,psa_30,6D1
1000000US110010019022001,"Block 2001, Block Group 2, Census Tract 19.02, District of Columbia, District of Columbia",34,4,23,0,1,0,0,6,34,29,2,23,0,1,0,0,3,5,2,0,0,0,0,0,3,110010019022001,4,406,406,4,psa_54,4D2
1000000US110010069001017,"Block 1017, Block Group 1, Census Tract 69, District of Columbia, District of Columbia",273,63,193,1,5,0,0,11,273,253,46,192,1,5,0,0,9,20,17,1,0,0,0,0,2,110010069001017,1,107,107,1,psa_16,1D2
1000000US110010093013015,"Block 3015, Block Group 3, Census Tract 93.01, District of Columbia, District of Columbia",44,10,31,1,1,0,1,0,44,43,10,31,1,1,0,0,0,1,0,0,0,0,0,1,0,110010093013015,5,504,504,5,psa_43,5D2
1000000US110010091022013,"Block 2013, Block Group 2, Census Tract 91.02, District of Columbia, District of Columbia",0,0,0,0,0,0,0,0,0,0,0,0,0,0,0,0,0,0,0,0,0,0,0,0,0,110010091022013,5,505,505,5,psa_34,5D2
1000000US110010004001002,"Block 1002, Block Group 1, Census Tract 4, District of Columbia, District of Columbia",0,0,0,0,0,0,0,0,0,0,0,0,0,0,0,0,0,0,0,0,0,0,0,0,0,110010004001002,2,204,204,2,psa_44,2D2
1000000US110010095031008,"Block 1008, Block Group 1, Census Tract 95.03, District of Columbia, District of Columbia",57,9,48,0,0,0,0,0,57,54,6,48,0,0,0,0,0,3,3,0,0,0,0,0,0,110010095031008,4,405,405,4,psa_49,4D2
1000000US110010038001002,"Block 1002, Block Group 1, Census Tract 38, District of Columbia, District of Columbia",536,330,73,10,50,0,53,20,536,429,286,71,1,50,0,5,16,107,44,2,9,0,0,48,4,110010038001002,3,303,303,3,psa_37,3D3
1000000US110010087011000,"Block 1000, Block Group 1, Census Tract 87.01, District of Columbia, District of Columbia",326,43,255,1,16,0,0,11,326,318,40,253,1,16,0,0,8,8,3,2,0,0,0,0,3,110010087011000,5,502,502,5,psa_40,5D1
1000000US110010095082000,"Block 2000, Block Group 2, Census Tract 95.08, District of Columbia, District of Columbia",66,3,63,0,0,0,0,0,66,66,3,63,0,0,0,0,0,0,0,0,0,0,0,0,0,110010095082000,4,406,406,4,psa_54,4D2
1000000US110010094004005,"Block 4005, Block Group 4, Census Tract 94, District of Columbia, District of Columbia",51,0,49,0,0,0,0,2,51,51,0,49,0,0,0,0,2,0,0,0,0,0,0,0,0,110010094004005,5,503,503,5,psa_45,5D2
1000000US110010098102000,"Block 2000, Block Group 2, Census Tract 98.10, District of Columbia, District of Columbia",101,4,96,0,0,0,0,1,101,101,4,96,0,0,0,0,1,0,0,0,0,0,0,0,0,110010098102000,7,708,708,7,psa_1,7D3
1000000US110010019021001,"Block 1001, Block Group 1, Census Tract 19.02, District of Columbia, District of Columbia",41,6,34,0,1,0,0,0,41,41,6,34,0,1,0,0,0,0,0,0,0,0,0,0,0,110010019021001,4,406,406,4,psa_54,4D2
1000000US110010074011030,"Block 1030, Block Group 1, Census Tract 74.01, District of Columbia, District of Columbia",0,0,0,0,0,0,0,0,0,0,0,0,0,0,0,0,0,0,0,0,0,0,0,0,0,110010074011030,7,703,703,7,psa_8,7D1
1000000US110010111002018,"Block 2018, Block Group 2, Census Tract 111, District of Columbia, District of Columbia",0,0,0,0,0,0,0,0,0,0,0,0,0,0,0,0,0,0,0,0,0,0,0,0,0,110010111002018,5,505,505,5,psa_34,5D2
1000000US110010107001033,"Block 1033, Block Group 1, Census Tract 107, District of Columbia, District of Columbia",0,0,0,0,0,0,0,0,0,0,0,0,0,0,0,0,0,0,0,0,0,0,0,0,0,110010107001033,2,207,207,2,psa_24,2D3
1000000US110010047012006,"Block 2006, Block Group 2, Census Tract 47.01, District of Columbia, District of Columbia",6,4,2,0,0,0,0,0,6,6,4,2,0,0,0,0,0,0,0,0,0,0,0,0,0,110010047012006,1,101,101,1,psa_20,1D1
1000000US110010071001002,"Block 1002, Block Group 1, Census Tract 71, District of Columbia, District of Columbia",0,0,0,0,0,0,0,0,0,0,0,0,0,0,0,0,0,0,0,0,0,0,0,0,0,110010071001002,1,106,106,1,psa_13,1D3
1000000US110010110002011,"Block 2011, Block Group 2, Census Tract 110, District of Columbia, District of Columbia",0,0,0,0,0,0,0,0,0,0,0,0,0,0,0,0,0,0,0,0,0,0,0,0,0,110010110002011,1,105,105,1,psa_22,1D3
1000000US110010062021137,"Block 1137, Block Group 1, Census Tract 62.02, District of Columbia, District of Columbia",0,0,0,0,0,0,0,0,0,0,0,0,0,0,0,0,0,0,0,0,0,0,0,0,0,110010062021137,1,106,106,1,psa_13,1D3
1000000US110010070002020,"Block 2020, Block Group 2, Census Tract 70, District of Columbia, District of Columbia",0,0,0,0,0,0,0,0,0,0,0,0,0,0,0,0,0,0,0,0,0,0,0,0,0,110010070002020,1,106,106,1,psa_13,1D3
1000000US110010096041005,"Block 1005, Block Group 1, Census Tract 96.04, District of Columbia, District of Columbia",94,2,88,0,0,0,0,4,94,92,0,88,0,0,0,0,4,2,2,0,0,0,0,0,0,110010096041005,6,603,603,6,psa_15,6D3
1000000US110010098071000,"Block 1000, Block Group 1, Census Tract 98.07, District of Columbia, District of Columbia",0,0,0,0,0,0,0,0,0,0,0,0,0,0,0,0,0,0,0,0,0,0,0,0,0,110010098071000,7,707,707,7,psa_4,7D2
1000000US110010106002046,"Block 2046, Block Group 2, Census Tract 106, District of Columbia, District of Columbia",96,20,70,1,2,0,1,2,96,91,17,70,1,2,0,0,1,5,3,0,0,0,0,1,1,110010106002046,5,501,501,5,psa_35,5D1
1000000US110010088021002,"Block 1002, Block Group 1, Census Tract 88.02, District of Columbia, District of Columbia",67,0,66,0,1,0,0,0,67,66,0,65,0,1,0,0,0,1,0,1,0,0,0,0,0,110010088021002,5,506,506,5,psa_26,5D3
1000000US110010001004010,"Block 4010, Block Group 4, Census Tract 1, District of Columbia, District of Columbia",0,0,0,0,0,0,0,0,0,0,0,0,0,0,0,0,0,0,0,0,0,0,0,0,0,110010001004010,2,206,206,2,psa_29,2D2
1000000US110010078041014,"Block 1014, Block Group 1, Census Tract 78.04, District of Columbia, District of Columbia",0,0,0,0,0,0,0,0,0,0,0,0,0,0,0,0,0,0,0,0,0,0,0,0,0,110010078041014,6,602,602,6,psa_25,6D1
1000000US110010098031004,"Block 1004, Block Group 1, Census Tract 98.03, District of Columbia, District of Columbia",191,0,185,0,0,0,0,6,191,191,0,185,0,0,0,0,6,0,0,0,0,0,0,0,0,110010098031004,7,707,707,7,psa_4,7D2
1000000US110010105002024,"Block 2024, Block Group 2, Census Tract 105, District of Columbia, District of Columbia",0,0,0,0,0,0,0,0,0,0,0,0,0,0,0,0,0,0,0,0,0,0,0,0,0,110010105002024,1,103,103,1,psa_12,1D1
1000000US110010009013022,"Block 3022, Block Group 3, Census Tract 9.01, District of Columbia, District of Columbia",0,0,0,0,0,0,0,0,0,0,0,0,0,0,0,0,0,0,0,0,0,0,0,0,0,110010009013022,2,205,205,2,psa_46,2D2
1000000US110010068041025,"Block 1025, Block Group 1, Census Tract 68.04, District of Columbia, District of Columbia",0,0,0,0,0,0,0,0,0,0,0,0,0,0,0,0,0,0,0,0,0,0,0,0,0,110010068041025,1,108,108,1,psa_17,1D2
1000000US110010104002005,"Block 2005, Block Group 2, Census Tract 104, District of Columbia, District of Columbia",0,0,0,0,0,0,0,0,0,0,0,0,0,0,0,0,0,0,0,0,0,0,0,0,0,110010104002005,7,703,703,7,psa_8,7D1
1000000US110010062021224,"Block 1224, Block Group 1, Census Tract 62.02, District of Columbia, District of Columbia",0,0,0,0,0,0,0,0,0,0,0,0,0,0,0,0,0,0,0,0,0,0,0,0,0,110010062021224,1,103,103,1,psa_12,1D1
1000000US110010072002048,"Block 2048, Block Group 2, Census Tract 72, District of Columbia, District of Columbia",0,0,0,0,0,0,0,0,0,0,0,0,0,0,0,0,0,0,0,0,0,0,0,0,0,110010072002048,1,106,106,1,psa_13,1D3
1000000US110010073041000,"Block 1000, Block Group 1, Census Tract 73.04, District of Columbia, District of Columbia",0,0,0,0,0,0,0,0,0,0,0,0,0,0,0,0,0,0,0,0,0,0,0,0,0,110010073041000,7,704,704,7,psa_5,7D2
1000000US110010076034007,"Block 4007, Block Group 4, Census Tract 76.03, District of Columbia, District of Columbia",29,6,23,0,0,0,0,0,29,28,6,22,0,0,0,0,0,1,0,1,0,0,0,0,0,110010076034007,6,606,606,6,psa_7,6D2
1000000US110010096031008,"Block 1008, Block Group 1, Census Tract 96.03, District of Columbia, District of Columbia",63,0,63,0,0,0,0,0,63,63,0,63,0,0,0,0,0,0,0,0,0,0,0,0,0,110010096031008,6,603,603,6,psa_15,6D3
1000000US110010073011117,"Block 1117, Block Group 1, Census Tract 73.01, District of Columbia, District of Columbia",0,0,0,0,0,0,0,0,0,0,0,0,0,0,0,0,0,0,0,0,0,0,0,0,0,110010073011117,7,708,708,7,psa_1,7D3
1000000US110010095052013,"Block 2013, Block Group 2, Census Tract 95.05, District of Columbia, District of Columbia",0,0,0,0,0,0,0,0,0,0,0,0,0,0,0,0,0,0,0,0,0,0,0,0,0,110010095052013,4,406,406,4,psa_54,4D2
1000000US110010095053001,"Block 3001, Block Group 3, Census Tract 95.05, District of Columbia, District of Columbia",48,0,47,0,1,0,0,0,48,48,0,47,0,1,0,0,0,0,0,0,0,0,0,0,0,110010095053001,4,406,406,4,psa_54,4D2
1000000US110010010014018,"Block 4018, Block Group 4, Census Tract 10.01, District of Columbia, District of Columbia",68,63,0,0,2,0,0,3,68,66,62,0,0,2,0,0,2,2,1,0,0,0,0,0,1,110010010014018,2,202,202,2,psa_52,2D1
1000000US110010093014004,"Block 4004, Block Group 4, Census Tract 93.01, District of Columbia, District of Columbia",72,16,45,0,3,0,4,4,72,67,16,45,0,3,0,0,3,5,0,0,0,0,0,4,1,110010093014004,5,504,504,5,psa_43,5D2
1000000US110010099052006,"Block 2006, Block Group 2, Census Tract 99.05, District of Columbia, District of Columbia",54,0,54,0,0,0,0,0,54,54,0,54,0,0,0,0,0,0,0,0,0,0,0,0,0,110010099052006,6,604,604,6,psa_14,6D3
1000000US110010021015000,"Block 5000, Block Group 5, Census Tract 21.01, District of Columbia, District of Columbia",193,17,145,1,11,0,16,3,193,156,1,141,0,11,0,0,3,37,16,4,1,0,0,16,0,110010021015000,4,403,403,4,psa_51,4D1
1000000US110010008021007,"Block 1007, Block Group 1, Census Tract 8.02, District of Columbia, District of Columbia",64,47,5,0,8,0,2,2,64,60,46,5,0,8,0,0,1,4,1,0,0,0,0,2,1,110010008021007,2,205,205,2,psa_46,2D2
1000000US110010073011075,"Block 1075, Block Group 1, Census Tract 73.01, District of Columbia, District of Columbia",0,0,0,0,0,0,0,0,0,0,0,0,0,0,0,0,0,0,0,0,0,0,0,0,0,110010073011075,7,708,708,7,psa_1,7D3
1000000US110010109002040,"Block 2040, Block Group 2, Census Tract 109, District of Columbia, District of Columbia",0,0,0,0,0,0,0,0,0,0,0,0,0,0,0,0,0,0,0,0,0,0,0,0,0,110010109002040,7,708,708,7,psa_1,7D3
1000000US110010031001004,"Block 1004, Block Group 1, Census Tract 31, District of Columbia, District of Columbia",141,40,53,1,10,0,37,0,141,86,28,48,0,10,0,0,0,55,12,5,1,0,0,37,0,110010031001004,4,409,409,4,psa_41,4D3
1000000US110010022011002,"Block 1002, Block Group 1, Census Tract 22.01, District of Columbia, District of Columbia",105,3,69,0,0,0,30,3,105,69,3,66,0,0,0,0,0,36,0,3,0,0,0,30,3,110010022011002,4,407,407,4,psa_47,4D2
1000000US110010080013004,"Block 3004, Block Group 3, Census Tract 80.01, District of Columbia, District of Columbia",170,104,39,0,12,0,7,8,170,164,104,39,0,12,0,4,5,6,0,0,0,0,0,3,3,110010080013004,1,108,108,1,psa_17,1D2
1000000US110010091022006,"Block 2006, Block Group 2, Census Tract 91.02, District of Columbia, District of Columbia",84,2,72,0,0,0,5,5,84,75,2,71,0,0,0,2,0,9,0,1,0,0,0,3,5,110010091022006,5,505,505,5,psa_34,5D2
1000000US110010064002028,"Block 2028, Block Group 2, Census Tract 64, District of Columbia, District of Columbia",0,0,0,0,0,0,0,0,0,0,0,0,0,0,0,0,0,0,0,0,0,0,0,0,0,110010064002028,1,105,105,1,psa_22,1D3
1000000US110010088021005,"Block 1005, Block Group 1, Census Tract 88.02, District of Columbia, District of Columbia",72,3,66,0,0,0,0,3,72,72,3,66,0,0,0,0,3,0,0,0,0,0,0,0,0,110010088021005,5,506,506,5,psa_26,5D3
1000000US110010059001012,"Block 1012, Block Group 1, Census Tract 59, District of Columbia, District of Columbia",0,0,0,0,0,0,0,0,0,0,0,0,0,0,0,0,0,0,0,0,0,0,0,0,0,110010059001012,1,101,101,1,psa_20,1D1
1000000US110010110002004,"Block 2004, Block Group 2, Census Tract 110, District of Columbia, District of Columbia",0,0,0,0,0,0,0,0,0,0,0,0,0,0,0,0,0,0,0,0,0,0,0,0,0,110010110002004,1,103,103,1,psa_12,1D1
1000000US110010019022003,"Block 2003, Block Group 2, Census Tract 19.02, District of Columbia, District of Columbia",55,11,44,0,0,0,0,0,55,55,11,44,0,0,0,0,0,0,0,0,0,0,0,0,0,110010019022003,4,406,406,4,psa_54,4D2
1000000US110010056002020,"Block 2020, Block Group 2, Census Tract 56, District of Columbia, District of Columbia",0,0,0,0,0,0,0,0,0,0,0,0,0,0,0,0,0,0,0,0,0,0,0,0,0,110010056002020,2,207,207,2,psa_24,2D3
1000000US110010016003006,"Block 3006, Block Group 3, Census Tract 16, District of Columbia, District of Columbia",37,5,25,0,0,0,0,7,37,37,5,25,0,0,0,0,7,0,0,0,0,0,0,0,0,110010016003006,4,401,401,4,psa_56,4D1
1000000US110010078062009,"Block 2009, Block Group 2, Census Tract 78.06, District of Columbia, District of Columbia",14,1,12,1,0,0,0,0,14,14,1,12,1,0,0,0,0,0,0,0,0,0,0,0,0,110010078062009,6,602,602,6,psa_25,6D1
1000000US110010096033005,"Block 3005, Block Group 3, Census Tract 96.03, District of Columbia, District of Columbia",249,2,244,1,0,0,0,2,249,248,2,243,1,0,0,0,2,1,0,1,0,0,0,0,0,110010096033005,6,603,603,6,psa_15,6D3
1000000US110010010012023,"Block 2023, Block Group 2, Census Tract 10.01, District of Columbia, District of Columbia",281,216,10,2,37,0,4,12,281,262,206,10,2,34,0,1,9,19,10,0,0,3,0,3,3,110010010012023,2,202,202,2,psa_52,2D1
1000000US110010062021002,"Block 1002, Block Group 1, Census Tract 62.02, District of Columbia, District of Columbia",0,0,0,0,0,0,0,0,0,0,0,0,0,0,0,0,0,0,0,0,0,0,0,0,0,110010062021002,1,102,102,1,psa_18,1D1
1000000US110010071001026,"Block 1026, Block Group 1, Census Tract 71, District of Columbia, District of Columbia",0,0,0,0,0,0,0,0,0,0,0,0,0,0,0,0,0,0,0,0,0,0,0,0,0,110010071001026,1,106,106,1,psa_13,1D3
1000000US110010078092011,"Block 2011, Block Group 2, Census Tract 78.09, District of Columbia, District of Columbia",84,2,82,0,0,0,0,0,84,82,2,80,0,0,0,0,0,2,0,2,0,0,0,0,0,110010078092011,6,602,602,6,psa_25,6D1
1000000US110010078092010,"Block 2010, Block Group 2, Census Tract 78.09, District of Columbia, District of Columbia",97,10,87,0,0,0,0,0,97,87,4,83,0,0,0,0,0,10,6,4,0,0,0,0,0,110010078092010,6,602,602,6,psa_25,6D1
1000000US110010006001004,"Block 1004, Block Group 1, Census Tract 6, District of Columbia, District of Columbia",69,56,2,2,6,0,1,2,69,67,55,2,2,6,0,0,2,2,1,0,0,0,0,1,0,110010006001004,2,203,203,2,psa_50,2D1
1000000US110010076031000,"Block 1000, Block Group 1, Census Tract 76.03, District of Columbia, District of Columbia",545,16,508,3,2,1,1,14,545,537,14,504,3,2,0,1,13,8,2,4,0,0,1,0,1,110010076031000,6,606,606,6,psa_7,6D2
1000000US110010098011007,"Block 1007, Block Group 1, Census Tract 98.01, District of Columbia, District of Columbia",0,0,0,0,0,0,0,0,0,0,0,0,0,0,0,0,0,0,0,0,0,0,0,0,0,110010098011007,7,706,706,7,psa_2,7D3
1000000US110010030001001,"Block 1001, Block Group 1, Census Tract 30, District of Columbia, District of Columbia",589,305,121,1,31,2,94,35,589,421,249,120,0,31,2,1,18,168,56,1,1,0,0,93,17,110010030001001,3,302,302,3,psa_42,3D1
1000000US110010067003003,"Block 3003, Block Group 3, Census Tract 67, District of Columbia, District of Columbia",48,43,4,1,0,0,0,0,48,46,41,4,1,0,0,0,0,2,2,0,0,0,0,0,0,110010067003003,1,107,107,1,psa_16,1D2
1000000US110010076015006,"Block 5006, Block Group 5, Census Tract 76.01, District of Columbia, District of Columbia",0,0,0,0,0,0,0,0,0,0,0,0,0,0,0,0,0,0,0,0,0,0,0,0,0,110010076015006,7,701,701,7,psa_9,7D1
1000000US110010009013014,"Block 3014, Block Group 3, Census Tract 9.01, District of Columbia, District of Columbia",37,36,0,0,0,0,1,0,37,33,33,0,0,0,0,0,0,4,3,0,0,0,0,1,0,110010009013014,2,205,205,2,psa_46,2D2
1000000US110010038002004,"Block 2004, Block Group 2, Census Tract 38, District of Columbia, District of Columbia",113,69,34,0,1,0,8,1,113,87,50,34,0,1,0,1,1,26,19,0,0,0,0,7,0,110010038002004,3,303,303,3,psa_37,3D3
1000000US110010073011090,"Block 1090, Block Group 1, Census Tract 73.01, District of Columbia, District of Columbia",0,0,0,0,0,0,0,0,0,0,0,0,0,0,0,0,0,0,0,0,0,0,0,0,0,110010073011090,7,707,707,7,psa_4,7D2
1000000US110010040013003,"Block 3003, Block Group 3, Census Tract 40.01, District of Columbia, District of Columbia",139,122,5,0,5,5,0,2,139,130,118,5,0,5,0,0,2,9,4,0,0,0,5,0,0,110010040013003,3,303,303,3,psa_37,3D3
1000000US110010096041004,"Block 1004, Block Group 1, Census Tract 96.04, District of Columbia, District of Columbia",110,1,95,0,0,0,11,3,110,99,1,95,0,0,0,0,3,11,0,0,0,0,0,11,0,110010096041004,6,603,603,6,psa_15,6D3
1000000US110010110002001,"Block 2001, Block Group 2, Census Tract 110, District of Columbia, District of Columbia",0,0,0,0,0,0,0,0,0,0,0,0,0,0,0,0,0,0,0,0,0,0,0,0,0,110010110002001,1,103,103,1,psa_12,1D1
1000000US110010008014005,"Block 4005, Block Group 4, Census Tract 8.01, District of Columbia, District of Columbia",30,27,0,0,1,0,1,1,30,26,24,0,0,1,0,0,1,4,3,0,0,0,0,1,0,110010008014005,2,205,205,2,psa_46,2D2
1000000US110010075031012,"Block 1012, Block Group 1, Census Tract 75.03, District of Columbia, District of Columbia",53,3,46,0,1,0,1,2,53,52,3,46,0,1,0,0,2,1,0,0,0,0,0,1,0,110010075031012,7,701,701,7,psa_9,7D1
1000000US110010071001020,"Block 1020, Block Group 1, Census Tract 71, District of Columbia, District of Columbia",0,0,0,0,0,0,0,0,0,0,0,0,0,0,0,0,0,0,0,0,0,0,0,0,0,110010071001020,1,106,106,1,psa_13,1D3
1000000US110010072002050,"Block 2050, Block Group 2, Census Tract 72, District of Columbia, District of Columbia",0,0,0,0,0,0,0,0,0,0,0,0,0,0,0,0,0,0,0,0,0,0,0,0,0,110010072002050,1,106,106,1,psa_13,1D3
1000000US110010074011033,"Block 1033, Block Group 1, Census Tract 74.01, District of Columbia, District of Columbia",147,1,143,2,0,0,1,0,147,144,1,143,0,0,0,0,0,3,0,0,2,0,0,1,0,110010074011033,7,703,703,7,psa_8,7D1
1000000US110010010021002,"Block 1002, Block Group 1, Census Tract 10.02, District of Columbia, District of Columbia",0,0,0,0,0,0,0,0,0,0,0,0,0,0,0,0,0,0,0,0,0,0,0,0,0,110010010021002,2,204,204,2,psa_44,2D2
1000000US110010019022014,"Block 2014, Block Group 2, Census Tract 19.02, District of Columbia, District of Columbia",63,12,51,0,0,0,0,0,63,60,9,51,0,0,0,0,0,3,3,0,0,0,0,0,0,110010019022014,4,402,402,4,psa_53,4D1
1000000US110010049022009,"Block 2009, Block Group 2, Census Tract 49.02, District of Columbia, District of Columbia",0,0,0,0,0,0,0,0,0,0,0,0,0,0,0,0,0,0,0,0,0,0,0,0,0,110010049022009,3,307,307,3,psa_28,3D3
1000000US110010107001024,"Block 1024, Block Group 1, Census Tract 107, District of Columbia, District of Columbia",0,0,0,0,0,0,0,0,0,0,0,0,0,0,0,0,0,0,0,0,0,0,0,0,0,110010107001024,2,207,207,2,psa_24,2D3
1000000US110010015001003,"Block 1003, Block Group 1, Census Tract 15, District of Columbia, District of Columbia",0,0,0,0,0,0,0,0,0,0,0,0,0,0,0,0,0,0,0,0,0,0,0,0,0,110010015001003,4,401,401,4,psa_56,4D1
1000000US110010095092004,"Block 2004, Block Group 2, Census Tract 95.09, District of Columbia, District of Columbia",49,0,48,0,0,0,0,1,49,49,0,48,0,0,0,0,1,0,0,0,0,0,0,0,0,110010095092004,4,405,405,4,psa_49,4D2
1000000US110010052011004,"Block 1004, Block Group 1, Census Tract 52.01, District of Columbia, District of Columbia",0,0,0,0,0,0,0,0,0,0,0,0,0,0,0,0,0,0,0,0,0,0,0,0,0,110010052011004,3,307,307,3,psa_28,3D3
1000000US110010062021172,"Block 1172, Block Group 1, Census Tract 62.02, District of Columbia, District of Columbia",0,0,0,0,0,0,0,0,0,0,0,0,0,0,0,0,0,0,0,0,0,0,0,0,0,110010062021172,2,207,207,2,psa_24,2D3
1000000US110010078062019,"Block 2019, Block Group 2, Census Tract 78.06, District of Columbia, District of Columbia",61,0,49,0,0,0,12,0,61,49,0,49,0,0,0,0,0,12,0,0,0,0,0,12,0,110010078062019,6,602,602,6,psa_25,6D1
1000000US110010049021002,"Block 1002, Block Group 1, Census Tract 49.02, District of Columbia, District of Columbia",38,27,4,1,3,0,3,0,38,30,23,4,0,3,0,0,0,8,4,0,1,0,0,3,0,110010049021002,3,307,307,3,psa_28,3D3
1000000US110010050024004,"Block 4004, Block Group 4, Census Tract 50.02, District of Columbia, District of Columbia",0,0,0,0,0,0,0,0,0,0,0,0,0,0,0,0,0,0,0,0,0,0,0,0,0,110010050024004,3,307,307,3,psa_28,3D3
1000000US110010070002010,"Block 2010, Block Group 2, Census Tract 70, District of Columbia, District of Columbia",181,123,51,1,2,0,0,4,181,179,122,51,1,2,0,0,3,2,1,0,0,0,0,0,1,110010070002010,1,106,106,1,psa_13,1D3
1000000US110010078033010,"Block 3010, Block Group 3, Census Tract 78.03, District of Columbia, District of Columbia",18,0,14,0,0,0,0,4,18,18,0,14,0,0,0,0,4,0,0,0,0,0,0,0,0,110010078033010,6,602,602,6,psa_25,6D1
1000000US110010096021007,"Block 1007, Block Group 1, Census Tract 96.02, District of Columbia, District of Columbia",0,0,0,0,0,0,0,0,0,0,0,0,0,0,0,0,0,0,0,0,0,0,0,0,0,110010096021007,6,601,601,6,psa_30,6D1
1000000US110010108002023,"Block 2023, Block Group 2, Census Tract 108.00, District of Columbia, District of Columbia",6,0,6,0,0,0,0,0,6,6,0,6,0,0,0,0,0,0,0,0,0,0,0,0,0,110010108002023,2,207,207,2,psa_24,2D3
1000000US110010104002041,"Block 2041, Block Group 2, Census Tract 104, District of Columbia, District of Columbia",120,0,116,0,0,0,2,2,120,118,0,116,0,0,0,0,2,2,0,0,0,0,0,2,0,110010104002041,7,707,707,7,psa_4,7D2
1000000US110010001001002,"Block 1002, Block Group 1, Census Tract 1, District of Columbia, District of Columbia",122,118,0,0,1,0,0,3,122,119,115,0,0,1,0,0,3,3,3,0,0,0,0,0,0,110010001001002,2,206,206,2,psa_29,2D2
1000000US110010009012009,"Block 2009, Block Group 2, Census Tract 9.01, District of Columbia, District of Columbia",204,176,12,0,13,0,0,3,204,189,161,12,0,13,0,0,3,15,15,0,0,0,0,0,0,110010009012009,2,205,205,2,psa_46,2D2
1000000US110010012001000,"Block 1000, Block Group 1, Census Tract 12, District of Columbia, District of Columbia",0,0,0,0,0,0,0,0,0,0,0,0,0,0,0,0,0,0,0,0,0,0,0,0,0,110010012001000,2,203,203,2,psa_50,2D1
1000000US110010073011108,"Block 1108, Block Group 1, Census Tract 73.01, District of Columbia, District of Columbia",3,0,2,0,0,0,0,1,3,3,0,2,0,0,0,0,1,0,0,0,0,0,0,0,0,110010073011108,7,708,708,7,psa_1,7D3
1000000US110010098033005,"Block 3005, Block Group 3, Census Tract 98.03, District of Columbia, District of Columbia",202,7,190,0,0,0,0,5,202,200,7,189,0,0,0,0,4,2,0,1,0,0,0,0,1,110010098033005,7,707,707,7,psa_4,7D2
1000000US110010103002006,"Block 2006, Block Group 2, Census Tract 103, District of Columbia, District of Columbia",72,4,68,0,0,0,0,0,72,70,2,68,0,0,0,0,0,2,2,0,0,0,0,0,0,110010103002006,4,401,401,4,psa_56,4D1
1000000US110010069002000,"Block 2000, Block Group 2, Census Tract 69, District of Columbia, District of Columbia",118,71,37,0,4,0,1,5,118,111,66,37,0,4,0,0,4,7,5,0,0,0,0,1,1,110010069002000,1,107,107,1,psa_16,1D2
1000000US110010015003007,"Block 3007, Block Group 3, Census Tract 15, District of Columbia, District of Columbia",80,76,0,0,0,0,1,3,80,73,69,0,0,0,0,1,3,7,7,0,0,0,0,0,0,110010015003007,2,201,201,2,psa_55,2D1
1000000US110010076043011,"Block 3011, Block Group 3, Census Tract 76.04, District of Columbia, District of Columbia",49,0,49,0,0,0,0,0,49,49,0,49,0,0,0,0,0,0,0,0,0,0,0,0,0,110010076043011,6,607,607,6,psa_10,6D2
1000000US110010081001000,"Block 1000, Block Group 1, Census Tract 81, District of Columbia, District of Columbia",107,59,36,1,5,0,0,6,107,100,58,32,1,5,0,0,4,7,1,4,0,0,0,0,2,110010081001000,1,104,104,1,psa_21,1D2
1000000US110010077082010,"Block 2010, Block Group 2, Census Tract 77.08, District of Columbia, District of Columbia",113,0,113,0,0,0,0,0,113,113,0,113,0,0,0,0,0,0,0,0,0,0,0,0,0,110010077082010,6,603,603,6,psa_15,6D3
1000000US110010015001008,"Block 1008, Block Group 1, Census Tract 15, District of Columbia, District of Columbia",33,10,22,0,0,0,1,0,33,33,10,22,0,0,0,1,0,0,0,0,0,0,0,0,0,110010015001008,2,201,201,2,psa_55,2D1
1000000US110010072001026,"Block 1026, Block Group 1, Census Tract 72, District of Columbia, District of Columbia",0,0,0,0,0,0,0,0,0,0,0,0,0,0,0,0,0,0,0,0,0,0,0,0,0,110010072001026,1,106,106,1,psa_13,1D3
1000000US110010094002000,"Block 2000, Block Group 2, Census Tract 94, District of Columbia, District of Columbia",13,0,13,0,0,0,0,0,13,13,0,13,0,0,0,0,0,0,0,0,0,0,0,0,0,110010094002000,5,504,504,5,psa_43,5D2
1000000US110010010011004,"Block 1004, Block Group 1, Census Tract 10.01, District of Columbia, District of Columbia",21,19,2,0,0,0,0,0,21,17,15,2,0,0,0,0,0,4,4,0,0,0,0,0,0,110010010011004,2,202,202,2,psa_52,2D1
1000000US110010032002000,"Block 2000, Block Group 2, Census Tract 32, District of Columbia, District of Columbia",141,42,92,0,4,0,0,3,141,126,31,89,0,4,0,0,2,15,11,3,0,0,0,0,1,110010032002000,4,409,409,4,psa_41,4D3
1000000US110010095041021,"Block 1021, Block Group 1, Census Tract 95.04, District of Columbia, District of Columbia",0,0,0,0,0,0,0,0,0,0,0,0,0,0,0,0,0,0,0,0,0,0,0,0,0,110010095041021,4,405,405,4,psa_49,4D2
1000000US110010099012009,"Block 2009, Block Group 2, Census Tract 99.01, District of Columbia, District of Columbia",31,2,29,0,0,0,0,0,31,31,2,29,0,0,0,0,0,0,0,0,0,0,0,0,0,110010099012009,6,605,605,6,psa_11,6D2
1000000US110010102001011,"Block 1011, Block Group 1, Census Tract 102, District of Columbia, District of Columbia",0,0,0,0,0,0,0,0,0,0,0,0,0,0,0,0,0,0,0,0,0,0,0,0,0,110010102001011,1,103,103,1,psa_12,1D1
1000000US110010107001026,"Block 1026, Block Group 1, Census Tract 107, District of Columbia, District of Columbia",0,0,0,0,0,0,0,0,0,0,0,0,0,0,0,0,0,0,0,0,0,0,0,0,0,110010107001026,2,207,207,2,psa_24,2D3
1000000US110010004002008,"Block 2008, Block Group 2, Census Tract 4, District of Columbia, District of Columbia",40,40,0,0,0,0,0,0,40,37,37,0,0,0,0,0,0,3,3,0,0,0,0,0,0,110010004002008,2,204,204,2,psa_44,2D2
1000000US110010048011002,"Block 1002, Block Group 1, Census Tract 48.01, District of Columbia, District of Columbia",108,45,51,0,7,0,5,0,108,97,39,50,0,7,0,1,0,11,6,1,0,0,0,4,0,110010048011002,3,306,306,3,psa_38,3D2
1000000US110010077092015,"Block 2015, Block Group 2, Census Tract 77.09, District of Columbia, District of Columbia",0,0,0,0,0,0,0,0,0,0,0,0,0,0,0,0,0,0,0,0,0,0,0,0,0,110010077092015,6,605,605,6,psa_11,6D2
1000000US110010098032005,"Block 2005, Block Group 2, Census Tract 98.03, District of Columbia, District of Columbia",272,5,252,3,2,0,2,8,272,261,3,246,3,2,0,0,7,11,2,6,0,0,0,2,1,110010098032005,7,707,707,7,psa_4,7D2
1000000US110010104001014,"Block 1014, Block Group 1, Census Tract 104, District of Columbia, District of Columbia",0,0,0,0,0,0,0,0,0,0,0,0,0,0,0,0,0,0,0,0,0,0,0,0,0,110010104001014,7,705,705,7,psa_3,7D2
1000000US110010019014007,"Block 4007, Block Group 4, Census Tract 19.01, District of Columbia, District of Columbia",0,0,0,0,0,0,0,0,0,0,0,0,0,0,0,0,0,0,0,0,0,0,0,0,0,110010019014007,4,402,402,4,psa_53,4D1
1000000US110010092011005,"Block 1005, Block Group 1, Census Tract 92.01, District of Columbia, District of Columbia",90,81,3,0,5,0,1,0,90,87,79,3,0,5,0,0,0,3,2,0,0,0,0,1,0,110010092011005,5,502,502,5,psa_40,5D1
1000000US110010099022007,"Block 2007, Block Group 2, Census Tract 99.02, District of Columbia, District of Columbia",250,6,241,1,2,0,0,0,250,250,6,241,1,2,0,0,0,0,0,0,0,0,0,0,0,110010099022007,6,605,605,6,psa_11,6D2
1000000US110010078061007,"Block 1007, Block Group 1, Census Tract 78.06, District of Columbia, District of Columbia",85,0,84,0,0,0,1,0,85,78,0,78,0,0,0,0,0,7,0,6,0,0,0,1,0,110010078061007,6,602,602,6,psa_25,6D1
1000000US110010073011137,"Block 1137, Block Group 1, Census Tract 73.01, District of Columbia, District of Columbia",0,0,0,0,0,0,0,0,0,0,0,0,0,0,0,0,0,0,0,0,0,0,0,0,0,110010073011137,7,707,707,7,psa_4,7D2
1000000US110010095081009,"Block 1009, Block Group 1, Census Tract 95.08, District of Columbia, District of Columbia",79,13,57,0,0,0,5,4,79,69,8,57,0,0,0,0,4,10,5,0,0,0,0,5,0,110010095081009,4,405,405,4,psa_49,4D2
1000000US110010033012004,"Block 2004, Block Group 2, Census Tract 33.01, District of Columbia, District of Columbia",158,79,73,0,3,0,0,3,158,147,69,72,0,3,0,0,3,11,10,1,0,0,0,0,0,110010033012004,3,306,306,3,psa_38,3D2
1000000US110010041001000,"Block 1000, Block Group 1, Census Tract 41, District of Columbia, District of Columbia",452,383,14,0,32,0,7,16,452,405,345,12,0,32,0,2,14,47,38,2,0,0,0,5,2,110010041001000,2,208,208,2,psa_33,2D3
1000000US110010066001002,"Block 1002, Block Group 1, Census Tract 66, District of Columbia, District of Columbia",83,79,4,0,0,0,0,0,83,76,72,4,0,0,0,0,0,7,7,0,0,0,0,0,0,110010066001002,1,107,107,1,psa_16,1D2
1000000US110010078071013,"Block 1013, Block Group 1, Census Tract 78.07, District of Columbia, District of Columbia",104,0,99,0,0,0,0,5,104,104,0,99,0,0,0,0,5,0,0,0,0,0,0,0,0,110010078071013,6,608,608,6,psa_19,6D1
1000000US110010010012019,"Block 2019, Block Group 2, Census Tract 10.01, District of Columbia, District of Columbia",91,81,1,0,4,0,0,5,91,90,81,1,0,4,0,0,4,1,0,0,0,0,0,0,1,110010010012019,2,202,202,2,psa_52,2D1
1000000US110010092031000,"Block 1000, Block Group 1, Census Tract 92.03, District of Columbia, District of Columbia",279,1,278,0,0,0,0,0,279,275,1,274,0,0,0,0,0,4,0,4,0,0,0,0,0,110010092031000,5,502,502,5,psa_40,5D1
1000000US110010042021011,"Block 1011, Block Group 1, Census Tract 42.02, District of Columbia, District of Columbia",0,0,0,0,0,0,0,0,0,0,0,0,0,0,0,0,0,0,0,0,0,0,0,0,0,110010042021011,2,208,208,2,psa_33,2D3
1000000US110010095032010,"Block 2010, Block Group 2, Census Tract 95.03, District of Columbia, District of Columbia",29,8,18,0,0,0,0,3,29,28,8,17,0,0,0,0,3,1,0,1,0,0,0,0,0,110010095032010,5,504,504,5,psa_43,5D2
1000000US110010005021010,"Block 1010, Block Group 1, Census Tract 5.02, District of Columbia, District of Columbia",25,22,0,0,0,0,2,1,25,17,17,0,0,0,0,0,0,8,5,0,0,0,0,2,1,110010005021010,2,204,204,2,psa_44,2D2
1000000US110010023011011,"Block 1011, Block Group 1, Census Tract 23.01, District of Columbia, District of Columbia",34,7,17,0,0,0,10,0,34,22,5,17,0,0,0,0,0,12,2,0,0,0,0,10,0,110010023011011,4,407,407,4,psa_47,4D2
1000000US110010083021007,"Block 1007, Block Group 1, Census Tract 83.02, District of Columbia, District of Columbia",94,73,17,1,1,0,1,1,94,90,69,17,1,1,0,1,1,4,4,0,0,0,0,0,0,110010083021007,1,108,108,1,psa_17,1D2
1000000US110010011002007,"Block 2007, Block Group 2, Census Tract 11, District of Columbia, District of Columbia",57,49,3,0,0,0,2,3,57,57,49,3,0,0,0,2,3,0,0,0,0,0,0,0,0,110010011002007,2,202,202,2,psa_52,2D1
1000000US110010017022019,"Block 2019, Block Group 2, Census Tract 17.02, District of Columbia, District of Columbia",51,22,29,0,0,0,0,0,51,48,21,27,0,0,0,0,0,3,1,2,0,0,0,0,0,110010017022019,4,401,401,4,psa_56,4D1
1000000US110010021022009,"Block 2009, Block Group 2, Census Tract 21.02, District of Columbia, District of Columbia",223,30,159,0,6,0,23,5,223,195,25,156,0,6,0,3,5,28,5,3,0,0,0,20,0,110010021022009,4,403,403,4,psa_51,4D1
1000000US110010084022002,"Block 2002, Block Group 2, Census Tract 84.02, District of Columbia, District of Columbia",143,103,32,0,1,0,0,7,143,129,91,30,0,1,0,0,7,14,12,2,0,0,0,0,0,110010084022002,1,104,104,1,psa_21,1D2
1000000US110010069001006,"Block 1006, Block Group 1, Census Tract 69, District of Columbia, District of Columbia",69,64,4,0,0,0,1,0,69,69,64,4,0,0,0,1,0,0,0,0,0,0,0,0,0,110010069001006,1,107,107,1,psa_16,1D2
1000000US110010082002008,"Block 2008, Block Group 2, Census Tract 82, District of Columbia, District of Columbia",133,111,17,1,1,0,0,3,133,125,106,17,0,1,0,0,1,8,5,0,1,0,0,0,2,110010082002008,1,108,108,1,psa_17,1D2
1000000US110010002024024,"Block 4024, Block Group 4, Census Tract 2.02, District of Columbia, District of Columbia",0,0,0,0,0,0,0,0,0,0,0,0,0,0,0,0,0,0,0,0,0,0,0,0,0,110010002024024,2,206,206,2,psa_29,2D2
1000000US110010027022005,"Block 2005, Block Group 2, Census Tract 27.02, District of Columbia, District of Columbia",288,232,34,1,12,0,3,6,288,274,222,33,1,12,0,1,5,14,10,1,0,0,0,2,1,110010027022005,3,302,302,3,psa_42,3D1
1000000US110010043001000,"Block 1000, Block Group 1, Census Tract 43, District of Columbia, District of Columbia",150,122,11,0,6,0,5,6,150,126,104,11,0,6,0,0,5,24,18,0,0,0,0,5,1,110010043001000,3,301,301,3,psa_31,3D3
1000000US110010106002048,"Block 2048, Block Group 2, Census Tract 106, District of Columbia, District of Columbia",69,22,37,0,7,0,0,3,69,68,22,37,0,7,0,0,2,1,0,0,0,0,0,0,1,110010106002048,1,104,104,1,psa_21,1D2
1000000US110010037001002,"Block 1002, Block Group 1, Census Tract 37, District of Columbia, District of Columbia",542,353,112,0,32,3,16,26,542,484,322,111,0,32,3,2,14,58,31,1,0,0,0,14,12,110010037001002,3,304,304,3,psa_36,3D1
1000000US110010070001013,"Block 1013, Block Group 1, Census Tract 70, District of Columbia, District of Columbia",0,0,0,0,0,0,0,0,0,0,0,0,0,0,0,0,0,0,0,0,0,0,0,0,0,110010070001013,1,106,106,1,psa_13,1D3
1000000US110010011002027,"Block 2027, Block Group 2, Census Tract 11, District of Columbia, District of Columbia",67,57,2,0,5,0,0,3,67,67,57,2,0,5,0,0,3,0,0,0,0,0,0,0,0,110010011002027,2,202,202,2,psa_52,2D1
1000000US110010068011007,"Block 1007, Block Group 1, Census Tract 68.01, District of Columbia, District of Columbia",102,23,67,1,1,0,5,5,102,93,21,67,0,1,0,0,4,9,2,0,1,0,0,5,1,110010068011007,1,107,107,1,psa_16,1D2
1000000US110010073011076,"Block 1076, Block Group 1, Census Tract 73.01, District of Columbia, District of Columbia",0,0,0,0,0,0,0,0,0,0,0,0,0,0,0,0,0,0,0,0,0,0,0,0,0,110010073011076,7,708,708,7,psa_1,7D3
1000000US110010074081001,"Block 1001, Block Group 1, Census Tract 74.08, District of Columbia, District of Columbia",7,0,6,0,0,0,1,0,7,6,0,6,0,0,0,0,0,1,0,0,0,0,0,1,0,110010074081001,7,702,702,7,psa_6,7D1
1000000US110010095053006,"Block 3006, Block Group 3, Census Tract 95.05, District of Columbia, District of Columbia",85,5,61,0,0,0,16,3,85,67,5,61,0,0,0,0,1,18,0,0,0,0,0,16,2,110010095053006,4,406,406,4,psa_54,4D2
1000000US110010024002012,"Block 2012, Block Group 2, Census Tract 24, District of Columbia, District of Columbia",0,0,0,0,0,0,0,0,0,0,0,0,0,0,0,0,0,0,0,0,0,0,0,0,0,110010024002012,4,407,407,4,psa_47,4D2
1000000US110010020011000,"Block 1000, Block Group 1, Census Tract 20.01, District of Columbia, District of Columbia",96,23,44,0,0,0,25,4,96,50,2,44,0,0,0,0,4,46,21,0,0,0,0,25,0,110010020011000,4,403,403,4,psa_51,4D1
1000000US110010041003004,"Block 3004, Block Group 3, Census Tract 41, District of Columbia, District of Columbia",0,0,0,0,0,0,0,0,0,0,0,0,0,0,0,0,0,0,0,0,0,0,0,0,0,110010041003004,2,208,208,2,psa_33,2D3
1000000US110010047012000,"Block 2000, Block Group 2, Census Tract 47.01, District of Columbia, District of Columbia",974,26,924,7,4,0,1,12,974,959,23,917,2,4,0,1,12,15,3,7,5,0,0,0,0,110010047012000,1,102,102,1,psa_18,1D1
1000000US110010076031005,"Block 1005, Block Group 1, Census Tract 76.03, District of Columbia, District of Columbia",92,3,85,0,2,0,1,1,92,90,3,84,0,2,0,0,1,2,0,1,0,0,0,1,0,110010076031005,6,606,606,6,psa_7,6D2
1000000US110010111003038,"Block 3038, Block Group 3, Census Tract 111, District of Columbia, District of Columbia",54,6,43,0,0,0,0,5,54,44,4,40,0,0,0,0,0,10,2,3,0,0,0,0,5,110010111003038,5,503,503,5,psa_45,5D2
1000000US110010088042003,"Block 2003, Block Group 2, Census Tract 88.04, District of Columbia, District of Columbia",0,0,0,0,0,0,0,0,0,0,0,0,0,0,0,0,0,0,0,0,0,0,0,0,0,110010088042003,5,506,506,5,psa_26,5D3
1000000US110010092032012,"Block 2012, Block Group 2, Census Tract 92.03, District of Columbia, District of Columbia",20,0,20,0,0,0,0,0,20,20,0,20,0,0,0,0,0,0,0,0,0,0,0,0,0,110010092032012,5,502,502,5,psa_40,5D1
1000000US110010095041015,"Block 1015, Block Group 1, Census Tract 95.04, District of Columbia, District of Columbia",39,29,6,0,2,0,0,2,39,38,28,6,0,2,0,0,2,1,1,0,0,0,0,0,0,110010095041015,4,405,405,4,psa_49,4D2
1000000US110010008013002,"Block 3002, Block Group 3, Census Tract 8.01, District of Columbia, District of Columbia",3,3,0,0,0,0,0,0,3,3,3,0,0,0,0,0,0,0,0,0,0,0,0,0,0,110010008013002,2,205,205,2,psa_46,2D2
1000000US110010078061010,"Block 1010, Block Group 1, Census Tract 78.06, District of Columbia, District of Columbia",38,0,30,8,0,0,0,0,38,38,0,30,8,0,0,0,0,0,0,0,0,0,0,0,0,110010078061010,6,602,602,6,psa_25,6D1
1000000US110010073011012,"Block 1012, Block Group 1, Census Tract 73.01, District of Columbia, District of Columbia",0,0,0,0,0,0,0,0,0,0,0,0,0,0,0,0,0,0,0,0,0,0,0,0,0,110010073011012,7,707,707,7,psa_4,7D2
1000000US110010111003028,"Block 3028, Block Group 3, Census Tract 111, District of Columbia, District of Columbia",0,0,0,0,0,0,0,0,0,0,0,0,0,0,0,0,0,0,0,0,0,0,0,0,0,110010111003028,5,503,503,5,psa_45,5D2
1000000US110010111003031,"Block 3031, Block Group 3, Census Tract 111, District of Columbia, District of Columbia",0,0,0,0,0,0,0,0,0,0,0,0,0,0,0,0,0,0,0,0,0,0,0,0,0,110010111003031,5,503,503,5,psa_45,5D2
1000000US110010001001004,"Block 1004, Block Group 1, Census Tract 1, District of Columbia, District of Columbia",78,65,5,1,6,1,0,0,78,74,61,5,1,6,1,0,0,4,4,0,0,0,0,0,0,110010001001004,2,206,206,2,psa_29,2D2
1000000US110010062021112,"Block 1112, Block Group 1, Census Tract 62.02, District of Columbia, District of Columbia",0,0,0,0,0,0,0,0,0,0,0,0,0,0,0,0,0,0,0,0,0,0,0,0,0,110010062021112,1,102,102,1,psa_18,1D1
1000000US110010078081004,"Block 1004, Block Group 1, Census Tract 78.08, District of Columbia, District of Columbia",67,0,67,0,0,0,0,0,67,67,0,67,0,0,0,0,0,0,0,0,0,0,0,0,0,110010078081004,6,608,608,6,psa_19,6D1
1000000US110010001004012,"Block 4012, Block Group 4, Census Tract 1, District of Columbia, District of Columbia",14,13,0,0,1,0,0,0,14,14,13,0,0,1,0,0,0,0,0,0,0,0,0,0,0,110010001004012,2,206,206,2,psa_29,2D2
1000000US110010021021011,"Block 1011, Block Group 1, Census Tract 21.02, District of Columbia, District of Columbia",38,0,23,0,0,0,15,0,38,23,0,23,0,0,0,0,0,15,0,0,0,0,0,15,0,110010021021011,4,402,402,4,psa_53,4D1
1000000US110010095032001,"Block 2001, Block Group 2, Census Tract 95.03, District of Columbia, District of Columbia",32,0,29,0,0,0,0,3,32,32,0,29,0,0,0,0,3,0,0,0,0,0,0,0,0,110010095032001,4,405,405,4,psa_49,4D2
1000000US110010078083003,"Block 3003, Block Group 3, Census Tract 78.08, District of Columbia, District of Columbia",0,0,0,0,0,0,0,0,0,0,0,0,0,0,0,0,0,0,0,0,0,0,0,0,0,110010078083003,6,608,608,6,psa_19,6D1
1000000US110010010014026,"Block 4026, Block Group 4, Census Tract 10.01, District of Columbia, District of Columbia",41,41,0,0,0,0,0,0,41,41,41,0,0,0,0,0,0,0,0,0,0,0,0,0,0,110010010014026,2,202,202,2,psa_52,2D1
1000000US110010096022006,"Block 2006, Block Group 2, Census Tract 96.02, District of Columbia, District of Columbia",0,0,0,0,0,0,0,0,0,0,0,0,0,0,0,0,0,0,0,0,0,0,0,0,0,110010096022006,6,601,601,6,psa_30,6D1
1000000US110010106002052,"Block 2052, Block Group 2, Census Tract 106, District of Columbia, District of Columbia",0,0,0,0,0,0,0,0,0,0,0,0,0,0,0,0,0,0,0,0,0,0,0,0,0,110010106002052,1,102,102,1,psa_18,1D1
1000000US110010029001005,"Block 1005, Block Group 1, Census Tract 29, District of Columbia, District of Columbia",334,112,96,1,3,0,105,17,334,197,85,96,1,3,0,6,6,137,27,0,0,0,0,99,11,110010029001005,4,408,408,4,psa_39,4D3
1000000US110010010022007,"Block 2007, Block Group 2, Census Tract 10.02, District of Columbia, District of Columbia",0,0,0,0,0,0,0,0,0,0,0,0,0,0,0,0,0,0,0,0,0,0,0,0,0,110010010022007,2,204,204,2,psa_44,2D2
1000000US110010005021009,"Block 1009, Block Group 1, Census Tract 5.02, District of Columbia, District of Columbia",5,5,0,0,0,0,0,0,5,4,4,0,0,0,0,0,0,1,1,0,0,0,0,0,0,110010005021009,2,204,204,2,psa_44,2D2
1000000US110010021021002,"Block 1002, Block Group 1, Census Tract 21.02, District of Columbia, District of Columbia",88,7,57,0,0,0,17,7,88,64,4,57,0,0,0,0,3,24,3,0,0,0,0,17,4,110010021021002,4,406,406,4,psa_54,4D2
1000000US110010077072011,"Block 2011, Block Group 2, Census Tract 77.07, District of Columbia, District of Columbia",38,0,37,0,0,0,0,1,38,38,0,37,0,0,0,0,1,0,0,0,0,0,0,0,0,110010077072011,6,605,605,6,psa_11,6D2
1000000US110010076042010,"Block 2010, Block Group 2, Census Tract 76.04, District of Columbia, District of Columbia",91,2,84,0,0,0,5,0,91,86,1,84,0,0,0,1,0,5,1,0,0,0,0,4,0,110010076042010,6,606,606,6,psa_7,6D2
1000000US110010095031003,"Block 1003, Block Group 1, Census Tract 95.03, District of Columbia, District of Columbia",93,0,86,0,0,0,0,7,93,93,0,86,0,0,0,0,7,0,0,0,0,0,0,0,0,110010095031003,4,405,405,4,psa_49,4D2
1000000US110010005012002,"Block 2002, Block Group 2, Census Tract 5.01, District of Columbia, District of Columbia",0,0,0,0,0,0,0,0,0,0,0,0,0,0,0,0,0,0,0,0,0,0,0,0,0,110010005012002,2,204,204,2,psa_44,2D2
1000000US110010041003014,"Block 3014, Block Group 3, Census Tract 41, District of Columbia, District of Columbia",29,15,0,0,14,0,0,0,29,29,15,0,0,14,0,0,0,0,0,0,0,0,0,0,0,110010041003014,2,208,208,2,psa_33,2D3
1000000US110010071001008,"Block 1008, Block Group 1, Census Tract 71, District of Columbia, District of Columbia",249,98,119,3,4,0,17,8,249,221,91,117,3,4,0,0,6,28,7,2,0,0,0,17,2,110010071001008,1,106,106,1,psa_13,1D3
1000000US110010093012012,"Block 2012, Block Group 2, Census Tract 93.01, District of Columbia, District of Columbia",39,13,26,0,0,0,0,0,39,39,13,26,0,0,0,0,0,0,0,0,0,0,0,0,0,110010093012012,5,504,504,5,psa_43,5D2
1000000US110010073011074,"Block 1074, Block Group 1, Census Tract 73.01, District of Columbia, District of Columbia",0,0,0,0,0,0,0,0,0,0,0,0,0,0,0,0,0,0,0,0,0,0,0,0,0,110010073011074,7,708,708,7,psa_1,7D3
1000000US110010021014006,"Block 4006, Block Group 4, Census Tract 21.01, District of Columbia, District of Columbia",112,27,57,0,0,0,28,0,112,66,8,57,0,0,0,1,0,46,19,0,0,0,0,27,0,110010021014006,4,403,403,4,psa_51,4D1
1000000US110010076031006,"Block 1006, Block Group 1, Census Tract 76.03, District of Columbia, District of Columbia",98,5,86,0,6,0,0,1,98,98,5,86,0,6,0,0,1,0,0,0,0,0,0,0,0,110010076031006,6,606,606,6,psa_7,6D2
1000000US110010078091007,"Block 1007, Block Group 1, Census Tract 78.09, District of Columbia, District of Columbia",88,2,85,0,1,0,0,0,88,88,2,85,0,1,0,0,0,0,0,0,0,0,0,0,0,110010078091007,6,608,608,6,psa_19,6D1
1000000US110010099021002,"Block 1002, Block Group 1, Census Tract 99.02, District of Columbia, District of Columbia",25,0,24,0,0,0,1,0,25,24,0,24,0,0,0,0,0,1,0,0,0,0,0,1,0,110010099021002,6,605,605,6,psa_11,6D2
1000000US110010006002007,"Block 2007, Block Group 2, Census Tract 6, District of Columbia, District of Columbia",205,176,6,2,13,0,4,4,205,192,167,6,1,12,0,2,4,13,9,0,1,1,0,2,0,110010006002007,2,204,204,2,psa_44,2D2
1000000US110010043001003,"Block 1003, Block Group 1, Census Tract 43, District of Columbia, District of Columbia",486,385,34,0,43,2,5,17,486,441,351,32,0,43,2,0,13,45,34,2,0,0,0,5,4,110010043001003,3,301,301,3,psa_31,3D3
1000000US110010095053020,"Block 3020, Block Group 3, Census Tract 95.05, District of Columbia, District of Columbia",14,4,10,0,0,0,0,0,14,10,0,10,0,0,0,0,0,4,4,0,0,0,0,0,0,110010095053020,4,406,406,4,psa_54,4D2
1000000US110010096032003,"Block 2003, Block Group 2, Census Tract 96.03, District of Columbia, District of Columbia",206,0,198,0,0,0,8,0,206,198,0,198,0,0,0,0,0,8,0,0,0,0,0,8,0,110010096032003,6,603,603,6,psa_15,6D3
1000000US110010058001008,"Block 1008, Block Group 1, Census Tract 58, District of Columbia, District of Columbia",0,0,0,0,0,0,0,0,0,0,0,0,0,0,0,0,0,0,0,0,0,0,0,0,0,110010058001008,2,209,209,2,psa_57,2D3
1000000US110010081001005,"Block 1005, Block Group 1, Census Tract 81, District of Columbia, District of Columbia",140,112,18,0,3,0,3,4,140,131,104,18,0,3,0,2,4,9,8,0,0,0,0,1,0,110010081001005,1,108,108,1,psa_17,1D2
1000000US110010089042006,"Block 2006, Block Group 2, Census Tract 89.04, District of Columbia, District of Columbia",146,3,138,1,0,0,4,0,146,142,3,138,1,0,0,0,0,4,0,0,0,0,0,4,0,110010089042006,5,507,507,5,psa_23,5D3
1000000US110010111003005,"Block 3005, Block Group 3, Census Tract 111, District of Columbia, District of Columbia",61,10,44,0,0,0,7,0,61,49,5,44,0,0,0,0,0,12,5,0,0,0,0,7,0,110010111003005,5,503,503,5,psa_45,5D2
1000000US110010096032008,"Block 2008, Block Group 2, Census Tract 96.03, District of Columbia, District of Columbia",0,0,0,0,0,0,0,0,0,0,0,0,0,0,0,0,0,0,0,0,0,0,0,0,0,110010096032008,6,603,603,6,psa_15,6D3
1000000US110010093012025,"Block 2025, Block Group 2, Census Tract 93.01, District of Columbia, District of Columbia",86,16,66,0,2,0,0,2,86,86,16,66,0,2,0,0,2,0,0,0,0,0,0,0,0,110010093012025,5,504,504,5,psa_43,5D2
1000000US110010106003002,"Block 3002, Block Group 3, Census Tract 106, District of Columbia, District of Columbia",108,38,58,0,0,0,5,7,108,99,34,57,0,0,0,2,6,9,4,1,0,0,0,3,1,110010106003002,5,501,501,5,psa_35,5D1
1000000US110010078082014,"Block 2014, Block Group 2, Census Tract 78.08, District of Columbia, District of Columbia",160,2,155,0,0,0,0,3,160,157,2,154,0,0,0,0,1,3,0,1,0,0,0,0,2,110010078082014,6,608,608,6,psa_19,6D1
1000000US110010095042007,"Block 2007, Block Group 2, Census Tract 95.04, District of Columbia, District of Columbia",70,6,61,0,1,0,2,0,70,67,5,60,0,1,0,1,0,3,1,1,0,0,0,1,0,110010095042007,4,405,405,4,psa_49,4D2
1000000US110010075032001,"Block 2001, Block Group 2, Census Tract 75.03, District of Columbia, District of Columbia",442,6,426,4,0,0,0,6,442,435,5,424,0,0,0,0,6,7,1,2,4,0,0,0,0,110010075032001,7,701,701,7,psa_9,7D1
1000000US110010079031009,"Block 1009, Block Group 1, Census Tract 79.03, District of Columbia, District of Columbia",99,11,87,0,0,0,1,0,99,91,4,87,0,0,0,0,0,8,7,0,0,0,0,1,0,110010079031009,5,507,507,5,psa_23,5D3
1000000US110010068041022,"Block 1022, Block Group 1, Census Tract 68.04, District of Columbia, District of Columbia",0,0,0,0,0,0,0,0,0,0,0,0,0,0,0,0,0,0,0,0,0,0,0,0,0,110010068041022,1,108,108,1,psa_17,1D2
1000000US110010095041006,"Block 1006, Block Group 1, Census Tract 95.04, District of Columbia, District of Columbia",89,15,63,0,0,0,7,4,89,78,11,63,0,0,0,0,4,11,4,0,0,0,0,7,0,110010095041006,4,405,405,4,psa_49,4D2
1000000US110010080022003,"Block 2003, Block Group 2, Census Tract 80.02, District of Columbia, District of Columbia",0,0,0,0,0,0,0,0,0,0,0,0,0,0,0,0,0,0,0,0,0,0,0,0,0,110010080022003,1,108,108,1,psa_17,1D2
1000000US110010091021001,"Block 1001, Block Group 1, Census Tract 91.02, District of Columbia, District of Columbia",0,0,0,0,0,0,0,0,0,0,0,0,0,0,0,0,0,0,0,0,0,0,0,0,0,110010091021001,5,505,505,5,psa_34,5D2
1000000US110010095053022,"Block 3022, Block Group 3, Census Tract 95.05, District of Columbia, District of Columbia",33,2,25,0,5,0,0,1,33,32,2,25,0,5,0,0,0,1,0,0,0,0,0,0,1,110010095053022,4,406,406,4,psa_54,4D2
1000000US110010026002014,"Block 2014, Block Group 2, Census Tract 26, District of Columbia, District of Columbia",0,0,0,0,0,0,0,0,0,0,0,0,0,0,0,0,0,0,0,0,0,0,0,0,0,110010026002014,2,203,203,2,psa_50,2D1
1000000US110010058002003,"Block 2003, Block Group 2, Census Tract 58, District of Columbia, District of Columbia",215,51,93,1,67,0,0,3,215,210,47,92,1,67,0,0,3,5,4,1,0,0,0,0,0,110010058002003,1,101,101,1,psa_20,1D1
1000000US110010111002030,"Block 2030, Block Group 2, Census Tract 111, District of Columbia, District of Columbia",31,0,31,0,0,0,0,0,31,31,0,31,0,0,0,0,0,0,0,0,0,0,0,0,0,110010111002030,5,503,503,5,psa_45,5D2
1000000US110010016001014,"Block 1014, Block Group 1, Census Tract 16, District of Columbia, District of Columbia",28,6,16,0,1,0,1,4,28,27,6,16,0,1,0,0,4,1,0,0,0,0,0,1,0,110010016001014,4,401,401,4,psa_56,4D1
1000000US110010042012003,"Block 2003, Block Group 2, Census Tract 42.01, District of Columbia, District of Columbia",446,393,11,2,19,0,9,12,446,417,374,11,1,19,0,1,11,29,19,0,1,0,0,8,1,110010042012003,3,301,301,3,psa_31,3D3
1000000US110010099012002,"Block 2002, Block Group 2, Census Tract 99.01, District of Columbia, District of Columbia",0,0,0,0,0,0,0,0,0,0,0,0,0,0,0,0,0,0,0,0,0,0,0,0,0,110010099012002,6,605,605,6,psa_11,6D2
1000000US110010016004006,"Block 4006, Block Group 4, Census Tract 16, District of Columbia, District of Columbia",22,2,19,0,0,0,0,1,22,22,2,19,0,0,0,0,1,0,0,0,0,0,0,0,0,110010016004006,4,401,401,4,psa_56,4D1
1000000US110010095052010,"Block 2010, Block Group 2, Census Tract 95.05, District of Columbia, District of Columbia",33,0,32,0,0,0,1,0,33,32,0,32,0,0,0,0,0,1,0,0,0,0,0,1,0,110010095052010,4,406,406,4,psa_54,4D2
1000000US110010101001011,"Block 1011, Block Group 1, Census Tract 101, District of Columbia, District of Columbia",83,63,3,0,14,0,3,0,83,73,58,3,0,12,0,0,0,10,5,0,0,2,0,3,0,110010101001011,2,209,209,2,psa_57,2D3
1000000US110010038002007,"Block 2007, Block Group 2, Census Tract 38, District of Columbia, District of Columbia",0,0,0,0,0,0,0,0,0,0,0,0,0,0,0,0,0,0,0,0,0,0,0,0,0,110010038002007,3,303,303,3,psa_37,3D3
1000000US110010068041011,"Block 1011, Block Group 1, Census Tract 68.04, District of Columbia, District of Columbia",3630,180,3192,29,21,1,104,103,3630,3319,86,3107,24,21,0,8,73,311,94,85,5,0,1,96,30,110010068041011,1,107,107,1,psa_16,1D2
1000000US110010005011011,"Block 1011, Block Group 1, Census Tract 5.01, District of Columbia, District of Columbia",103,91,5,2,3,0,0,2,103,100,88,5,2,3,0,0,2,3,3,0,0,0,0,0,0,110010005011011,2,204,204,2,psa_44,2D2
1000000US110010056001005,"Block 1005, Block Group 1, Census Tract 56, District of Columbia, District of Columbia",0,0,0,0,0,0,0,0,0,0,0,0,0,0,0,0,0,0,0,0,0,0,0,0,0,110010056001005,2,207,207,2,psa_24,2D3
1000000US110010091022011,"Block 2011, Block Group 2, Census Tract 91.02, District of Columbia, District of Columbia",109,2,107,0,0,0,0,0,109,109,2,107,0,0,0,0,0,0,0,0,0,0,0,0,0,110010091022011,5,505,505,5,psa_34,5D2
1000000US110010106003005,"Block 3005, Block Group 3, Census Tract 106, District of Columbia, District of Columbia",53,25,28,0,0,0,0,0,53,52,24,28,0,0,0,0,0,1,1,0,0,0,0,0,0,110010106003005,1,104,104,1,psa_21,1D2
1000000US110010107001028,"Block 1028, Block Group 1, Census Tract 107, District of Columbia, District of Columbia",0,0,0,0,0,0,0,0,0,0,0,0,0,0,0,0,0,0,0,0,0,0,0,0,0,110010107001028,2,207,207,2,psa_24,2D3
1000000US110010009022000,"Block 2000, Block Group 2, Census Tract 9.02, District of Columbia, District of Columbia",0,0,0,0,0,0,0,0,0,0,0,0,0,0,0,0,0,0,0,0,0,0,0,0,0,110010009022000,2,205,205,2,psa_46,2D2
1000000US110010019011008,"Block 1008, Block Group 1, Census Tract 19.01, District of Columbia, District of Columbia",74,7,56,1,0,0,5,5,74,65,5,54,1,0,0,0,5,9,2,2,0,0,0,5,0,110010019011008,4,402,402,4,psa_53,4D1
1000000US110010092041000,"Block 1000, Block Group 1, Census Tract 92.04, District of Columbia, District of Columbia",0,0,0,0,0,0,0,0,0,0,0,0,0,0,0,0,0,0,0,0,0,0,0,0,0,110010092041000,5,502,502,5,psa_40,5D1
1000000US110010071002011,"Block 2011, Block Group 2, Census Tract 71, District of Columbia, District of Columbia",192,112,55,1,4,0,11,9,192,177,109,55,1,4,0,1,7,15,3,0,0,0,0,10,2,110010071002011,1,106,106,1,psa_13,1D3
1000000US110010088023001,"Block 3001, Block Group 3, Census Tract 88.02, District of Columbia, District of Columbia",223,17,188,1,6,0,5,6,223,211,14,187,1,6,0,0,3,12,3,1,0,0,0,5,3,110010088023001,5,506,506,5,psa_26,5D3
1000000US110010095033016,"Block 3016, Block Group 3, Census Tract 95.03, District of Columbia, District of Columbia",60,35,20,0,3,0,1,1,60,57,33,20,0,3,0,0,1,3,2,0,0,0,0,1,0,110010095033016,5,504,504,5,psa_43,5D2
1000000US110010098101004,"Block 1004, Block Group 1, Census Tract 98.10, District of Columbia, District of Columbia",0,0,0,0,0,0,0,0,0,0,0,0,0,0,0,0,0,0,0,0,0,0,0,0,0,110010098101004,7,708,708,7,psa_1,7D3
1000000US110010104001024,"Block 1024, Block Group 1, Census Tract 104, District of Columbia, District of Columbia",52,0,52,0,0,0,0,0,52,52,0,52,0,0,0,0,0,0,0,0,0,0,0,0,0,110010104001024,7,707,707,7,psa_4,7D2
1000000US110010106002013,"Block 2013, Block Group 2, Census Tract 106, District of Columbia, District of Columbia",194,50,136,6,1,0,1,0,194,187,50,136,0,1,0,0,0,7,0,0,6,0,0,1,0,110010106002013,5,501,501,5,psa_35,5D1
1000000US110010006002002,"Block 2002, Block Group 2, Census Tract 6, District of Columbia, District of Columbia",172,164,0,0,4,0,1,3,172,164,158,0,0,4,0,0,2,8,6,0,0,0,0,1,1,110010006002002,2,203,203,2,psa_50,2D1
1000000US110010018042015,"Block 2015, Block Group 2, Census Tract 18.04, District of Columbia, District of Columbia",58,8,31,0,2,0,14,3,58,37,0,31,0,2,0,1,3,21,8,0,0,0,0,13,0,110010018042015,4,402,402,4,psa_53,4D1
1000000US110010010012028,"Block 2028, Block Group 2, Census Tract 10.01, District of Columbia, District of Columbia",80,73,3,0,3,0,0,1,80,76,69,3,0,3,0,0,1,4,4,0,0,0,0,0,0,110010010012028,2,202,202,2,psa_52,2D1
1000000US110010094001005,"Block 1005, Block Group 1, Census Tract 94, District of Columbia, District of Columbia",90,9,69,1,2,0,5,4,90,82,9,66,1,2,0,0,4,8,0,3,0,0,0,5,0,110010094001005,5,503,503,5,psa_45,5D2
1000000US110010004002003,"Block 2003, Block Group 2, Census Tract 4, District of Columbia, District of Columbia",21,17,0,1,1,0,0,2,21,21,17,0,1,1,0,0,2,0,0,0,0,0,0,0,0,110010004002003,2,204,204,2,psa_44,2D2
1000000US110010093011010,"Block 1010, Block Group 1, Census Tract 93.01, District of Columbia, District of Columbia",43,20,20,0,2,0,1,0,43,38,16,20,0,2,0,0,0,5,4,0,0,0,0,1,0,110010093011010,5,504,504,5,psa_43,5D2
1000000US110010095033005,"Block 3005, Block Group 3, Census Tract 95.03, District of Columbia, District of Columbia",14,3,11,0,0,0,0,0,14,14,3,11,0,0,0,0,0,0,0,0,0,0,0,0,0,110010095033005,4,405,405,4,psa_49,4D2
1000000US110010064002027,"Block 2027, Block Group 2, Census Tract 64, District of Columbia, District of Columbia",0,0,0,0,0,0,0,0,0,0,0,0,0,0,0,0,0,0,0,0,0,0,0,0,0,110010064002027,1,105,105,1,psa_22,1D3
1000000US110010099052005,"Block 2005, Block Group 2, Census Tract 99.05, District of Columbia, District of Columbia",92,1,91,0,0,0,0,0,92,92,1,91,0,0,0,0,0,0,0,0,0,0,0,0,0,110010099052005,6,604,604,6,psa_14,6D3
1000000US110010105002017,"Block 2017, Block Group 2, Census Tract 105, District of Columbia, District of Columbia",0,0,0,0,0,0,0,0,0,0,0,0,0,0,0,0,0,0,0,0,0,0,0,0,0,110010105002017,1,103,103,1,psa_12,1D1
1000000US110010076053005,"Block 3005, Block Group 3, Census Tract 76.05, District of Columbia, District of Columbia",212,3,202,1,0,0,0,6,212,204,3,197,1,0,0,0,3,8,0,5,0,0,0,0,3,110010076053005,6,607,607,6,psa_10,6D2
1000000US110010078081010,"Block 1010, Block Group 1, Census Tract 78.08, District of Columbia, District of Columbia",75,2,73,0,0,0,0,0,75,75,2,73,0,0,0,0,0,0,0,0,0,0,0,0,0,110010078081010,6,608,608,6,psa_19,6D1
1000000US110010080022014,"Block 2014, Block Group 2, Census Tract 80.02, District of Columbia, District of Columbia",156,108,34,0,0,0,4,10,156,145,100,34,0,0,0,2,9,11,8,0,0,0,0,2,1,110010080022014,1,108,108,1,psa_17,1D2
1000000US110010078082008,"Block 2008, Block Group 2, Census Tract 78.08, District of Columbia, District of Columbia",75,0,72,0,0,0,0,3,75,74,0,72,0,0,0,0,2,1,0,0,0,0,0,0,1,110010078082008,6,608,608,6,psa_19,6D1
1000000US110010108002011,"Block 2011, Block Group 2, Census Tract 108.00, District of Columbia, District of Columbia",0,0,0,0,0,0,0,0,0,0,0,0,0,0,0,0,0,0,0,0,0,0,0,0,0,110010108002011,2,207,207,2,psa_24,2D3
1000000US110010076014003,"Block 4003, Block Group 4, Census Tract 76.01, District of Columbia, District of Columbia",76,0,71,0,2,0,0,3,76,76,0,71,0,2,0,0,3,0,0,0,0,0,0,0,0,110010076014003,6,607,607,6,psa_10,6D2
1000000US110010004002022,"Block 2022, Block Group 2, Census Tract 4, District of Columbia, District of Columbia",0,0,0,0,0,0,0,0,0,0,0,0,0,0,0,0,0,0,0,0,0,0,0,0,0,110010004002022,2,204,204,2,psa_44,2D2
1000000US110010098071003,"Block 1003, Block Group 1, Census Tract 98.07, District of Columbia, District of Columbia",0,0,0,0,0,0,0,0,0,0,0,0,0,0,0,0,0,0,0,0,0,0,0,0,0,110010098071003,7,708,708,7,psa_1,7D3
1000000US110010073011098,"Block 1098, Block Group 1, Census Tract 73.01, District of Columbia, District of Columbia",19,17,0,0,0,0,2,0,19,17,17,0,0,0,0,0,0,2,0,0,0,0,0,2,0,110010073011098,7,708,708,7,psa_1,7D3
1000000US110010078072003,"Block 2003, Block Group 2, Census Tract 78.07, District of Columbia, District of Columbia",48,0,43,1,0,0,0,4,48,48,0,43,1,0,0,0,4,0,0,0,0,0,0,0,0,110010078072003,6,608,608,6,psa_19,6D1
1000000US110010005022001,"Block 2001, Block Group 2, Census Tract 5.02, District of Columbia, District of Columbia",197,151,16,0,12,0,7,11,197,175,142,14,0,12,0,0,7,22,9,2,0,0,0,7,4,110010005022001,2,204,204,2,psa_44,2D2
1000000US110010053013002,"Block 3002, Block Group 3, Census Tract 53.01, District of Columbia, District of Columbia",0,0,0,0,0,0,0,0,0,0,0,0,0,0,0,0,0,0,0,0,0,0,0,0,0,110010053013002,2,208,208,2,psa_33,2D3
1000000US110010098033003,"Block 3003, Block Group 3, Census Tract 98.03, District of Columbia, District of Columbia",117,1,113,0,0,0,0,3,117,116,1,113,0,0,0,0,2,1,0,0,0,0,0,0,1,110010098033003,7,707,707,7,psa_4,7D2
1000000US110010106002028,"Block 2028, Block Group 2, Census Tract 106, District of Columbia, District of Columbia",0,0,0,0,0,0,0,0,0,0,0,0,0,0,0,0,0,0,0,0,0,0,0,0,0,110010106002028,5,501,501,5,psa_35,5D1
1000000US110010025011003,"Block 1003, Block Group 1, Census Tract 25.01, District of Columbia, District of Columbia",56,23,30,0,0,0,0,3,56,54,21,30,0,0,0,0,3,2,2,0,0,0,0,0,0,110010025011003,4,404,404,4,psa_48,4D3
1000000US110010101001023,"Block 1023, Block Group 1, Census Tract 101, District of Columbia, District of Columbia",0,0,0,0,0,0,0,0,0,0,0,0,0,0,0,0,0,0,0,0,0,0,0,0,0,110010101001023,2,209,209,2,psa_57,2D3
1000000US110010025012013,"Block 2013, Block Group 2, Census Tract 25.01, District of Columbia, District of Columbia",105,5,58,1,3,0,35,3,105,68,3,58,1,3,0,1,2,37,2,0,0,0,0,34,1,110010025012013,4,404,404,4,psa_48,4D3
1000000US110010080022023,"Block 2023, Block Group 2, Census Tract 80.02, District of Columbia, District of Columbia",0,0,0,0,0,0,0,0,0,0,0,0,0,0,0,0,0,0,0,0,0,0,0,0,0,110010080022023,1,108,108,1,psa_17,1D2
1000000US110010020021023,"Block 1023, Block Group 1, Census Tract 20.02, District of Columbia, District of Columbia",16,3,12,0,0,0,1,0,16,15,3,12,0,0,0,0,0,1,0,0,0,0,0,1,0,110010020021023,4,404,404,4,psa_48,4D3
1000000US110010044001002,"Block 1002, Block Group 1, Census Tract 44, District of Columbia, District of Columbia",180,82,67,3,6,0,16,6,180,125,55,60,2,6,0,0,2,55,27,7,1,0,0,16,4,110010044001002,3,305,305,3,psa_32,3D2
1000000US110010091023000,"Block 3000, Block Group 3, Census Tract 91.02, District of Columbia, District of Columbia",240,1,233,0,0,0,0,6,240,231,1,225,0,0,0,0,5,9,0,8,0,0,0,0,1,110010091023000,5,505,505,5,psa_34,5D2
1000000US110010088031019,"Block 1019, Block Group 1, Census Tract 88.03, District of Columbia, District of Columbia",0,0,0,0,0,0,0,0,0,0,0,0,0,0,0,0,0,0,0,0,0,0,0,0,0,110010088031019,5,501,501,5,psa_35,5D1
1000000US110010092032003,"Block 2003, Block Group 2, Census Tract 92.03, District of Columbia, District of Columbia",107,10,86,0,0,0,11,0,107,95,9,83,0,0,0,3,0,12,1,3,0,0,0,8,0,110010092032003,5,502,502,5,psa_40,5D1
1000000US110010020022005,"Block 2005, Block Group 2, Census Tract 20.02, District of Columbia, District of Columbia",402,83,215,4,5,0,80,15,402,298,56,215,0,5,0,15,7,104,27,0,4,0,0,65,8,110010020022005,4,403,403,4,psa_51,4D1
1000000US110010094001016,"Block 1016, Block Group 1, Census Tract 94, District of Columbia, District of Columbia",40,0,40,0,0,0,0,0,40,40,0,40,0,0,0,0,0,0,0,0,0,0,0,0,0,110010094001016,5,503,503,5,psa_45,5D2
1000000US110010078062008,"Block 2008, Block Group 2, Census Tract 78.06, District of Columbia, District of Columbia",42,4,38,0,0,0,0,0,42,42,4,38,0,0,0,0,0,0,0,0,0,0,0,0,0,110010078062008,6,602,602,6,psa_25,6D1
1000000US110010073011032,"Block 1032, Block Group 1, Census Tract 73.01, District of Columbia, District of Columbia",0,0,0,0,0,0,0,0,0,0,0,0,0,0,0,0,0,0,0,0,0,0,0,0,0,110010073011032,7,703,703,7,psa_8,7D1
1000000US110010077082015,"Block 2015, Block Group 2, Census Tract 77.08, District of Columbia, District of Columbia",88,2,86,0,0,0,0,0,88,88,2,86,0,0,0,0,0,0,0,0,0,0,0,0,0,110010077082015,6,603,603,6,psa_15,6D3
1000000US110010099011008,"Block 1008, Block Group 1, Census Tract 99.01, District of Columbia, District of Columbia",84,8,75,0,1,0,0,0,84,84,8,75,0,1,0,0,0,0,0,0,0,0,0,0,0,110010099011008,6,605,605,6,psa_11,6D2
1000000US110010062021057,"Block 1057, Block Group 1, Census Tract 62.02, District of Columbia, District of Columbia",0,0,0,0,0,0,0,0,0,0,0,0,0,0,0,0,0,0,0,0,0,0,0,0,0,110010062021057,2,207,207,2,psa_24,2D3
1000000US110010023011010,"Block 1010, Block Group 1, Census Tract 23.01, District of Columbia, District of Columbia",81,17,52,0,0,0,12,0,81,68,16,52,0,0,0,0,0,13,1,0,0,0,0,12,0,110010023011010,4,407,407,4,psa_47,4D2
1000000US110010073011086,"Block 1086, Block Group 1, Census Tract 73.01, District of Columbia, District of Columbia",0,0,0,0,0,0,0,0,0,0,0,0,0,0,0,0,0,0,0,0,0,0,0,0,0,110010073011086,7,707,707,7,psa_4,7D2
1000000US110010080021008,"Block 1008, Block Group 1, Census Tract 80.02, District of Columbia, District of Columbia",0,0,0,0,0,0,0,0,0,0,0,0,0,0,0,0,0,0,0,0,0,0,0,0,0,110010080021008,1,108,108,1,psa_17,1D2
1000000US110010095083006,"Block 3006, Block Group 3, Census Tract 95.08, District of Columbia, District of Columbia",99,8,86,0,0,0,3,2,99,96,8,86,0,0,0,0,2,3,0,0,0,0,0,3,0,110010095083006,4,406,406,4,psa_54,4D2
1000000US110010092011000,"Block 1000, Block Group 1, Census Tract 92.01, District of Columbia, District of Columbia",0,0,0,0,0,0,0,0,0,0,0,0,0,0,0,0,0,0,0,0,0,0,0,0,0,110010092011000,5,504,504,5,psa_43,5D2
1000000US110010064002029,"Block 2029, Block Group 2, Census Tract 64, District of Columbia, District of Columbia",0,0,0,0,0,0,0,0,0,0,0,0,0,0,0,0,0,0,0,0,0,0,0,0,0,110010064002029,1,105,105,1,psa_22,1D3
1000000US110010067002002,"Block 2002, Block Group 2, Census Tract 67, District of Columbia, District of Columbia",172,141,21,0,7,0,0,3,172,171,140,21,0,7,0,0,3,1,1,0,0,0,0,0,0,110010067002002,1,107,107,1,psa_16,1D2
1000000US110010012002004,"Block 2004, Block Group 2, Census Tract 12, District of Columbia, District of Columbia",24,19,5,0,0,0,0,0,24,24,19,5,0,0,0,0,0,0,0,0,0,0,0,0,0,110010012002004,2,202,202,2,psa_52,2D1
1000000US110010011002012,"Block 2012, Block Group 2, Census Tract 11, District of Columbia, District of Columbia",0,0,0,0,0,0,0,0,0,0,0,0,0,0,0,0,0,0,0,0,0,0,0,0,0,110010011002012,2,202,202,2,psa_52,2D1
1000000US110010067003009,"Block 3009, Block Group 3, Census Tract 67, District of Columbia, District of Columbia",195,164,9,1,11,0,1,9,195,182,156,8,1,11,0,0,6,13,8,1,0,0,0,1,3,110010067003009,1,107,107,1,psa_16,1D2
1000000US110010001003002,"Block 3002, Block Group 3, Census Tract 1, District of Columbia, District of Columbia",248,229,3,0,14,0,2,0,248,239,220,3,0,14,0,2,0,9,9,0,0,0,0,0,0,110010001003002,2,206,206,2,psa_29,2D2
1000000US110010004002024,"Block 2024, Block Group 2, Census Tract 4, District of Columbia, District of Columbia",0,0,0,0,0,0,0,0,0,0,0,0,0,0,0,0,0,0,0,0,0,0,0,0,0,110010004002024,2,204,204,2,psa_44,2D2
1000000US110010010013010,"Block 3010, Block Group 3, Census Tract 10.01, District of Columbia, District of Columbia",55,53,0,0,0,0,1,1,55,50,50,0,0,0,0,0,0,5,3,0,0,0,0,1,1,110010010013010,2,202,202,2,psa_52,2D1
1000000US110010020012002,"Block 2002, Block Group 2, Census Tract 20.01, District of Columbia, District of Columbia",0,0,0,0,0,0,0,0,0,0,0,0,0,0,0,0,0,0,0,0,0,0,0,0,0,110010020012002,4,403,403,4,psa_51,4D1
1000000US110010084021007,"Block 1007, Block Group 1, Census Tract 84.02, District of Columbia, District of Columbia",126,58,60,1,0,0,2,5,126,123,58,59,0,0,0,1,5,3,0,1,1,0,0,1,0,110010084021007,1,104,104,1,psa_21,1D2
1000000US110010062021087,"Block 1087, Block Group 1, Census Tract 62.02, District of Columbia, District of Columbia",0,0,0,0,0,0,0,0,0,0,0,0,0,0,0,0,0,0,0,0,0,0,0,0,0,110010062021087,2,207,207,2,psa_24,2D3
1000000US110010078033008,"Block 3008, Block Group 3, Census Tract 78.03, District of Columbia, District of Columbia",81,0,77,0,1,0,2,1,81,78,0,77,0,1,0,0,0,3,0,0,0,0,0,2,1,110010078033008,6,608,608,6,psa_19,6D1
1000000US110010076042019,"Block 2019, Block Group 2, Census Tract 76.04, District of Columbia, District of Columbia",43,4,39,0,0,0,0,0,43,43,4,39,0,0,0,0,0,0,0,0,0,0,0,0,0,110010076042019,6,606,606,6,psa_7,6D2
1000000US110010062021063,"Block 1063, Block Group 1, Census Tract 62.02, District of Columbia, District of Columbia",4,0,4,0,0,0,0,0,4,4,0,4,0,0,0,0,0,0,0,0,0,0,0,0,0,110010062021063,2,207,207,2,psa_24,2D3
1000000US110010014022001,"Block 2001, Block Group 2, Census Tract 14.02, District of Columbia, District of Columbia",105,89,6,0,5,0,0,5,105,100,84,6,0,5,0,0,5,5,5,0,0,0,0,0,0,110010014022001,2,201,201,2,psa_55,2D1
1000000US110010102001009,"Block 1009, Block Group 1, Census Tract 102, District of Columbia, District of Columbia",20,18,0,1,0,0,0,1,20,20,18,0,1,0,0,0,1,0,0,0,0,0,0,0,0,110010102001009,1,103,103,1,psa_12,1D1
1000000US110010017022018,"Block 2018, Block Group 2, Census Tract 17.02, District of Columbia, District of Columbia",29,14,13,0,0,0,0,2,29,25,12,13,0,0,0,0,0,4,2,0,0,0,0,0,2,110010017022018,4,401,401,4,psa_56,4D1
1000000US110010062021033,"Block 1033, Block Group 1, Census Tract 62.02, District of Columbia, District of Columbia",0,0,0,0,0,0,0,0,0,0,0,0,0,0,0,0,0,0,0,0,0,0,0,0,0,110010062021033,2,207,207,2,psa_24,2D3
1000000US110010081003002,"Block 3002, Block Group 3, Census Tract 81, District of Columbia, District of Columbia",64,63,0,0,0,0,1,0,64,62,61,0,0,0,0,1,0,2,2,0,0,0,0,0,0,110010081003002,1,108,108,1,psa_17,1D2
1000000US110010096041009,"Block 1009, Block Group 1, Census Tract 96.04, District of Columbia, District of Columbia",0,0,0,0,0,0,0,0,0,0,0,0,0,0,0,0,0,0,0,0,0,0,0,0,0,110010096041009,6,603,603,6,psa_15,6D3
1000000US110010010012003,"Block 2003, Block Group 2, Census Tract 10.01, District of Columbia, District of Columbia",67,61,0,0,2,0,0,4,67,66,60,0,0,2,0,0,4,1,1,0,0,0,0,0,0,110010010012003,2,202,202,2,psa_52,2D1
1000000US110010010013012,"Block 3012, Block Group 3, Census Tract 10.01, District of Columbia, District of Columbia",55,43,0,0,10,0,0,2,55,52,41,0,0,10,0,0,1,3,2,0,0,0,0,0,1,110010010013012,2,202,202,2,psa_52,2D1
1000000US110010059001000,"Block 1000, Block Group 1, Census Tract 59, District of Columbia, District of Columbia",0,0,0,0,0,0,0,0,0,0,0,0,0,0,0,0,0,0,0,0,0,0,0,0,0,110010059001000,1,102,102,1,psa_18,1D1
1000000US110010106002003,"Block 2003, Block Group 2, Census Tract 106, District of Columbia, District of Columbia",0,0,0,0,0,0,0,0,0,0,0,0,0,0,0,0,0,0,0,0,0,0,0,0,0,110010106002003,5,501,501,5,psa_35,5D1
1000000US110010014011013,"Block 1013, Block Group 1, Census Tract 14.01, District of Columbia, District of Columbia",428,318,45,0,30,0,17,18,428,367,276,45,0,30,0,1,15,61,42,0,0,0,0,16,3,110010014011013,2,201,201,2,psa_55,2D1
1000000US110010046002013,"Block 2013, Block Group 2, Census Tract 46, District of Columbia, District of Columbia",92,30,49,0,9,0,0,4,92,87,25,49,0,9,0,0,4,5,5,0,0,0,0,0,0,110010046002013,3,308,308,3,psa_27,3D2
1000000US110010093012010,"Block 2010, Block Group 2, Census Tract 93.01, District of Columbia, District of Columbia",50,28,17,0,3,0,1,1,50,42,22,17,0,3,0,0,0,8,6,0,0,0,0,1,1,110010093012010,5,504,504,5,psa_43,5D2
1000000US110010032001004,"Block 1004, Block Group 1, Census Tract 32, District of Columbia, District of Columbia",137,42,78,0,2,0,15,0,137,117,38,77,0,2,0,0,0,20,4,1,0,0,0,15,0,110010032001004,4,409,409,4,psa_41,4D3
1000000US110010019021010,"Block 1010, Block Group 1, Census Tract 19.02, District of Columbia, District of Columbia",0,0,0,0,0,0,0,0,0,0,0,0,0,0,0,0,0,0,0,0,0,0,0,0,0,110010019021010,4,406,406,4,psa_54,4D2
1000000US110010024003005,"Block 3005, Block Group 3, Census Tract 24, District of Columbia, District of Columbia",106,12,79,0,0,0,10,5,106,90,6,79,0,0,0,3,2,16,6,0,0,0,0,7,3,110010024003005,4,407,407,4,psa_47,4D2
1000000US110010001004030,"Block 4030, Block Group 4, Census Tract 1, District of Columbia, District of Columbia",0,0,0,0,0,0,0,0,0,0,0,0,0,0,0,0,0,0,0,0,0,0,0,0,0,110010001004030,2,206,206,2,psa_29,2D2
1000000US110010010021000,"Block 1000, Block Group 1, Census Tract 10.02, District of Columbia, District of Columbia",1255,969,74,2,165,0,11,34,1255,1156,889,69,1,165,0,2,30,99,80,5,1,0,0,9,4,110010010021000,2,204,204,2,psa_44,2D2
1000000US110010106002038,"Block 2038, Block Group 2, Census Tract 106, District of Columbia, District of Columbia",0,0,0,0,0,0,0,0,0,0,0,0,0,0,0,0,0,0,0,0,0,0,0,0,0,110010106002038,1,102,102,1,psa_18,1D1
1000000US110010006002006,"Block 2006, Block Group 2, Census Tract 6, District of Columbia, District of Columbia",90,82,6,1,0,0,0,1,90,82,75,6,0,0,0,0,1,8,7,0,1,0,0,0,0,110010006002006,2,203,203,2,psa_50,2D1
1000000US110010020021001,"Block 1001, Block Group 1, Census Tract 20.02, District of Columbia, District of Columbia",30,16,13,0,1,0,0,0,30,27,13,13,0,1,0,0,0,3,3,0,0,0,0,0,0,110010020021001,4,403,403,4,psa_51,4D1
1000000US110010055001000,"Block 1000, Block Group 1, Census Tract 55, District of Columbia, District of Columbia",0,0,0,0,0,0,0,0,0,0,0,0,0,0,0,0,0,0,0,0,0,0,0,0,0,110010055001000,2,208,208,2,psa_33,2D3
1000000US110010078092008,"Block 2008, Block Group 2, Census Tract 78.09, District of Columbia, District of Columbia",28,0,14,0,0,0,14,0,28,14,0,14,0,0,0,0,0,14,0,0,0,0,0,14,0,110010078092008,6,602,602,6,psa_25,6D1
1000000US110010095051008,"Block 1008, Block Group 1, Census Tract 95.05, District of Columbia, District of Columbia",176,4,156,0,2,0,14,0,176,165,4,156,0,2,0,3,0,11,0,0,0,0,0,11,0,110010095051008,4,406,406,4,psa_54,4D2
1000000US110010096011024,"Block 1024, Block Group 1, Census Tract 96.01, District of Columbia, District of Columbia",0,0,0,0,0,0,0,0,0,0,0,0,0,0,0,0,0,0,0,0,0,0,0,0,0,110010096011024,6,601,601,6,psa_30,6D1
1000000US110010014011016,"Block 1016, Block Group 1, Census Tract 14.01, District of Columbia, District of Columbia",92,78,6,0,5,0,0,3,92,88,74,6,0,5,0,0,3,4,4,0,0,0,0,0,0,110010014011016,2,201,201,2,psa_55,2D1
1000000US110010074072003,"Block 2003, Block Group 2, Census Tract 74.07, District of Columbia, District of Columbia",48,0,48,0,0,0,0,0,48,48,0,48,0,0,0,0,0,0,0,0,0,0,0,0,0,110010074072003,7,703,703,7,psa_8,7D1
1000000US110010105002007,"Block 2007, Block Group 2, Census Tract 105, District of Columbia, District of Columbia",0,0,0,0,0,0,0,0,0,0,0,0,0,0,0,0,0,0,0,0,0,0,0,0,0,110010105002007,1,103,103,1,psa_12,1D1
1000000US110010019022000,"Block 2000, Block Group 2, Census Tract 19.02, District of Columbia, District of Columbia",0,0,0,0,0,0,0,0,0,0,0,0,0,0,0,0,0,0,0,0,0,0,0,0,0,110010019022000,4,406,406,4,psa_54,4D2
1000000US110010026001008,"Block 1008, Block Group 1, Census Tract 26, District of Columbia, District of Columbia",69,30,37,0,0,0,0,2,69,68,29,37,0,0,0,0,2,1,1,0,0,0,0,0,0,110010026001008,4,404,404,4,psa_48,4D3
1000000US110010064002009,"Block 2009, Block Group 2, Census Tract 64, District of Columbia, District of Columbia",199,3,180,0,0,0,14,2,199,184,3,180,0,0,0,0,1,15,0,0,0,0,0,14,1,110010064002009,1,105,105,1,psa_22,1D3
1000000US110010065002014,"Block 2014, Block Group 2, Census Tract 65, District of Columbia, District of Columbia",155,135,5,1,10,0,0,4,155,151,131,5,1,10,0,0,4,4,4,0,0,0,0,0,0,110010065002014,1,106,106,1,psa_13,1D3
1000000US110010043002003,"Block 2003, Block Group 2, Census Tract 43, District of Columbia, District of Columbia",143,115,9,1,9,0,6,3,143,123,102,9,1,8,0,0,3,20,13,0,0,1,0,6,0,110010043002003,3,301,301,3,psa_31,3D3
1000000US110010074062000,"Block 2000, Block Group 2, Census Tract 74.06, District of Columbia, District of Columbia",1624,7,1584,4,2,0,12,15,1624,1595,2,1574,4,2,0,2,11,29,5,10,0,0,0,10,4,110010074062000,7,703,703,7,psa_8,7D1
1000000US110010088021001,"Block 1001, Block Group 1, Census Tract 88.02, District of Columbia, District of Columbia",66,5,61,0,0,0,0,0,66,64,3,61,0,0,0,0,0,2,2,0,0,0,0,0,0,110010088021001,5,506,506,5,psa_26,5D3
1000000US110010095071008,"Block 1008, Block Group 1, Census Tract 95.07, District of Columbia, District of Columbia",68,0,68,0,0,0,0,0,68,67,0,67,0,0,0,0,0,1,0,1,0,0,0,0,0,110010095071008,4,406,406,4,psa_54,4D2
1000000US110010058002005,"Block 2005, Block Group 2, Census Tract 58, District of Columbia, District of Columbia",221,145,21,1,45,0,0,9,221,214,139,21,1,45,0,0,8,7,6,0,0,0,0,0,1,110010058002005,1,101,101,1,psa_20,1D1
1000000US110010058001025,"Block 1025, Block Group 1, Census Tract 58, District of Columbia, District of Columbia",0,0,0,0,0,0,0,0,0,0,0,0,0,0,0,0,0,0,0,0,0,0,0,0,0,110010058001025,1,101,101,1,psa_20,1D1
1000000US110010093012005,"Block 2005, Block Group 2, Census Tract 93.01, District of Columbia, District of Columbia",0,0,0,0,0,0,0,0,0,0,0,0,0,0,0,0,0,0,0,0,0,0,0,0,0,110010093012005,5,504,504,5,psa_43,5D2
1000000US110010074072011,"Block 2011, Block Group 2, Census Tract 74.07, District of Columbia, District of Columbia",97,0,93,0,4,0,0,0,97,97,0,93,0,4,0,0,0,0,0,0,0,0,0,0,0,110010074072011,7,703,703,7,psa_8,7D1
1000000US110010032004006,"Block 4006, Block Group 4, Census Tract 32, District of Columbia, District of Columbia",161,48,79,0,3,0,27,4,161,102,19,77,0,3,0,0,3,59,29,2,0,0,0,27,1,110010032004006,3,306,306,3,psa_38,3D2
1000000US110010076042022,"Block 2022, Block Group 2, Census Tract 76.04, District of Columbia, District of Columbia",26,4,22,0,0,0,0,0,26,26,4,22,0,0,0,0,0,0,0,0,0,0,0,0,0,110010076042022,6,606,606,6,psa_7,6D2
1000000US110010083021001,"Block 1001, Block Group 1, Census Tract 83.02, District of Columbia, District of Columbia",145,70,60,1,6,0,3,5,145,138,69,60,1,5,0,1,2,7,1,0,0,1,0,2,3,110010083021001,1,104,104,1,psa_21,1D2
1000000US110010089042000,"Block 2000, Block Group 2, Census Tract 89.04, District of Columbia, District of Columbia",92,0,92,0,0,0,0,0,92,92,0,92,0,0,0,0,0,0,0,0,0,0,0,0,0,110010089042000,5,507,507,5,psa_23,5D3
1000000US110010080021005,"Block 1005, Block Group 1, Census Tract 80.02, District of Columbia, District of Columbia",143,72,60,0,6,0,1,4,143,136,66,60,0,6,0,0,4,7,6,0,0,0,0,1,0,110010080021005,1,108,108,1,psa_17,1D2
1000000US110010056002009,"Block 2009, Block Group 2, Census Tract 56, District of Columbia, District of Columbia",7,1,4,0,2,0,0,0,7,7,1,4,0,2,0,0,0,0,0,0,0,0,0,0,0,110010056002009,2,207,207,2,psa_24,2D3
1000000US110010074011005,"Block 1005, Block Group 1, Census Tract 74.01, District of Columbia, District of Columbia",0,0,0,0,0,0,0,0,0,0,0,0,0,0,0,0,0,0,0,0,0,0,0,0,0,110010074011005,1,106,106,1,psa_13,1D3
1000000US110010076041004,"Block 1004, Block Group 1, Census Tract 76.04, District of Columbia, District of Columbia",76,0,73,1,0,0,0,2,76,76,0,73,1,0,0,0,2,0,0,0,0,0,0,0,0,110010076041004,6,607,607,6,psa_10,6D2
1000000US110010026002016,"Block 2016, Block Group 2, Census Tract 26, District of Columbia, District of Columbia",89,46,33,0,0,0,7,3,89,79,38,33,0,0,0,5,3,10,8,0,0,0,0,2,0,110010026002016,4,404,404,4,psa_48,4D3
1000000US110010019014006,"Block 4006, Block Group 4, Census Tract 19.01, District of Columbia, District of Columbia",0,0,0,0,0,0,0,0,0,0,0,0,0,0,0,0,0,0,0,0,0,0,0,0,0,110010019014006,4,402,402,4,psa_53,4D1
1000000US110010024002010,"Block 2010, Block Group 2, Census Tract 24, District of Columbia, District of Columbia",15,14,0,0,0,0,1,0,15,2,2,0,0,0,0,0,0,13,12,0,0,0,0,1,0,110010024002010,4,407,407,4,psa_47,4D2
1000000US110010026001021,"Block 1021, Block Group 1, Census Tract 26, District of Columbia, District of Columbia",0,0,0,0,0,0,0,0,0,0,0,0,0,0,0,0,0,0,0,0,0,0,0,0,0,110010026001021,3,302,302,3,psa_42,3D1
1000000US110010081003010,"Block 3010, Block Group 3, Census Tract 81, District of Columbia, District of Columbia",88,74,3,2,4,0,1,4,88,86,73,3,2,4,0,0,4,2,1,0,0,0,0,1,0,110010081003010,1,108,108,1,psa_17,1D2
1000000US110010074031003,"Block 1003, Block Group 1, Census Tract 74.03, District of Columbia, District of Columbia",254,0,254,0,0,0,0,0,254,254,0,254,0,0,0,0,0,0,0,0,0,0,0,0,0,110010074031003,7,704,704,7,psa_5,7D2
1000000US110010024002005,"Block 2005, Block Group 2, Census Tract 24, District of Columbia, District of Columbia",55,7,42,1,0,0,3,2,55,50,7,41,0,0,0,0,2,5,0,1,1,0,0,3,0,110010024002005,4,407,407,4,psa_47,4D2
1000000US110010032001000,"Block 1000, Block Group 1, Census Tract 32, District of Columbia, District of Columbia",0,0,0,0,0,0,0,0,0,0,0,0,0,0,0,0,0,0,0,0,0,0,0,0,0,110010032001000,4,409,409,4,psa_41,4D3
1000000US110010044001008,"Block 1008, Block Group 1, Census Tract 44, District of Columbia, District of Columbia",108,83,11,1,10,0,3,0,108,103,79,11,1,10,0,2,0,5,4,0,0,0,0,1,0,110010044001008,3,305,305,3,psa_32,3D2
1000000US110010089042003,"Block 2003, Block Group 2, Census Tract 89.04, District of Columbia, District of Columbia",62,1,61,0,0,0,0,0,62,62,1,61,0,0,0,0,0,0,0,0,0,0,0,0,0,110010089042003,5,507,507,5,psa_23,5D3
1000000US110010066001020,"Block 1020, Block Group 1, Census Tract 66, District of Columbia, District of Columbia",83,76,0,0,7,0,0,0,83,81,74,0,0,7,0,0,0,2,2,0,0,0,0,0,0,110010066001020,1,107,107,1,psa_16,1D2
1000000US110010028021005,"Block 1005, Block Group 1, Census Tract 28.02, District of Columbia, District of Columbia",300,11,268,0,7,0,7,7,300,275,4,260,0,7,0,1,3,25,7,8,0,0,0,6,4,110010028021005,3,302,302,3,psa_42,3D1
1000000US110010066001006,"Block 1006, Block Group 1, Census Tract 66, District of Columbia, District of Columbia",31,30,0,0,1,0,0,0,31,30,29,0,0,1,0,0,0,1,1,0,0,0,0,0,0,110010066001006,1,106,106,1,psa_13,1D3
1000000US110010087021006,"Block 1006, Block Group 1, Census Tract 87.02, District of Columbia, District of Columbia",117,8,99,0,1,0,6,3,117,106,7,96,0,1,0,0,2,11,1,3,0,0,0,6,1,110010087021006,5,502,502,5,psa_40,5D1
1000000US110010104002023,"Block 2023, Block Group 2, Census Tract 104, District of Columbia, District of Columbia",0,0,0,0,0,0,0,0,0,0,0,0,0,0,0,0,0,0,0,0,0,0,0,0,0,110010104002023,7,703,703,7,psa_8,7D1
1000000US110010011003001,"Block 3001, Block Group 3, Census Tract 11, District of Columbia, District of Columbia",53,49,0,0,0,0,0,4,53,50,46,0,0,0,0,0,4,3,3,0,0,0,0,0,0,110010011003001,2,201,201,2,psa_55,2D1
1000000US110010107001029,"Block 1029, Block Group 1, Census Tract 107, District of Columbia, District of Columbia",0,0,0,0,0,0,0,0,0,0,0,0,0,0,0,0,0,0,0,0,0,0,0,0,0,110010107001029,2,207,207,2,psa_24,2D3
1000000US110010007011000,"Block 1000, Block Group 1, Census Tract 7.01, District of Columbia, District of Columbia",442,312,28,10,41,0,25,26,442,363,273,23,3,40,0,4,20,79,39,5,7,1,0,21,6,110010007011000,2,204,204,2,psa_44,2D2
1000000US110010072002022,"Block 2022, Block Group 2, Census Tract 72, District of Columbia, District of Columbia",0,0,0,0,0,0,0,0,0,0,0,0,0,0,0,0,0,0,0,0,0,0,0,0,0,110010072002022,1,106,106,1,psa_13,1D3
1000000US110010073011003,"Block 1003, Block Group 1, Census Tract 73.01, District of Columbia, District of Columbia",0,0,0,0,0,0,0,0,0,0,0,0,0,0,0,0,0,0,0,0,0,0,0,0,0,110010073011003,1,105,105,1,psa_22,1D3
1000000US110010078083013,"Block 3013, Block Group 3, Census Tract 78.08, District of Columbia, District of Columbia",42,0,42,0,0,0,0,0,42,42,0,42,0,0,0,0,0,0,0,0,0,0,0,0,0,110010078083013,6,608,608,6,psa_19,6D1
1000000US110010062021104,"Block 1104, Block Group 1, Census Tract 62.02, District of Columbia, District of Columbia",0,0,0,0,0,0,0,0,0,0,0,0,0,0,0,0,0,0,0,0,0,0,0,0,0,110010062021104,1,102,102,1,psa_18,1D1
1000000US110010073011133,"Block 1133, Block Group 1, Census Tract 73.01, District of Columbia, District of Columbia",0,0,0,0,0,0,0,0,0,0,0,0,0,0,0,0,0,0,0,0,0,0,0,0,0,110010073011133,7,708,708,7,psa_1,7D3
1000000US110010096021009,"Block 1009, Block Group 1, Census Tract 96.02, District of Columbia, District of Columbia",0,0,0,0,0,0,0,0,0,0,0,0,0,0,0,0,0,0,0,0,0,0,0,0,0,110010096021009,6,601,601,6,psa_30,6D1
1000000US110010026001011,"Block 1011, Block Group 1, Census Tract 26, District of Columbia, District of Columbia",40,24,15,1,0,0,0,0,40,38,22,15,1,0,0,0,0,2,2,0,0,0,0,0,0,110010026001011,4,404,404,4,psa_48,4D3
1000000US110010056002006,"Block 2006, Block Group 2, Census Tract 56, District of Columbia, District of Columbia",1,1,0,0,0,0,0,0,1,1,1,0,0,0,0,0,0,0,0,0,0,0,0,0,0,110010056002006,2,207,207,2,psa_24,2D3
1000000US110010009012006,"Block 2006, Block Group 2, Census Tract 9.01, District of Columbia, District of Columbia",204,165,13,0,16,0,6,4,204,177,144,13,0,16,0,0,4,27,21,0,0,0,0,6,0,110010009012006,2,205,205,2,psa_46,2D2
1000000US110010098102004,"Block 2004, Block Group 2, Census Tract 98.10, District of Columbia, District of Columbia",127,0,126,1,0,0,0,0,127,124,0,123,1,0,0,0,0,3,0,3,0,0,0,0,0,110010098102004,7,708,708,7,psa_1,7D3
1000000US110010012004009,"Block 4009, Block Group 4, Census Tract 12, District of Columbia, District of Columbia",0,0,0,0,0,0,0,0,0,0,0,0,0,0,0,0,0,0,0,0,0,0,0,0,0,110010012004009,2,203,203,2,psa_50,2D1
1000000US110010042011006,"Block 1006, Block Group 1, Census Tract 42.01, District of Columbia, District of Columbia",270,194,27,0,23,0,15,11,270,233,176,26,0,23,0,0,8,37,18,1,0,0,0,15,3,110010042011006,3,301,301,3,psa_31,3D3
1000000US110010071001003,"Block 1003, Block Group 1, Census Tract 71, District of Columbia, District of Columbia",0,0,0,0,0,0,0,0,0,0,0,0,0,0,0,0,0,0,0,0,0,0,0,0,0,110010071001003,1,106,106,1,psa_13,1D3
1000000US110010078071010,"Block 1010, Block Group 1, Census Tract 78.07, District of Columbia, District of Columbia",107,0,107,0,0,0,0,0,107,107,0,107,0,0,0,0,0,0,0,0,0,0,0,0,0,110010078071010,6,608,608,6,psa_19,6D1
1000000US110010106002050,"Block 2050, Block Group 2, Census Tract 106, District of Columbia, District of Columbia",64,31,23,0,4,0,4,2,64,63,31,23,0,4,0,3,2,1,0,0,0,0,0,1,0,110010106002050,1,104,104,1,psa_21,1D2
1000000US110010034002012,"Block 2012, Block Group 2, Census Tract 34, District of Columbia, District of Columbia",64,16,40,0,0,0,2,6,64,63,16,40,0,0,0,2,5,1,0,0,0,0,0,0,1,110010034002012,3,306,306,3,psa_38,3D2
1000000US110010050023006,"Block 3006, Block Group 3, Census Tract 50.02, District of Columbia, District of Columbia",148,45,34,0,0,0,61,8,148,63,28,32,0,0,0,1,2,85,17,2,0,0,0,60,6,110010050023006,3,307,307,3,psa_28,3D3
1000000US110010073011069,"Block 1069, Block Group 1, Census Tract 73.01, District of Columbia, District of Columbia",0,0,0,0,0,0,0,0,0,0,0,0,0,0,0,0,0,0,0,0,0,0,0,0,0,110010073011069,7,707,707,7,psa_4,7D2
1000000US110010096011044,"Block 1044, Block Group 1, Census Tract 96.01, District of Columbia, District of Columbia",0,0,0,0,0,0,0,0,0,0,0,0,0,0,0,0,0,0,0,0,0,0,0,0,0,110010096011044,6,602,602,6,psa_25,6D1
1000000US110010018042000,"Block 2000, Block Group 2, Census Tract 18.04, District of Columbia, District of Columbia",581,51,426,3,16,0,66,19,581,457,9,417,0,16,0,4,11,124,42,9,3,0,0,62,8,110010018042000,4,401,401,4,psa_56,4D1
1000000US110010087022006,"Block 2006, Block Group 2, Census Tract 87.02, District of Columbia, District of Columbia",0,0,0,0,0,0,0,0,0,0,0,0,0,0,0,0,0,0,0,0,0,0,0,0,0,110010087022006,5,501,501,5,psa_35,5D1
1000000US110010104002027,"Block 2027, Block Group 2, Census Tract 104, District of Columbia, District of Columbia",323,35,284,0,0,1,0,3,323,320,34,282,0,0,1,0,3,3,1,2,0,0,0,0,0,110010104002027,7,703,703,7,psa_8,7D1
1000000US110010062021189,"Block 1189, Block Group 1, Census Tract 62.02, District of Columbia, District of Columbia",0,0,0,0,0,0,0,0,0,0,0,0,0,0,0,0,0,0,0,0,0,0,0,0,0,110010062021189,1,103,103,1,psa_12,1D1
1000000US110010072002014,"Block 2014, Block Group 2, Census Tract 72, District of Columbia, District of Columbia",0,0,0,0,0,0,0,0,0,0,0,0,0,0,0,0,0,0,0,0,0,0,0,0,0,110010072002014,1,106,106,1,psa_13,1D3
1000000US110010111001027,"Block 1027, Block Group 1, Census Tract 111, District of Columbia, District of Columbia",0,0,0,0,0,0,0,0,0,0,0,0,0,0,0,0,0,0,0,0,0,0,0,0,0,110010111001027,5,503,503,5,psa_45,5D2
1000000US110010065002015,"Block 2015, Block Group 2, Census Tract 65, District of Columbia, District of Columbia",117,105,8,0,4,0,0,0,117,112,100,8,0,4,0,0,0,5,5,0,0,0,0,0,0,110010065002015,1,106,106,1,psa_13,1D3
1000000US110010034002019,"Block 2019, Block Group 2, Census Tract 34, District of Columbia, District of Columbia",81,43,28,0,8,0,0,2,81,77,39,28,0,8,0,0,2,4,4,0,0,0,0,0,0,110010034002019,3,306,306,3,psa_38,3D2
1000000US110010032003000,"Block 3000, Block Group 3, Census Tract 32, District of Columbia, District of Columbia",71,15,55,0,1,0,0,0,71,70,14,55,0,1,0,0,0,1,1,0,0,0,0,0,0,110010032003000,4,409,409,4,psa_41,4D3
1000000US110010053013007,"Block 3007, Block Group 3, Census Tract 53.01, District of Columbia, District of Columbia",0,0,0,0,0,0,0,0,0,0,0,0,0,0,0,0,0,0,0,0,0,0,0,0,0,110010053013007,2,208,208,2,psa_33,2D3
1000000US110010099012004,"Block 2004, Block Group 2, Census Tract 99.01, District of Columbia, District of Columbia",31,0,30,0,0,0,0,1,31,31,0,30,0,0,0,0,1,0,0,0,0,0,0,0,0,110010099012004,6,605,605,6,psa_11,6D2
1000000US110010101002002,"Block 2002, Block Group 2, Census Tract 101, District of Columbia, District of Columbia",0,0,0,0,0,0,0,0,0,0,0,0,0,0,0,0,0,0,0,0,0,0,0,0,0,110010101002002,2,207,207,2,psa_24,2D3
1000000US110010111003045,"Block 3045, Block Group 3, Census Tract 111, District of Columbia, District of Columbia",0,0,0,0,0,0,0,0,0,0,0,0,0,0,0,0,0,0,0,0,0,0,0,0,0,110010111003045,5,503,503,5,psa_45,5D2
1000000US110010027022007,"Block 2007, Block Group 2, Census Tract 27.02, District of Columbia, District of Columbia",295,147,129,2,4,0,2,11,295,283,142,126,2,4,0,0,9,12,5,3,0,0,0,2,2,110010027022007,3,302,302,3,psa_42,3D1
1000000US110010056003006,"Block 3006, Block Group 3, Census Tract 56, District of Columbia, District of Columbia",0,0,0,0,0,0,0,0,0,0,0,0,0,0,0,0,0,0,0,0,0,0,0,0,0,110010056003006,2,207,207,2,psa_24,2D3
1000000US110010095092009,"Block 2009, Block Group 2, Census Tract 95.09, District of Columbia, District of Columbia",73,5,65,0,3,0,0,0,73,73,5,65,0,3,0,0,0,0,0,0,0,0,0,0,0,110010095092009,4,405,405,4,psa_49,4D2
1000000US110010021011009,"Block 1009, Block Group 1, Census Tract 21.01, District of Columbia, District of Columbia",307,18,190,0,0,0,75,24,307,191,7,182,0,0,0,0,2,116,11,8,0,0,0,75,22,110010021011009,4,403,403,4,psa_51,4D1
1000000US110010032004004,"Block 4004, Block Group 4, Census Tract 32, District of Columbia, District of Columbia",170,34,106,0,3,0,25,2,170,124,22,96,0,3,0,1,2,46,12,10,0,0,0,24,0,110010032004004,4,409,409,4,psa_41,4D3
1000000US110010099011012,"Block 1012, Block Group 1, Census Tract 99.01, District of Columbia, District of Columbia",44,4,40,0,0,0,0,0,44,44,4,40,0,0,0,0,0,0,0,0,0,0,0,0,0,110010099011012,6,605,605,6,psa_11,6D2
1000000US110010006004021,"Block 4021, Block Group 4, Census Tract 6, District of Columbia, District of Columbia",124,98,10,0,11,0,0,5,124,111,88,10,0,11,0,0,2,13,10,0,0,0,0,0,3,110010006004021,2,203,203,2,psa_50,2D1
1000000US110010008013019,"Block 3019, Block Group 3, Census Tract 8.01, District of Columbia, District of Columbia",18,17,0,0,1,0,0,0,18,18,17,0,0,1,0,0,0,0,0,0,0,0,0,0,0,110010008013019,2,205,205,2,psa_46,2D2
1000000US110010076051004,"Block 1004, Block Group 1, Census Tract 76.05, District of Columbia, District of Columbia",13,1,11,0,1,0,0,0,13,13,1,11,0,1,0,0,0,0,0,0,0,0,0,0,0,110010076051004,6,607,607,6,psa_10,6D2
1000000US110010006002009,"Block 2009, Block Group 2, Census Tract 6, District of Columbia, District of Columbia",57,48,0,0,5,0,0,4,57,52,43,0,0,5,0,0,4,5,5,0,0,0,0,0,0,110010006002009,2,204,204,2,psa_44,2D2
1000000US110010042021009,"Block 1009, Block Group 1, Census Tract 42.02, District of Columbia, District of Columbia",0,0,0,0,0,0,0,0,0,0,0,0,0,0,0,0,0,0,0,0,0,0,0,0,0,110010042021009,3,301,301,3,psa_31,3D3
1000000US110010048021000,"Block 1000, Block Group 1, Census Tract 48.02, District of Columbia, District of Columbia",377,0,365,3,3,0,0,6,377,374,0,363,3,3,0,0,5,3,0,2,0,0,0,0,1,110010048021000,3,308,308,3,psa_27,3D2
1000000US110010099052007,"Block 2007, Block Group 2, Census Tract 99.05, District of Columbia, District of Columbia",6,0,6,0,0,0,0,0,6,6,0,6,0,0,0,0,0,0,0,0,0,0,0,0,0,110010099052007,6,604,604,6,psa_14,6D3
1000000US110010078032006,"Block 2006, Block Group 2, Census Tract 78.03, District of Columbia, District of Columbia",83,0,81,0,0,0,0,2,83,83,0,81,0,0,0,0,2,0,0,0,0,0,0,0,0,110010078032006,6,602,602,6,psa_25,6D1
1000000US110010014012009,"Block 2009, Block Group 2, Census Tract 14.01, District of Columbia, District of Columbia",1,1,0,0,0,0,0,0,1,1,1,0,0,0,0,0,0,0,0,0,0,0,0,0,0,110010014012009,2,201,201,2,psa_55,2D1
1000000US110010024001006,"Block 1006, Block Group 1, Census Tract 24, District of Columbia, District of Columbia",33,2,9,0,0,0,22,0,33,10,2,8,0,0,0,0,0,23,0,1,0,0,0,22,0,110010024001006,4,407,407,4,psa_47,4D2
1000000US110010077091024,"Block 1024, Block Group 1, Census Tract 77.09, District of Columbia, District of Columbia",193,4,182,1,0,0,1,5,193,191,3,182,0,0,0,1,5,2,1,0,1,0,0,0,0,110010077091024,6,605,605,6,psa_11,6D2
1000000US110010108002019,"Block 2019, Block Group 2, Census Tract 108.00, District of Columbia, District of Columbia",0,0,0,0,0,0,0,0,0,0,0,0,0,0,0,0,0,0,0,0,0,0,0,0,0,110010108002019,2,207,207,2,psa_24,2D3
1000000US110010039002003,"Block 2003, Block Group 2, Census Tract 39, District of Columbia, District of Columbia",257,194,29,1,12,0,11,10,257,230,180,29,1,12,0,0,8,27,14,0,0,0,0,11,2,110010039002003,3,303,303,3,psa_37,3D3
1000000US110010076053002,"Block 3002, Block Group 3, Census Tract 76.05, District of Columbia, District of Columbia",0,0,0,0,0,0,0,0,0,0,0,0,0,0,0,0,0,0,0,0,0,0,0,0,0,110010076053002,6,607,607,6,psa_10,6D2
1000000US110010009022032,"Block 2032, Block Group 2, Census Tract 9.02, District of Columbia, District of Columbia",83,63,8,0,8,0,0,4,83,81,61,8,0,8,0,0,4,2,2,0,0,0,0,0,0,110010009022032,2,205,205,2,psa_46,2D2
1000000US110010074041008,"Block 1008, Block Group 1, Census Tract 74.04, District of Columbia, District of Columbia",118,1,114,0,0,0,2,1,118,110,1,109,0,0,0,0,0,8,0,5,0,0,0,2,1,110010074041008,7,704,704,7,psa_5,7D2
1000000US110010094002023,"Block 2023, Block Group 2, Census Tract 94, District of Columbia, District of Columbia",0,0,0,0,0,0,0,0,0,0,0,0,0,0,0,0,0,0,0,0,0,0,0,0,0,110010094002023,5,504,504,5,psa_43,5D2
1000000US110010012004024,"Block 4024, Block Group 4, Census Tract 12, District of Columbia, District of Columbia",0,0,0,0,0,0,0,0,0,0,0,0,0,0,0,0,0,0,0,0,0,0,0,0,0,110010012004024,2,202,202,2,psa_52,2D1
1000000US110010037001003,"Block 1003, Block Group 1, Census Tract 37, District of Columbia, District of Columbia",206,23,116,1,0,0,49,17,206,100,4,95,1,0,0,0,0,106,19,21,0,0,0,49,17,110010037001003,3,304,304,3,psa_36,3D1
1000000US110010010011001,"Block 1001, Block Group 1, Census Tract 10.01, District of Columbia, District of Columbia",1,0,1,0,0,0,0,0,1,1,0,1,0,0,0,0,0,0,0,0,0,0,0,0,0,110010010011001,2,202,202,2,psa_52,2D1
1000000US110010064002013,"Block 2013, Block Group 2, Census Tract 64, District of Columbia, District of Columbia",0,0,0,0,0,0,0,0,0,0,0,0,0,0,0,0,0,0,0,0,0,0,0,0,0,110010064002013,1,105,105,1,psa_22,1D3
1000000US110010108001007,"Block 1007, Block Group 1, Census Tract 108.00, District of Columbia, District of Columbia",470,400,17,0,37,0,0,16,470,469,400,17,0,37,0,0,15,1,0,0,0,0,0,0,1,110010108001007,2,207,207,2,psa_24,2D3
1000000US110010039002010,"Block 2010, Block Group 2, Census Tract 39, District of Columbia, District of Columbia",341,285,16,1,19,0,11,9,341,311,266,16,1,19,0,1,8,30,19,0,0,0,0,10,1,110010039002010,3,303,303,3,psa_37,3D3
1000000US110010077071007,"Block 1007, Block Group 1, Census Tract 77.07, District of Columbia, District of Columbia",72,0,70,2,0,0,0,0,72,71,0,69,2,0,0,0,0,1,0,1,0,0,0,0,0,110010077071007,6,604,604,6,psa_14,6D3
1000000US110010095041016,"Block 1016, Block Group 1, Census Tract 95.04, District of Columbia, District of Columbia",0,0,0,0,0,0,0,0,0,0,0,0,0,0,0,0,0,0,0,0,0,0,0,0,0,110010095041016,4,405,405,4,psa_49,4D2
1000000US110010099022004,"Block 2004, Block Group 2, Census Tract 99.02, District of Columbia, District of Columbia",89,1,88,0,0,0,0,0,89,88,1,87,0,0,0,0,0,1,0,1,0,0,0,0,0,110010099022004,6,605,605,6,psa_11,6D2
1000000US110010064001001,"Block 1001, Block Group 1, Census Tract 64, District of Columbia, District of Columbia",126,36,76,1,8,0,0,5,126,121,34,73,1,8,0,0,5,5,2,3,0,0,0,0,0,110010064001001,1,105,105,1,psa_22,1D3
1000000US110010098112004,"Block 2004, Block Group 2, Census Tract 98.11, District of Columbia, District of Columbia",109,0,105,0,0,0,1,3,109,108,0,105,0,0,0,0,3,1,0,0,0,0,0,1,0,110010098112004,7,706,706,7,psa_2,7D3
1000000US110010020012005,"Block 2005, Block Group 2, Census Tract 20.01, District of Columbia, District of Columbia",98,29,60,0,0,0,9,0,98,76,16,60,0,0,0,0,0,22,13,0,0,0,0,9,0,110010020012005,4,403,403,4,psa_51,4D1
1000000US110010066001013,"Block 1013, Block Group 1, Census Tract 66, District of Columbia, District of Columbia",0,0,0,0,0,0,0,0,0,0,0,0,0,0,0,0,0,0,0,0,0,0,0,0,0,110010066001013,1,106,106,1,psa_13,1D3
1000000US110010083012005,"Block 2005, Block Group 2, Census Tract 83.01, District of Columbia, District of Columbia",168,130,31,2,3,0,0,2,168,167,130,30,2,3,0,0,2,1,0,1,0,0,0,0,0,110010083012005,1,108,108,1,psa_17,1D2
1000000US110010099031000,"Block 1000, Block Group 1, Census Tract 99.03, District of Columbia, District of Columbia",404,8,379,2,0,0,3,12,404,398,7,375,1,0,0,3,12,6,1,4,1,0,0,0,0,110010099031000,6,604,604,6,psa_14,6D3
1000000US110010023012001,"Block 2001, Block Group 2, Census Tract 23.01, District of Columbia, District of Columbia",0,0,0,0,0,0,0,0,0,0,0,0,0,0,0,0,0,0,0,0,0,0,0,0,0,110010023012001,4,407,407,4,psa_47,4D2
1000000US110010044002005,"Block 2005, Block Group 2, Census Tract 44, District of Columbia, District of Columbia",80,44,30,1,3,0,0,2,80,78,42,30,1,3,0,0,2,2,2,0,0,0,0,0,0,110010044002005,3,305,305,3,psa_32,3D2
1000000US110010004001003,"Block 1003, Block Group 1, Census Tract 4, District of Columbia, District of Columbia",21,21,0,0,0,0,0,0,21,18,18,0,0,0,0,0,0,3,3,0,0,0,0,0,0,110010004001003,2,204,204,2,psa_44,2D2
1000000US110010066001012,"Block 1012, Block Group 1, Census Tract 66, District of Columbia, District of Columbia",8,8,0,0,0,0,0,0,8,8,8,0,0,0,0,0,0,0,0,0,0,0,0,0,0,110010066001012,1,106,106,1,psa_13,1D3
1000000US110010020021000,"Block 1000, Block Group 1, Census Tract 20.02, District of Columbia, District of Columbia",26,8,15,0,0,0,0,3,26,26,8,15,0,0,0,0,3,0,0,0,0,0,0,0,0,110010020021000,4,403,403,4,psa_51,4D1
1000000US110010078083010,"Block 3010, Block Group 3, Census Tract 78.08, District of Columbia, District of Columbia",28,0,28,0,0,0,0,0,28,28,0,28,0,0,0,0,0,0,0,0,0,0,0,0,0,110010078083010,6,608,608,6,psa_19,6D1
1000000US110010010012018,"Block 2018, Block Group 2, Census Tract 10.01, District of Columbia, District of Columbia",70,51,2,0,7,0,3,7,70,67,51,2,0,7,0,3,4,3,0,0,0,0,0,0,3,110010010012018,2,202,202,2,psa_52,2D1
1000000US110010077091007,"Block 1007, Block Group 1, Census Tract 77.09, District of Columbia, District of Columbia",0,0,0,0,0,0,0,0,0,0,0,0,0,0,0,0,0,0,0,0,0,0,0,0,0,110010077091007,6,605,605,6,psa_11,6D2
1000000US110010014012015,"Block 2015, Block Group 2, Census Tract 14.01, District of Columbia, District of Columbia",54,45,0,0,3,0,0,6,54,54,45,0,0,3,0,0,6,0,0,0,0,0,0,0,0,110010014012015,2,201,201,2,psa_55,2D1
1000000US110010102001014,"Block 1014, Block Group 1, Census Tract 102, District of Columbia, District of Columbia",0,0,0,0,0,0,0,0,0,0,0,0,0,0,0,0,0,0,0,0,0,0,0,0,0,110010102001014,1,103,103,1,psa_12,1D1
1000000US110010083021009,"Block 1009, Block Group 1, Census Tract 83.02, District of Columbia, District of Columbia",188,144,23,0,10,0,1,10,188,182,138,23,0,10,0,1,10,6,6,0,0,0,0,0,0,110010083021009,1,104,104,1,psa_21,1D2
1000000US110010096033004,"Block 3004, Block Group 3, Census Tract 96.03, District of Columbia, District of Columbia",121,0,119,0,0,0,1,1,121,120,0,119,0,0,0,0,1,1,0,0,0,0,0,1,0,110010096033004,6,603,603,6,psa_15,6D3
1000000US110010103003004,"Block 3004, Block Group 3, Census Tract 103, District of Columbia, District of Columbia",8,0,8,0,0,0,0,0,8,8,0,8,0,0,0,0,0,0,0,0,0,0,0,0,0,110010103003004,4,401,401,4,psa_56,4D1
1000000US110010010013004,"Block 3004, Block Group 3, Census Tract 10.01, District of Columbia, District of Columbia",53,44,0,0,1,0,5,3,53,48,44,0,0,1,0,0,3,5,0,0,0,0,0,5,0,110010010013004,2,202,202,2,psa_52,2D1
1000000US110010068041004,"Block 1004, Block Group 1, Census Tract 68.04, District of Columbia, District of Columbia",0,0,0,0,0,0,0,0,0,0,0,0,0,0,0,0,0,0,0,0,0,0,0,0,0,110010068041004,1,108,108,1,psa_17,1D2
1000000US110010095032012,"Block 2012, Block Group 2, Census Tract 95.03, District of Columbia, District of Columbia",21,4,17,0,0,0,0,0,21,20,3,17,0,0,0,0,0,1,1,0,0,0,0,0,0,110010095032012,5,504,504,5,psa_43,5D2
1000000US110010021012001,"Block 2001, Block Group 2, Census Tract 21.01, District of Columbia, District of Columbia",284,42,140,2,9,0,75,16,284,172,20,134,2,9,0,1,6,112,22,6,0,0,0,74,10,110010021012001,4,403,403,4,psa_51,4D1
1000000US110010013022010,"Block 2010, Block Group 2, Census Tract 13.02, District of Columbia, District of Columbia",0,0,0,0,0,0,0,0,0,0,0,0,0,0,0,0,0,0,0,0,0,0,0,0,0,110010013022010,2,203,203,2,psa_50,2D1
1000000US110010105002015,"Block 2015, Block Group 2, Census Tract 105, District of Columbia, District of Columbia",0,0,0,0,0,0,0,0,0,0,0,0,0,0,0,0,0,0,0,0,0,0,0,0,0,110010105002015,1,103,103,1,psa_12,1D1
1000000US110010108002002,"Block 2002, Block Group 2, Census Tract 108.00, District of Columbia, District of Columbia",3,1,2,0,0,0,0,0,3,3,1,2,0,0,0,0,0,0,0,0,0,0,0,0,0,110010108002002,2,207,207,2,psa_24,2D3
1000000US110010023011004,"Block 1004, Block Group 1, Census Tract 23.01, District of Columbia, District of Columbia",13,6,7,0,0,0,0,0,13,13,6,7,0,0,0,0,0,0,0,0,0,0,0,0,0,110010023011004,4,407,407,4,psa_47,4D2
1000000US110010023012012,"Block 2012, Block Group 2, Census Tract 23.01, District of Columbia, District of Columbia",155,36,86,5,1,0,5,22,155,123,34,86,0,1,0,0,2,32,2,0,5,0,0,5,20,110010023012012,4,407,407,4,psa_47,4D2
1000000US110010062021251,"Block 1251, Block Group 1, Census Tract 62.02, District of Columbia, District of Columbia",0,0,0,0,0,0,0,0,0,0,0,0,0,0,0,0,0,0,0,0,0,0,0,0,0,110010062021251,2,207,207,2,psa_24,2D3
1000000US110010041002008,"Block 2008, Block Group 2, Census Tract 41, District of Columbia, District of Columbia",0,0,0,0,0,0,0,0,0,0,0,0,0,0,0,0,0,0,0,0,0,0,0,0,0,110010041002008,2,208,208,2,psa_33,2D3
1000000US110010095092010,"Block 2010, Block Group 2, Census Tract 95.09, District of Columbia, District of Columbia",135,14,112,0,0,0,3,6,135,119,7,112,0,0,0,0,0,16,7,0,0,0,0,3,6,110010095092010,4,405,405,4,psa_49,4D2
1000000US110010062021077,"Block 1077, Block Group 1, Census Tract 62.02, District of Columbia, District of Columbia",0,0,0,0,0,0,0,0,0,0,0,0,0,0,0,0,0,0,0,0,0,0,0,0,0,110010062021077,2,207,207,2,psa_24,2D3
1000000US110010023021028,"Block 1028, Block Group 1, Census Tract 23.02, District of Columbia, District of Columbia",0,0,0,0,0,0,0,0,0,0,0,0,0,0,0,0,0,0,0,0,0,0,0,0,0,110010023021028,4,405,405,4,psa_49,4D2
1000000US110010025012001,"Block 2001, Block Group 2, Census Tract 25.01, District of Columbia, District of Columbia",74,24,49,0,0,0,1,0,74,70,20,49,0,0,0,1,0,4,4,0,0,0,0,0,0,110010025012001,4,404,404,4,psa_48,4D3
1000000US110010095053010,"Block 3010, Block Group 3, Census Tract 95.05, District of Columbia, District of Columbia",14,0,14,0,0,0,0,0,14,14,0,14,0,0,0,0,0,0,0,0,0,0,0,0,0,110010095053010,4,406,406,4,psa_54,4D2
1000000US110010018031007,"Block 1007, Block Group 1, Census Tract 18.03, District of Columbia, District of Columbia",59,9,50,0,0,0,0,0,59,59,9,50,0,0,0,0,0,0,0,0,0,0,0,0,0,110010018031007,4,402,402,4,psa_53,4D1
1000000US110010062021037,"Block 1037, Block Group 1, Census Tract 62.02, District of Columbia, District of Columbia",0,0,0,0,0,0,0,0,0,0,0,0,0,0,0,0,0,0,0,0,0,0,0,0,0,110010062021037,2,207,207,2,psa_24,2D3
1000000US110010058001023,"Block 1023, Block Group 1, Census Tract 58, District of Columbia, District of Columbia",298,237,12,2,39,0,0,8,298,286,225,12,2,39,0,0,8,12,12,0,0,0,0,0,0,110010058001023,2,209,209,2,psa_57,2D3
1000000US110010058002011,"Block 2011, Block Group 2, Census Tract 58, District of Columbia, District of Columbia",0,0,0,0,0,0,0,0,0,0,0,0,0,0,0,0,0,0,0,0,0,0,0,0,0,110010058002011,1,102,102,1,psa_18,1D1
1000000US110010073043002,"Block 3002, Block Group 3, Census Tract 73.04, District of Columbia, District of Columbia",51,4,42,0,0,0,2,3,51,47,4,42,0,0,0,1,0,4,0,0,0,0,0,1,3,110010073043002,7,705,705,7,psa_3,7D2
1000000US110010092032005,"Block 2005, Block Group 2, Census Tract 92.03, District of Columbia, District of Columbia",55,12,40,0,1,0,2,0,55,52,9,40,0,1,0,2,0,3,3,0,0,0,0,0,0,110010092032005,5,502,502,5,psa_40,5D1
1000000US110010027014000,"Block 4000, Block Group 4, Census Tract 27.01, District of Columbia, District of Columbia",1929,707,628,17,84,0,403,90,1929,1116,361,603,12,78,0,16,46,813,346,25,5,6,0,387,44,110010027014000,3,302,302,3,psa_42,3D1
1000000US110010073011008,"Block 1008, Block Group 1, Census Tract 73.01, District of Columbia, District of Columbia",0,0,0,0,0,0,0,0,0,0,0,0,0,0,0,0,0,0,0,0,0,0,0,0,0,110010073011008,7,703,703,7,psa_8,7D1
1000000US110010078061014,"Block 1014, Block Group 1, Census Tract 78.06, District of Columbia, District of Columbia",53,1,51,0,0,0,1,0,53,52,1,51,0,0,0,0,0,1,0,0,0,0,0,1,0,110010078061014,6,602,602,6,psa_25,6D1
1000000US110010071001021,"Block 1021, Block Group 1, Census Tract 71, District of Columbia, District of Columbia",0,0,0,0,0,0,0,0,0,0,0,0,0,0,0,0,0,0,0,0,0,0,0,0,0,110010071001021,1,106,106,1,psa_13,1D3
1000000US110010078031013,"Block 1013, Block Group 1, Census Tract 78.03, District of Columbia, District of Columbia",225,3,217,3,0,0,0,2,225,224,3,216,3,0,0,0,2,1,0,1,0,0,0,0,0,110010078031013,6,602,602,6,psa_25,6D1
1000000US110010038003000,"Block 3000, Block Group 3, Census Tract 38, District of Columbia, District of Columbia",0,0,0,0,0,0,0,0,0,0,0,0,0,0,0,0,0,0,0,0,0,0,0,0,0,110010038003000,3,303,303,3,psa_37,3D3
1000000US110010008013035,"Block 3035, Block Group 3, Census Tract 8.01, District of Columbia, District of Columbia",11,10,0,0,1,0,0,0,11,11,10,0,0,1,0,0,0,0,0,0,0,0,0,0,0,110010008013035,2,205,205,2,psa_46,2D2
1000000US110010107002004,"Block 2004, Block Group 2, Census Tract 107, District of Columbia, District of Columbia",0,0,0,0,0,0,0,0,0,0,0,0,0,0,0,0,0,0,0,0,0,0,0,0,0,110010107002004,2,208,208,2,psa_33,2D3
1000000US110010010012017,"Block 2017, Block Group 2, Census Tract 10.01, District of Columbia, District of Columbia",66,55,4,0,3,0,0,4,66,63,52,4,0,3,0,0,4,3,3,0,0,0,0,0,0,110010010012017,2,202,202,2,psa_52,2D1
1000000US110010109002022,"Block 2022, Block Group 2, Census Tract 109, District of Columbia, District of Columbia",0,0,0,0,0,0,0,0,0,0,0,0,0,0,0,0,0,0,0,0,0,0,0,0,0,110010109002022,7,708,708,7,psa_1,7D3
1000000US110010049012014,"Block 2014, Block Group 2, Census Tract 49.01, District of Columbia, District of Columbia",152,101,41,1,8,0,0,1,152,147,96,41,1,8,0,0,1,5,5,0,0,0,0,0,0,110010049012014,3,307,307,3,psa_28,3D3
1000000US110010033022000,"Block 2000, Block Group 2, Census Tract 33.02, District of Columbia, District of Columbia",249,91,142,0,3,0,6,7,249,238,88,141,0,3,0,1,5,11,3,1,0,0,0,5,2,110010033022000,3,308,308,3,psa_27,3D2
1000000US110010111003048,"Block 3048, Block Group 3, Census Tract 111, District of Columbia, District of Columbia",0,0,0,0,0,0,0,0,0,0,0,0,0,0,0,0,0,0,0,0,0,0,0,0,0,110010111003048,5,503,503,5,psa_45,5D2
1000000US110010010013003,"Block 3003, Block Group 3, Census Tract 10.01, District of Columbia, District of Columbia",64,56,0,0,3,0,0,5,64,64,56,0,0,3,0,0,5,0,0,0,0,0,0,0,0,110010010013003,2,202,202,2,psa_52,2D1
1000000US110010044001004,"Block 1004, Block Group 1, Census Tract 44, District of Columbia, District of Columbia",114,81,18,0,7,0,4,4,114,106,77,17,0,7,0,1,4,8,4,1,0,0,0,3,0,110010044001004,3,305,305,3,psa_32,3D2
1000000US110010088024003,"Block 4003, Block Group 4, Census Tract 88.02, District of Columbia, District of Columbia",220,14,206,0,0,0,0,0,220,219,14,205,0,0,0,0,0,1,0,1,0,0,0,0,0,110010088024003,5,506,506,5,psa_26,5D3
1000000US110010093021013,"Block 1013, Block Group 1, Census Tract 93.02, District of Columbia, District of Columbia",71,2,62,1,3,0,0,3,71,68,2,59,1,3,0,0,3,3,0,3,0,0,0,0,0,110010093021013,5,504,504,5,psa_43,5D2
1000000US110010019014010,"Block 4010, Block Group 4, Census Tract 19.01, District of Columbia, District of Columbia",29,5,24,0,0,0,0,0,29,28,4,24,0,0,0,0,0,1,1,0,0,0,0,0,0,110010019014010,4,402,402,4,psa_53,4D1
1000000US110010009012011,"Block 2011, Block Group 2, Census Tract 9.01, District of Columbia, District of Columbia",108,102,0,0,3,0,3,0,108,94,91,0,0,3,0,0,0,14,11,0,0,0,0,3,0,110010009012011,2,205,205,2,psa_46,2D2
1000000US110010055001005,"Block 1005, Block Group 1, Census Tract 55, District of Columbia, District of Columbia",75,63,1,0,10,0,0,1,75,73,61,1,0,10,0,0,1,2,2,0,0,0,0,0,0,110010055001005,2,208,208,2,psa_33,2D3
1000000US110010073011089,"Block 1089, Block Group 1, Census Tract 73.01, District of Columbia, District of Columbia",0,0,0,0,0,0,0,0,0,0,0,0,0,0,0,0,0,0,0,0,0,0,0,0,0,110010073011089,7,707,707,7,psa_4,7D2
1000000US110010019014002,"Block 4002, Block Group 4, Census Tract 19.01, District of Columbia, District of Columbia",46,11,34,0,0,0,0,1,46,40,7,33,0,0,0,0,0,6,4,1,0,0,0,0,1,110010019014002,4,402,402,4,psa_53,4D1
1000000US110010068041002,"Block 1002, Block Group 1, Census Tract 68.04, District of Columbia, District of Columbia",0,0,0,0,0,0,0,0,0,0,0,0,0,0,0,0,0,0,0,0,0,0,0,0,0,110010068041002,5,507,507,5,psa_23,5D3
1000000US110010073011141,"Block 1141, Block Group 1, Census Tract 73.01, District of Columbia, District of Columbia",12,10,2,0,0,0,0,0,12,11,10,1,0,0,0,0,0,1,0,1,0,0,0,0,0,110010073011141,7,707,707,7,psa_4,7D2
1000000US110010013012001,"Block 2001, Block Group 2, Census Tract 13.01, District of Columbia, District of Columbia",37,28,5,0,1,0,3,0,37,37,28,5,0,1,0,3,0,0,0,0,0,0,0,0,0,110010013012001,2,203,203,2,psa_50,2D1
1000000US110010021011008,"Block 1008, Block Group 1, Census Tract 21.01, District of Columbia, District of Columbia",145,3,119,0,8,0,11,4,145,124,3,113,0,8,0,0,0,21,0,6,0,0,0,11,4,110010021011008,4,403,403,4,psa_51,4D1
1000000US110010102002009,"Block 2009, Block Group 2, Census Tract 102, District of Columbia, District of Columbia",0,0,0,0,0,0,0,0,0,0,0,0,0,0,0,0,0,0,0,0,0,0,0,0,0,110010102002009,1,103,103,1,psa_12,1D1
1000000US110010110002005,"Block 2005, Block Group 2, Census Tract 110, District of Columbia, District of Columbia",58,50,5,0,1,1,1,0,58,55,48,5,0,1,1,0,0,3,2,0,0,0,0,1,0,110010110002005,1,105,105,1,psa_22,1D3
1000000US110010107002007,"Block 2007, Block Group 2, Census Tract 107, District of Columbia, District of Columbia",0,0,0,0,0,0,0,0,0,0,0,0,0,0,0,0,0,0,0,0,0,0,0,0,0,110010107002007,2,208,208,2,psa_33,2D3
1000000US110010110002007,"Block 2007, Block Group 2, Census Tract 110, District of Columbia, District of Columbia",26,22,3,0,0,1,0,0,26,25,21,3,0,0,1,0,0,1,1,0,0,0,0,0,0,110010110002007,1,105,105,1,psa_22,1D3
1000000US110010010016003,"Block 6003, Block Group 6, Census Tract 10.01, District of Columbia, District of Columbia",57,49,4,1,3,0,0,0,57,51,43,4,1,3,0,0,0,6,6,0,0,0,0,0,0,110010010016003,2,202,202,2,psa_52,2D1
1000000US110010096022007,"Block 2007, Block Group 2, Census Tract 96.02, District of Columbia, District of Columbia",0,0,0,0,0,0,0,0,0,0,0,0,0,0,0,0,0,0,0,0,0,0,0,0,0,110010096022007,6,601,601,6,psa_30,6D1
1000000US110010017021013,"Block 1013, Block Group 1, Census Tract 17.02, District of Columbia, District of Columbia",35,13,17,0,1,0,0,4,35,35,13,17,0,1,0,0,4,0,0,0,0,0,0,0,0,110010017021013,4,401,401,4,psa_56,4D1
1000000US110010075041000,"Block 1000, Block Group 1, Census Tract 75.04, District of Columbia, District of Columbia",197,1,193,0,0,0,0,3,197,197,1,193,0,0,0,0,3,0,0,0,0,0,0,0,0,110010075041000,7,701,701,7,psa_9,7D1
1000000US110010010015006,"Block 5006, Block Group 5, Census Tract 10.01, District of Columbia, District of Columbia",0,0,0,0,0,0,0,0,0,0,0,0,0,0,0,0,0,0,0,0,0,0,0,0,0,110010010015006,2,202,202,2,psa_52,2D1
1000000US110010098041000,"Block 1000, Block Group 1, Census Tract 98.04, District of Columbia, District of Columbia",138,2,136,0,0,0,0,0,138,138,2,136,0,0,0,0,0,0,0,0,0,0,0,0,0,110010098041000,7,705,705,7,psa_3,7D2
1000000US110010015004015,"Block 4015, Block Group 4, Census Tract 15, District of Columbia, District of Columbia",59,48,6,1,0,1,0,3,59,57,47,6,1,0,1,0,2,2,1,0,0,0,0,0,1,110010015004015,2,201,201,2,psa_55,2D1
1000000US110010025011010,"Block 1010, Block Group 1, Census Tract 25.01, District of Columbia, District of Columbia",55,7,37,0,1,0,8,2,55,42,2,37,0,1,0,0,2,13,5,0,0,0,0,8,0,110010025011010,4,404,404,4,psa_48,4D3
1000000US110010096021019,"Block 1019, Block Group 1, Census Tract 96.02, District of Columbia, District of Columbia",0,0,0,0,0,0,0,0,0,0,0,0,0,0,0,0,0,0,0,0,0,0,0,0,0,110010096021019,6,601,601,6,psa_30,6D1
1000000US110010009021005,"Block 1005, Block Group 1, Census Tract 9.02, District of Columbia, District of Columbia",29,23,5,0,0,0,0,1,29,27,21,5,0,0,0,0,1,2,2,0,0,0,0,0,0,110010009021005,2,205,205,2,psa_46,2D2
1000000US110010004001007,"Block 1007, Block Group 1, Census Tract 4, District of Columbia, District of Columbia",38,36,1,0,0,0,0,1,38,37,35,1,0,0,0,0,1,1,1,0,0,0,0,0,0,110010004001007,2,204,204,2,psa_44,2D2
1000000US110010106002036,"Block 2036, Block Group 2, Census Tract 106, District of Columbia, District of Columbia",49,29,14,0,2,0,1,3,49,47,28,14,0,2,0,0,3,2,1,0,0,0,0,1,0,110010106002036,5,501,501,5,psa_35,5D1
1000000US110010026002017,"Block 2017, Block Group 2, Census Tract 26, District of Columbia, District of Columbia",47,24,20,0,0,0,0,3,47,45,22,20,0,0,0,0,3,2,2,0,0,0,0,0,0,110010026002017,4,404,404,4,psa_48,4D3
1000000US110010077034000,"Block 4000, Block Group 4, Census Tract 77.03, District of Columbia, District of Columbia",121,0,121,0,0,0,0,0,121,121,0,121,0,0,0,0,0,0,0,0,0,0,0,0,0,110010077034000,6,603,603,6,psa_15,6D3
1000000US110010019022005,"Block 2005, Block Group 2, Census Tract 19.02, District of Columbia, District of Columbia",48,9,31,0,0,0,0,8,48,42,8,31,0,0,0,0,3,6,1,0,0,0,0,0,5,110010019022005,4,406,406,4,psa_54,4D2
1000000US110010088031001,"Block 1001, Block Group 1, Census Tract 88.03, District of Columbia, District of Columbia",0,0,0,0,0,0,0,0,0,0,0,0,0,0,0,0,0,0,0,0,0,0,0,0,0,110010088031001,5,506,506,5,psa_26,5D3
1000000US110010062021173,"Block 1173, Block Group 1, Census Tract 62.02, District of Columbia, District of Columbia",0,0,0,0,0,0,0,0,0,0,0,0,0,0,0,0,0,0,0,0,0,0,0,0,0,110010062021173,2,207,207,2,psa_24,2D3
1000000US110010026001000,"Block 1000, Block Group 1, Census Tract 26, District of Columbia, District of Columbia",42,9,21,0,0,0,11,1,42,33,9,21,0,0,0,2,1,9,0,0,0,0,0,9,0,110010026001000,4,404,404,4,psa_48,4D3
1000000US110010095093003,"Block 3003, Block Group 3, Census Tract 95.09, District of Columbia, District of Columbia",157,11,139,0,0,0,3,4,157,151,9,139,0,0,0,0,3,6,2,0,0,0,0,3,1,110010095093003,4,405,405,4,psa_49,4D2
1000000US110010010012010,"Block 2010, Block Group 2, Census Tract 10.01, District of Columbia, District of Columbia",0,0,0,0,0,0,0,0,0,0,0,0,0,0,0,0,0,0,0,0,0,0,0,0,0,110010010012010,2,202,202,2,psa_52,2D1
1000000US110010093021005,"Block 1005, Block Group 1, Census Tract 93.02, District of Columbia, District of Columbia",82,15,55,0,12,0,0,0,82,81,14,55,0,12,0,0,0,1,1,0,0,0,0,0,0,110010093021005,5,504,504,5,psa_43,5D2
1000000US110010025022006,"Block 2006, Block Group 2, Census Tract 25.02, District of Columbia, District of Columbia",206,86,87,1,1,0,21,10,206,176,82,83,1,1,0,1,8,30,4,4,0,0,0,20,2,110010025022006,4,404,404,4,psa_48,4D3
1000000US110010059001001,"Block 1001, Block Group 1, Census Tract 59, District of Columbia, District of Columbia",0,0,0,0,0,0,0,0,0,0,0,0,0,0,0,0,0,0,0,0,0,0,0,0,0,110010059001001,1,102,102,1,psa_18,1D1
1000000US110010101001022,"Block 1022, Block Group 1, Census Tract 101, District of Columbia, District of Columbia",0,0,0,0,0,0,0,0,0,0,0,0,0,0,0,0,0,0,0,0,0,0,0,0,0,110010101001022,2,209,209,2,psa_57,2D3
1000000US110010104002034,"Block 2034, Block Group 2, Census Tract 104, District of Columbia, District of Columbia",0,0,0,0,0,0,0,0,0,0,0,0,0,0,0,0,0,0,0,0,0,0,0,0,0,110010104002034,7,703,703,7,psa_8,7D1
1000000US110010076032005,"Block 2005, Block Group 2, Census Tract 76.03, District of Columbia, District of Columbia",192,5,183,0,1,0,0,3,192,192,5,183,0,1,0,0,3,0,0,0,0,0,0,0,0,110010076032005,6,606,606,6,psa_7,6D2
1000000US110010092031001,"Block 1001, Block Group 1, Census Tract 92.03, District of Columbia, District of Columbia",165,21,133,1,5,0,3,2,165,146,11,132,1,0,0,0,2,19,10,1,0,5,0,3,0,110010092031001,5,502,502,5,psa_40,5D1
1000000US110010010016008,"Block 6008, Block Group 6, Census Tract 10.01, District of Columbia, District of Columbia",52,48,0,0,4,0,0,0,52,46,42,0,0,4,0,0,0,6,6,0,0,0,0,0,0,110010010016008,2,202,202,2,psa_52,2D1
1000000US110010089042004,"Block 2004, Block Group 2, Census Tract 89.04, District of Columbia, District of Columbia",86,2,80,0,2,1,0,1,86,83,1,79,0,2,0,0,1,3,1,1,0,0,1,0,0,110010089042004,5,507,507,5,psa_23,5D3
1000000US110010026001018,"Block 1018, Block Group 1, Census Tract 26, District of Columbia, District of Columbia",0,0,0,0,0,0,0,0,0,0,0,0,0,0,0,0,0,0,0,0,0,0,0,0,0,110010026001018,4,404,404,4,psa_48,4D3
1000000US110010077081004,"Block 1004, Block Group 1, Census Tract 77.08, District of Columbia, District of Columbia",95,0,93,0,0,0,0,2,95,94,0,92,0,0,0,0,2,1,0,1,0,0,0,0,0,110010077081004,6,603,603,6,psa_15,6D3
1000000US110010077072020,"Block 2020, Block Group 2, Census Tract 77.07, District of Columbia, District of Columbia",46,1,45,0,0,0,0,0,46,46,1,45,0,0,0,0,0,0,0,0,0,0,0,0,0,110010077072020,6,604,604,6,psa_14,6D3
1000000US110010095051005,"Block 1005, Block Group 1, Census Tract 95.05, District of Columbia, District of Columbia",41,6,35,0,0,0,0,0,41,36,1,35,0,0,0,0,0,5,5,0,0,0,0,0,0,110010095051005,4,406,406,4,psa_54,4D2
1000000US110010005021011,"Block 1011, Block Group 1, Census Tract 5.02, District of Columbia, District of Columbia",287,236,12,0,20,0,6,13,287,261,219,12,0,20,0,0,10,26,17,0,0,0,0,6,3,110010005021011,2,204,204,2,psa_44,2D2
1000000US110010074081005,"Block 1005, Block Group 1, Census Tract 74.08, District of Columbia, District of Columbia",42,0,42,0,0,0,0,0,42,42,0,42,0,0,0,0,0,0,0,0,0,0,0,0,0,110010074081005,7,702,702,7,psa_6,7D1
1000000US110010032003003,"Block 3003, Block Group 3, Census Tract 32, District of Columbia, District of Columbia",278,65,156,4,5,0,43,5,278,204,44,151,0,5,0,0,4,74,21,5,4,0,0,43,1,110010032003003,4,409,409,4,psa_41,4D3
1000000US110010074081006,"Block 1006, Block Group 1, Census Tract 74.08, District of Columbia, District of Columbia",40,0,39,0,1,0,0,0,40,40,0,39,0,1,0,0,0,0,0,0,0,0,0,0,0,110010074081006,7,702,702,7,psa_6,7D1
1000000US110010001004020,"Block 4020, Block Group 4, Census Tract 1, District of Columbia, District of Columbia",0,0,0,0,0,0,0,0,0,0,0,0,0,0,0,0,0,0,0,0,0,0,0,0,0,110010001004020,2,206,206,2,psa_29,2D2
1000000US110010005011000,"Block 1000, Block Group 1, Census Tract 5.01, District of Columbia, District of Columbia",0,0,0,0,0,0,0,0,0,0,0,0,0,0,0,0,0,0,0,0,0,0,0,0,0,110010005011000,2,203,203,2,psa_50,2D1
1000000US110010018042007,"Block 2007, Block Group 2, Census Tract 18.04, District of Columbia, District of Columbia",86,16,56,2,5,0,6,1,86,62,5,50,1,5,0,1,0,24,11,6,1,0,0,5,1,110010018042007,4,402,402,4,psa_53,4D1
1000000US110010062021050,"Block 1050, Block Group 1, Census Tract 62.02, District of Columbia, District of Columbia",0,0,0,0,0,0,0,0,0,0,0,0,0,0,0,0,0,0,0,0,0,0,0,0,0,110010062021050,2,207,207,2,psa_24,2D3
1000000US110010062021205,"Block 1205, Block Group 1, Census Tract 62.02, District of Columbia, District of Columbia",0,0,0,0,0,0,0,0,0,0,0,0,0,0,0,0,0,0,0,0,0,0,0,0,0,110010062021205,1,103,103,1,psa_12,1D1
1000000US110010074072010,"Block 2010, Block Group 2, Census Tract 74.07, District of Columbia, District of Columbia",77,4,73,0,0,0,0,0,77,75,4,71,0,0,0,0,0,2,0,2,0,0,0,0,0,110010074072010,7,703,703,7,psa_8,7D1
1000000US110010111003023,"Block 3023, Block Group 3, Census Tract 111, District of Columbia, District of Columbia",261,0,236,0,0,0,1,24,261,249,0,233,0,0,0,0,16,12,0,3,0,0,0,1,8,110010111003023,5,503,503,5,psa_45,5D2
1000000US110010073011000,"Block 1000, Block Group 1, Census Tract 73.01, District of Columbia, District of Columbia",0,0,0,0,0,0,0,0,0,0,0,0,0,0,0,0,0,0,0,0,0,0,0,0,0,110010073011000,7,703,703,7,psa_8,7D1
1000000US110010095031012,"Block 1012, Block Group 1, Census Tract 95.03, District of Columbia, District of Columbia",78,14,54,0,3,0,3,4,78,77,13,54,0,3,0,3,4,1,1,0,0,0,0,0,0,110010095031012,4,405,405,4,psa_49,4D2
1000000US110010021026004,"Block 6004, Block Group 6, Census Tract 21.02, District of Columbia, District of Columbia",179,33,121,0,0,0,20,5,179,130,7,121,0,0,0,0,2,49,26,0,0,0,0,20,3,110010021026004,4,403,403,4,psa_51,4D1
1000000US110010032001001,"Block 1001, Block Group 1, Census Tract 32, District of Columbia, District of Columbia",130,31,86,0,3,0,4,6,130,113,24,86,0,3,0,0,0,17,7,0,0,0,0,4,6,110010032001001,4,409,409,4,psa_41,4D3
1000000US110010015002007,"Block 2007, Block Group 2, Census Tract 15, District of Columbia, District of Columbia",48,38,3,0,0,0,0,7,48,48,38,3,0,0,0,0,7,0,0,0,0,0,0,0,0,110010015002007,2,201,201,2,psa_55,2D1
1000000US110010022023006,"Block 3006, Block Group 3, Census Tract 22.02, District of Columbia, District of Columbia",168,9,133,3,0,0,20,3,168,138,9,125,1,0,0,0,3,30,0,8,2,0,0,20,0,110010022023006,4,407,407,4,psa_47,4D2
1000000US110010080011004,"Block 1004, Block Group 1, Census Tract 80.01, District of Columbia, District of Columbia",0,0,0,0,0,0,0,0,0,0,0,0,0,0,0,0,0,0,0,0,0,0,0,0,0,110010080011004,1,104,104,1,psa_21,1D2
1000000US110010062021004,"Block 1004, Block Group 1, Census Tract 62.02, District of Columbia, District of Columbia",0,0,0,0,0,0,0,0,0,0,0,0,0,0,0,0,0,0,0,0,0,0,0,0,0,110010062021004,1,102,102,1,psa_18,1D1
1000000US110010108001002,"Block 1002, Block Group 1, Census Tract 108.00, District of Columbia, District of Columbia",0,0,0,0,0,0,0,0,0,0,0,0,0,0,0,0,0,0,0,0,0,0,0,0,0,110010108001002,2,207,207,2,psa_24,2D3
1000000US110010072002047,"Block 2047, Block Group 2, Census Tract 72, District of Columbia, District of Columbia",0,0,0,0,0,0,0,0,0,0,0,0,0,0,0,0,0,0,0,0,0,0,0,0,0,110010072002047,1,106,106,1,psa_13,1D3
1000000US110010052012005,"Block 2005, Block Group 2, Census Tract 52.01, District of Columbia, District of Columbia",151,121,8,0,13,0,2,7,151,146,119,8,0,12,0,0,7,5,2,0,0,1,0,2,0,110010052012005,2,208,208,2,psa_33,2D3
1000000US110010084101011,"Block 1011, Block Group 1, Census Tract 84.10, District of Columbia, District of Columbia",91,40,46,0,3,0,1,1,91,89,40,46,0,3,0,0,0,2,0,0,0,0,0,1,1,110010084101011,5,501,501,5,psa_35,5D1
1000000US110010093011014,"Block 1014, Block Group 1, Census Tract 93.01, District of Columbia, District of Columbia",55,15,36,0,0,0,1,3,55,47,11,34,0,0,0,0,2,8,4,2,0,0,0,1,1,110010093011014,5,504,504,5,psa_43,5D2
1000000US110010096041006,"Block 1006, Block Group 1, Census Tract 96.04, District of Columbia, District of Columbia",135,0,135,0,0,0,0,0,135,135,0,135,0,0,0,0,0,0,0,0,0,0,0,0,0,110010096041006,6,603,603,6,psa_15,6D3
1000000US110010106001004,"Block 1004, Block Group 1, Census Tract 106, District of Columbia, District of Columbia",34,16,17,0,1,0,0,0,34,33,15,17,0,1,0,0,0,1,1,0,0,0,0,0,0,110010106001004,5,501,501,5,psa_35,5D1
1000000US110010062021023,"Block 1023, Block Group 1, Census Tract 62.02, District of Columbia, District of Columbia",0,0,0,0,0,0,0,0,0,0,0,0,0,0,0,0,0,0,0,0,0,0,0,0,0,110010062021023,2,209,209,2,psa_57,2D3
1000000US110010042012004,"Block 2004, Block Group 2, Census Tract 42.01, District of Columbia, District of Columbia",449,378,27,0,24,0,8,12,449,427,363,27,0,24,0,3,10,22,15,0,0,0,0,5,2,110010042012004,3,301,301,3,psa_31,3D3
1000000US110010102002021,"Block 2021, Block Group 2, Census Tract 102, District of Columbia, District of Columbia",0,0,0,0,0,0,0,0,0,0,0,0,0,0,0,0,0,0,0,0,0,0,0,0,0,110010102002021,1,103,103,1,psa_12,1D1
1000000US110010084101020,"Block 1020, Block Group 1, Census Tract 84.10, District of Columbia, District of Columbia",57,23,30,0,3,1,0,0,57,54,23,27,0,3,1,0,0,3,0,3,0,0,0,0,0,110010084101020,1,104,104,1,psa_21,1D2
1000000US110010042021000,"Block 1000, Block Group 1, Census Tract 42.02, District of Columbia, District of Columbia",231,202,2,0,12,0,4,11,231,217,196,2,0,11,0,0,8,14,6,0,0,1,0,4,3,110010042021000,3,301,301,3,psa_31,3D3
1000000US110010088041003,"Block 1003, Block Group 1, Census Tract 88.04, District of Columbia, District of Columbia",111,7,101,0,0,0,2,1,111,107,5,101,0,0,0,0,1,4,2,0,0,0,0,2,0,110010088041003,5,506,506,5,psa_26,5D3
1000000US110010019012004,"Block 2004, Block Group 2, Census Tract 19.01, District of Columbia, District of Columbia",61,0,37,0,0,0,19,5,61,42,0,37,0,0,0,0,5,19,0,0,0,0,0,19,0,110010019012004,4,402,402,4,psa_53,4D1
1000000US110010022023001,"Block 3001, Block Group 3, Census Tract 22.02, District of Columbia, District of Columbia",98,1,84,0,1,0,8,4,98,89,1,83,0,1,0,0,4,9,0,1,0,0,0,8,0,110010022023001,4,407,407,4,psa_47,4D2
1000000US110010098033004,"Block 3004, Block Group 3, Census Tract 98.03, District of Columbia, District of Columbia",98,0,94,0,0,0,0,4,98,96,0,94,0,0,0,0,2,2,0,0,0,0,0,0,2,110010098033004,7,707,707,7,psa_4,7D2
1000000US110010076015003,"Block 5003, Block Group 5, Census Tract 76.01, District of Columbia, District of Columbia",0,0,0,0,0,0,0,0,0,0,0,0,0,0,0,0,0,0,0,0,0,0,0,0,0,110010076015003,6,607,607,6,psa_10,6D2
1000000US110010095041002,"Block 1002, Block Group 1, Census Tract 95.04, District of Columbia, District of Columbia",106,29,67,1,0,0,0,9,106,103,27,66,1,0,0,0,9,3,2,1,0,0,0,0,0,110010095041002,4,405,405,4,psa_49,4D2
1000000US110010078062017,"Block 2017, Block Group 2, Census Tract 78.06, District of Columbia, District of Columbia",51,0,51,0,0,0,0,0,51,51,0,51,0,0,0,0,0,0,0,0,0,0,0,0,0,110010078062017,6,602,602,6,psa_25,6D1
1000000US110010023012018,"Block 2018, Block Group 2, Census Tract 23.01, District of Columbia, District of Columbia",0,0,0,0,0,0,0,0,0,0,0,0,0,0,0,0,0,0,0,0,0,0,0,0,0,110010023012018,4,407,407,4,psa_47,4D2
1000000US110010102001008,"Block 1008, Block Group 1, Census Tract 102, District of Columbia, District of Columbia",0,0,0,0,0,0,0,0,0,0,0,0,0,0,0,0,0,0,0,0,0,0,0,0,0,110010102001008,1,103,103,1,psa_12,1D1
1000000US110010016001003,"Block 1003, Block Group 1, Census Tract 16, District of Columbia, District of Columbia",89,19,59,0,6,0,1,4,89,83,16,56,0,6,0,1,4,6,3,3,0,0,0,0,0,110010016001003,4,401,401,4,psa_56,4D1
1000000US110010048022002,"Block 2002, Block Group 2, Census Tract 48.02, District of Columbia, District of Columbia",358,71,231,0,13,0,31,12,358,318,64,231,0,13,0,0,10,40,7,0,0,0,0,31,2,110010048022002,3,308,308,3,psa_27,3D2
1000000US110010065002003,"Block 2003, Block Group 2, Census Tract 65, District of Columbia, District of Columbia",86,81,3,0,0,0,0,2,86,82,77,3,0,0,0,0,2,4,4,0,0,0,0,0,0,110010065002003,1,106,106,1,psa_13,1D3
1000000US110010098112002,"Block 2002, Block Group 2, Census Tract 98.11, District of Columbia, District of Columbia",316,0,314,2,0,0,0,0,316,315,0,313,2,0,0,0,0,1,0,1,0,0,0,0,0,110010098112002,7,706,706,7,psa_2,7D3
1000000US110010111003052,"Block 3052, Block Group 3, Census Tract 111, District of Columbia, District of Columbia",0,0,0,0,0,0,0,0,0,0,0,0,0,0,0,0,0,0,0,0,0,0,0,0,0,110010111003052,5,507,507,5,psa_23,5D3
1000000US110010088024000,"Block 4000, Block Group 4, Census Tract 88.02, District of Columbia, District of Columbia",268,23,227,0,1,4,4,9,268,250,12,224,0,1,4,0,9,18,11,3,0,0,0,4,0,110010088024000,5,506,506,5,psa_26,5D3
1000000US110010095082007,"Block 2007, Block Group 2, Census Tract 95.08, District of Columbia, District of Columbia",82,7,68,0,0,0,6,1,82,77,5,68,0,0,0,3,1,5,2,0,0,0,0,3,0,110010095082007,4,406,406,4,psa_54,4D2
1000000US110010023021019,"Block 1019, Block Group 1, Census Tract 23.02, District of Columbia, District of Columbia",136,23,102,0,5,0,1,5,136,132,23,100,0,5,0,0,4,4,0,2,0,0,0,1,1,110010023021019,4,405,405,4,psa_49,4D2
1000000US110010015001018,"Block 1018, Block Group 1, Census Tract 15, District of Columbia, District of Columbia",75,54,13,0,5,0,0,3,75,71,50,13,0,5,0,0,3,4,4,0,0,0,0,0,0,110010015001018,2,201,201,2,psa_55,2D1
1000000US110010020023000,"Block 3000, Block Group 3, Census Tract 20.02, District of Columbia, District of Columbia",98,15,70,0,0,0,7,6,98,69,3,64,0,0,0,0,2,29,12,6,0,0,0,7,4,110010020023000,4,403,403,4,psa_51,4D1
1000000US110010022013001,"Block 3001, Block Group 3, Census Tract 22.01, District of Columbia, District of Columbia",117,11,78,0,0,0,26,2,117,84,5,77,0,0,0,0,2,33,6,1,0,0,0,26,0,110010022013001,4,407,407,4,psa_47,4D2
1000000US110010109002001,"Block 2001, Block Group 2, Census Tract 109, District of Columbia, District of Columbia",0,0,0,0,0,0,0,0,0,0,0,0,0,0,0,0,0,0,0,0,0,0,0,0,0,110010109002001,7,708,708,7,psa_1,7D3
1000000US110010098071005,"Block 1005, Block Group 1, Census Tract 98.07, District of Columbia, District of Columbia",117,7,109,0,0,0,1,0,117,115,7,108,0,0,0,0,0,2,0,1,0,0,0,1,0,110010098071005,7,708,708,7,psa_1,7D3
1000000US110010102001016,"Block 1016, Block Group 1, Census Tract 102, District of Columbia, District of Columbia",90,51,30,2,4,0,0,3,90,85,50,30,0,4,0,0,1,5,1,0,2,0,0,0,2,110010102001016,1,103,103,1,psa_12,1D1
1000000US110010058002000,"Block 2000, Block Group 2, Census Tract 58, District of Columbia, District of Columbia",0,0,0,0,0,0,0,0,0,0,0,0,0,0,0,0,0,0,0,0,0,0,0,0,0,110010058002000,1,101,101,1,psa_20,1D1
1000000US110010109002020,"Block 2020, Block Group 2, Census Tract 109, District of Columbia, District of Columbia",0,0,0,0,0,0,0,0,0,0,0,0,0,0,0,0,0,0,0,0,0,0,0,0,0,110010109002020,7,708,708,7,psa_1,7D3
1000000US110010096011049,"Block 1049, Block Group 1, Census Tract 96.01, District of Columbia, District of Columbia",0,0,0,0,0,0,0,0,0,0,0,0,0,0,0,0,0,0,0,0,0,0,0,0,0,110010096011049,6,602,602,6,psa_25,6D1
1000000US110010110002013,"Block 2013, Block Group 2, Census Tract 110, District of Columbia, District of Columbia",0,0,0,0,0,0,0,0,0,0,0,0,0,0,0,0,0,0,0,0,0,0,0,0,0,110010110002013,1,105,105,1,psa_22,1D3
1000000US110010022012003,"Block 2003, Block Group 2, Census Tract 22.01, District of Columbia, District of Columbia",111,19,85,0,0,0,1,6,111,94,6,85,0,0,0,0,3,17,13,0,0,0,0,1,3,110010022012003,4,407,407,4,psa_47,4D2
1000000US110010076011004,"Block 1004, Block Group 1, Census Tract 76.01, District of Columbia, District of Columbia",272,10,251,2,1,0,0,8,272,269,10,249,2,1,0,0,7,3,0,2,0,0,0,0,1,110010076011004,6,607,607,6,psa_10,6D2
1000000US110010078081009,"Block 1009, Block Group 1, Census Tract 78.08, District of Columbia, District of Columbia",200,0,187,0,0,0,0,13,200,196,0,186,0,0,0,0,10,4,0,1,0,0,0,0,3,110010078081009,6,608,608,6,psa_19,6D1
1000000US110010062021158,"Block 1158, Block Group 1, Census Tract 62.02, District of Columbia, District of Columbia",0,0,0,0,0,0,0,0,0,0,0,0,0,0,0,0,0,0,0,0,0,0,0,0,0,110010062021158,2,207,207,2,psa_24,2D3
1000000US110010077091025,"Block 1025, Block Group 1, Census Tract 77.09, District of Columbia, District of Columbia",94,0,89,0,3,0,0,2,94,94,0,89,0,3,0,0,2,0,0,0,0,0,0,0,0,110010077091025,6,605,605,6,psa_11,6D2
1000000US110010068041013,"Block 1013, Block Group 1, Census Tract 68.04, District of Columbia, District of Columbia",0,0,0,0,0,0,0,0,0,0,0,0,0,0,0,0,0,0,0,0,0,0,0,0,0,110010068041013,1,106,106,1,psa_13,1D3
1000000US110010015005000,"Block 5000, Block Group 5, Census Tract 15, District of Columbia, District of Columbia",94,88,0,0,6,0,0,0,94,92,86,0,0,6,0,0,0,2,2,0,0,0,0,0,0,110010015005000,2,201,201,2,psa_55,2D1
1000000US110010094002002,"Block 2002, Block Group 2, Census Tract 94, District of Columbia, District of Columbia",34,0,34,0,0,0,0,0,34,33,0,33,0,0,0,0,0,1,0,1,0,0,0,0,0,110010094002002,5,504,504,5,psa_43,5D2
1000000US110010058002002,"Block 2002, Block Group 2, Census Tract 58, District of Columbia, District of Columbia",298,2,2,0,262,0,29,3,298,269,2,2,0,262,0,0,3,29,0,0,0,0,0,29,0,110010058002002,1,101,101,1,psa_20,1D1
1000000US110010076011003,"Block 1003, Block Group 1, Census Tract 76.01, District of Columbia, District of Columbia",4,0,4,0,0,0,0,0,4,4,0,4,0,0,0,0,0,0,0,0,0,0,0,0,0,110010076011003,6,607,607,6,psa_10,6D2
1000000US110010111003003,"Block 3003, Block Group 3, Census Tract 111, District of Columbia, District of Columbia",55,0,48,0,0,0,0,7,55,55,0,48,0,0,0,0,7,0,0,0,0,0,0,0,0,110010111003003,5,503,503,5,psa_45,5D2
1000000US110010099052002,"Block 2002, Block Group 2, Census Tract 99.05, District of Columbia, District of Columbia",22,0,22,0,0,0,0,0,22,22,0,22,0,0,0,0,0,0,0,0,0,0,0,0,0,110010099052002,6,604,604,6,psa_14,6D3
1000000US110010109002034,"Block 2034, Block Group 2, Census Tract 109, District of Columbia, District of Columbia",0,0,0,0,0,0,0,0,0,0,0,0,0,0,0,0,0,0,0,0,0,0,0,0,0,110010109002034,7,708,708,7,psa_1,7D3
1000000US110010013023000,"Block 3000, Block Group 3, Census Tract 13.02, District of Columbia, District of Columbia",26,19,0,0,0,0,7,0,26,19,19,0,0,0,0,0,0,7,0,0,0,0,0,7,0,110010013023000,2,203,203,2,psa_50,2D1
1000000US110010018042013,"Block 2013, Block Group 2, Census Tract 18.04, District of Columbia, District of Columbia",0,0,0,0,0,0,0,0,0,0,0,0,0,0,0,0,0,0,0,0,0,0,0,0,0,110010018042013,4,402,402,4,psa_53,4D1
1000000US110010062021118,"Block 1118, Block Group 1, Census Tract 62.02, District of Columbia, District of Columbia",0,0,0,0,0,0,0,0,0,0,0,0,0,0,0,0,0,0,0,0,0,0,0,0,0,110010062021118,1,102,102,1,psa_18,1D1
1000000US110010019012000,"Block 2000, Block Group 2, Census Tract 19.01, District of Columbia, District of Columbia",121,13,99,0,0,0,0,9,121,121,13,99,0,0,0,0,9,0,0,0,0,0,0,0,0,110010019012000,4,402,402,4,psa_53,4D1
1000000US110010050022003,"Block 2003, Block Group 2, Census Tract 50.02, District of Columbia, District of Columbia",575,427,48,0,49,2,21,28,575,499,380,45,0,49,2,1,22,76,47,3,0,0,0,20,6,110010050022003,3,307,307,3,psa_28,3D3
1000000US110010081003008,"Block 3008, Block Group 3, Census Tract 81, District of Columbia, District of Columbia",145,131,8,0,4,0,0,2,145,138,124,8,0,4,0,0,2,7,7,0,0,0,0,0,0,110010081003008,1,108,108,1,psa_17,1D2
1000000US110010076015011,"Block 5011, Block Group 5, Census Tract 76.01, District of Columbia, District of Columbia",0,0,0,0,0,0,0,0,0,0,0,0,0,0,0,0,0,0,0,0,0,0,0,0,0,110010076015011,7,701,701,7,psa_9,7D1
1000000US110010062021042,"Block 1042, Block Group 1, Census Tract 62.02, District of Columbia, District of Columbia",0,0,0,0,0,0,0,0,0,0,0,0,0,0,0,0,0,0,0,0,0,0,0,0,0,110010062021042,2,207,207,2,psa_24,2D3
1000000US110010067002006,"Block 2006, Block Group 2, Census Tract 67, District of Columbia, District of Columbia",141,120,12,1,3,0,0,5,141,137,118,12,1,3,0,0,3,4,2,0,0,0,0,0,2,110010067002006,1,107,107,1,psa_16,1D2
1000000US110010106002049,"Block 2049, Block Group 2, Census Tract 106, District of Columbia, District of Columbia",123,77,37,1,3,0,0,5,123,114,74,34,1,2,0,0,3,9,3,3,0,1,0,0,2,110010106002049,1,104,104,1,psa_21,1D2
1000000US110010010014004,"Block 4004, Block Group 4, Census Tract 10.01, District of Columbia, District of Columbia",69,64,1,0,1,0,0,3,69,63,58,1,0,1,0,0,3,6,6,0,0,0,0,0,0,110010010014004,2,202,202,2,psa_52,2D1
1000000US110010040012004,"Block 2004, Block Group 2, Census Tract 40.01, District of Columbia, District of Columbia",0,0,0,0,0,0,0,0,0,0,0,0,0,0,0,0,0,0,0,0,0,0,0,0,0,110010040012004,3,303,303,3,psa_37,3D3
1000000US110010107002002,"Block 2002, Block Group 2, Census Tract 107, District of Columbia, District of Columbia",130,103,6,0,15,0,3,3,130,112,89,6,0,14,0,0,3,18,14,0,0,1,0,3,0,110010107002002,2,208,208,2,psa_33,2D3
1000000US110010095012004,"Block 2004, Block Group 2, Census Tract 95.01, District of Columbia, District of Columbia",96,13,73,0,0,0,7,3,96,81,7,73,0,0,0,0,1,15,6,0,0,0,0,7,2,110010095012004,4,405,405,4,psa_49,4D2
1000000US110010025023002,"Block 3002, Block Group 3, Census Tract 25.02, District of Columbia, District of Columbia",374,145,113,0,5,4,82,25,374,193,60,110,0,5,4,7,7,181,85,3,0,0,0,75,18,110010025023002,4,404,404,4,psa_48,4D3
1000000US110010077091020,"Block 1020, Block Group 1, Census Tract 77.09, District of Columbia, District of Columbia",65,0,65,0,0,0,0,0,65,62,0,62,0,0,0,0,0,3,0,3,0,0,0,0,0,110010077091020,6,605,605,6,psa_11,6D2
1000000US110010094001017,"Block 1017, Block Group 1, Census Tract 94, District of Columbia, District of Columbia",50,0,45,0,2,0,0,3,50,50,0,45,0,2,0,0,3,0,0,0,0,0,0,0,0,110010094001017,5,503,503,5,psa_45,5D2
1000000US110010049012002,"Block 2002, Block Group 2, Census Tract 49.01, District of Columbia, District of Columbia",0,0,0,0,0,0,0,0,0,0,0,0,0,0,0,0,0,0,0,0,0,0,0,0,0,110010049012002,3,307,307,3,psa_28,3D3
1000000US110010109002002,"Block 2002, Block Group 2, Census Tract 109, District of Columbia, District of Columbia",129,0,125,0,0,0,1,3,129,129,0,125,0,0,0,1,3,0,0,0,0,0,0,0,0,110010109002002,7,708,708,7,psa_1,7D3
1000000US110010047021004,"Block 1004, Block Group 1, Census Tract 47.02, District of Columbia, District of Columbia",0,0,0,0,0,0,0,0,0,0,0,0,0,0,0,0,0,0,0,0,0,0,0,0,0,110010047021004,1,101,101,1,psa_20,1D1
1000000US110010034001002,"Block 1002, Block Group 1, Census Tract 34, District of Columbia, District of Columbia",92,39,50,1,1,0,0,1,92,91,39,50,1,0,0,0,1,1,0,0,0,1,0,0,0,110010034001002,3,306,306,3,psa_38,3D2
1000000US110010072002055,"Block 2055, Block Group 2, Census Tract 72, District of Columbia, District of Columbia",0,0,0,0,0,0,0,0,0,0,0,0,0,0,0,0,0,0,0,0,0,0,0,0,0,110010072002055,1,106,106,1,psa_13,1D3
1000000US110010042021003,"Block 1003, Block Group 1, Census Tract 42.02, District of Columbia, District of Columbia",82,67,3,1,6,1,0,4,82,79,64,3,1,6,1,0,4,3,3,0,0,0,0,0,0,110010042021003,3,301,301,3,psa_31,3D3
1000000US110010096042004,"Block 2004, Block Group 2, Census Tract 96.04, District of Columbia, District of Columbia",28,6,20,0,1,0,0,1,28,27,5,20,0,1,0,0,1,1,1,0,0,0,0,0,0,110010096042004,6,603,603,6,psa_15,6D3
1000000US110010088021000,"Block 1000, Block Group 1, Census Tract 88.02, District of Columbia, District of Columbia",236,17,210,0,0,0,2,7,236,233,16,210,0,0,0,0,7,3,1,0,0,0,0,2,0,110010088021000,5,506,506,5,psa_26,5D3
1000000US110010002024032,"Block 4032, Block Group 4, Census Tract 2.02, District of Columbia, District of Columbia",19,18,0,0,0,0,0,1,19,19,18,0,0,0,0,0,1,0,0,0,0,0,0,0,0,110010002024032,2,206,206,2,psa_29,2D2
1000000US110010088042012,"Block 2012, Block Group 2, Census Tract 88.04, District of Columbia, District of Columbia",201,10,179,1,0,0,4,7,201,197,10,179,1,0,0,0,7,4,0,0,0,0,0,4,0,110010088042012,5,506,506,5,psa_26,5D3
1000000US110010047021006,"Block 1006, Block Group 1, Census Tract 47.02, District of Columbia, District of Columbia",0,0,0,0,0,0,0,0,0,0,0,0,0,0,0,0,0,0,0,0,0,0,0,0,0,110010047021006,1,101,101,1,psa_20,1D1
1000000US110010072002024,"Block 2024, Block Group 2, Census Tract 72, District of Columbia, District of Columbia",0,0,0,0,0,0,0,0,0,0,0,0,0,0,0,0,0,0,0,0,0,0,0,0,0,110010072002024,1,106,106,1,psa_13,1D3
1000000US110010011002003,"Block 2003, Block Group 2, Census Tract 11, District of Columbia, District of Columbia",92,69,0,0,12,1,7,3,92,83,69,0,0,11,0,0,3,9,0,0,0,1,1,7,0,110010011002003,2,202,202,2,psa_52,2D1
1000000US110010062021106,"Block 1106, Block Group 1, Census Tract 62.02, District of Columbia, District of Columbia",0,0,0,0,0,0,0,0,0,0,0,0,0,0,0,0,0,0,0,0,0,0,0,0,0,110010062021106,1,102,102,1,psa_18,1D1
1000000US110010074011007,"Block 1007, Block Group 1, Census Tract 74.01, District of Columbia, District of Columbia",0,0,0,0,0,0,0,0,0,0,0,0,0,0,0,0,0,0,0,0,0,0,0,0,0,110010074011007,7,701,701,7,psa_9,7D1
1000000US110010076011005,"Block 1005, Block Group 1, Census Tract 76.01, District of Columbia, District of Columbia",71,6,65,0,0,0,0,0,71,69,4,65,0,0,0,0,0,2,2,0,0,0,0,0,0,110010076011005,6,607,607,6,psa_10,6D2
1000000US110010109002003,"Block 2003, Block Group 2, Census Tract 109, District of Columbia, District of Columbia",0,0,0,0,0,0,0,0,0,0,0,0,0,0,0,0,0,0,0,0,0,0,0,0,0,110010109002003,7,708,708,7,psa_1,7D3
1000000US110010076034004,"Block 4004, Block Group 4, Census Tract 76.03, District of Columbia, District of Columbia",267,19,235,1,0,0,4,8,267,258,19,232,1,0,0,0,6,9,0,3,0,0,0,4,2,110010076034004,6,606,606,6,psa_7,6D2
1000000US110010077072001,"Block 2001, Block Group 2, Census Tract 77.07, District of Columbia, District of Columbia",104,0,104,0,0,0,0,0,104,104,0,104,0,0,0,0,0,0,0,0,0,0,0,0,0,110010077072001,6,605,605,6,psa_11,6D2
1000000US110010062021021,"Block 1021, Block Group 1, Census Tract 62.02, District of Columbia, District of Columbia",8,0,8,0,0,0,0,0,8,8,0,8,0,0,0,0,0,0,0,0,0,0,0,0,0,110010062021021,1,102,102,1,psa_18,1D1
1000000US110010062021139,"Block 1139, Block Group 1, Census Tract 62.02, District of Columbia, District of Columbia",0,0,0,0,0,0,0,0,0,0,0,0,0,0,0,0,0,0,0,0,0,0,0,0,0,110010062021139,1,106,106,1,psa_13,1D3
1000000US110010062021035,"Block 1035, Block Group 1, Census Tract 62.02, District of Columbia, District of Columbia",0,0,0,0,0,0,0,0,0,0,0,0,0,0,0,0,0,0,0,0,0,0,0,0,0,110010062021035,2,207,207,2,psa_24,2D3
1000000US110010068021000,"Block 1000, Block Group 1, Census Tract 68.02, District of Columbia, District of Columbia",92,20,65,0,1,0,0,6,92,89,20,63,0,1,0,0,5,3,0,2,0,0,0,0,1,110010068021000,1,107,107,1,psa_16,1D2
1000000US110010002024034,"Block 4034, Block Group 4, Census Tract 2.02, District of Columbia, District of Columbia",0,0,0,0,0,0,0,0,0,0,0,0,0,0,0,0,0,0,0,0,0,0,0,0,0,110010002024034,2,206,206,2,psa_29,2D2
1000000US110010011002002,"Block 2002, Block Group 2, Census Tract 11, District of Columbia, District of Columbia",275,166,83,0,19,0,0,7,275,259,152,83,0,19,0,0,5,16,14,0,0,0,0,0,2,110010011002002,2,202,202,2,psa_52,2D1
1000000US110010056002003,"Block 2003, Block Group 2, Census Tract 56, District of Columbia, District of Columbia",0,0,0,0,0,0,0,0,0,0,0,0,0,0,0,0,0,0,0,0,0,0,0,0,0,110010056002003,2,207,207,2,psa_24,2D3
1000000US110010073011050,"Block 1050, Block Group 1, Census Tract 73.01, District of Columbia, District of Columbia",0,0,0,0,0,0,0,0,0,0,0,0,0,0,0,0,0,0,0,0,0,0,0,0,0,110010073011050,7,708,708,7,psa_1,7D3
1000000US110010042012007,"Block 2007, Block Group 2, Census Tract 42.01, District of Columbia, District of Columbia",0,0,0,0,0,0,0,0,0,0,0,0,0,0,0,0,0,0,0,0,0,0,0,0,0,110010042012007,3,301,301,3,psa_31,3D3
1000000US110010078081011,"Block 1011, Block Group 1, Census Tract 78.08, District of Columbia, District of Columbia",74,1,73,0,0,0,0,0,74,74,1,73,0,0,0,0,0,0,0,0,0,0,0,0,0,110010078081011,6,608,608,6,psa_19,6D1
1000000US110010059001003,"Block 1003, Block Group 1, Census Tract 59, District of Columbia, District of Columbia",0,0,0,0,0,0,0,0,0,0,0,0,0,0,0,0,0,0,0,0,0,0,0,0,0,110010059001003,1,101,101,1,psa_20,1D1
1000000US110010026002000,"Block 2000, Block Group 2, Census Tract 26, District of Columbia, District of Columbia",0,0,0,0,0,0,0,0,0,0,0,0,0,0,0,0,0,0,0,0,0,0,0,0,0,110010026002000,4,403,403,4,psa_51,4D1
1000000US110010071002010,"Block 2010, Block Group 2, Census Tract 71, District of Columbia, District of Columbia",35,17,11,0,2,0,2,3,35,28,13,11,0,2,0,0,2,7,4,0,0,0,0,2,1,110010071002010,1,106,106,1,psa_13,1D3
1000000US110010011004013,"Block 4013, Block Group 4, Census Tract 11, District of Columbia, District of Columbia",0,0,0,0,0,0,0,0,0,0,0,0,0,0,0,0,0,0,0,0,0,0,0,0,0,110010011004013,2,202,202,2,psa_52,2D1
1000000US110010017021026,"Block 1026, Block Group 1, Census Tract 17.02, District of Columbia, District of Columbia",55,19,33,0,0,0,3,0,55,41,10,31,0,0,0,0,0,14,9,2,0,0,0,3,0,110010017021026,4,401,401,4,psa_56,4D1
1000000US110010019021005,"Block 1005, Block Group 1, Census Tract 19.02, District of Columbia, District of Columbia",82,0,72,0,0,0,10,0,82,74,0,72,0,0,0,2,0,8,0,0,0,0,0,8,0,110010019021005,4,402,402,4,psa_53,4D1
1000000US110010107001016,"Block 1016, Block Group 1, Census Tract 107, District of Columbia, District of Columbia",0,0,0,0,0,0,0,0,0,0,0,0,0,0,0,0,0,0,0,0,0,0,0,0,0,110010107001016,2,207,207,2,psa_24,2D3
1000000US110010016004013,"Block 4013, Block Group 4, Census Tract 16, District of Columbia, District of Columbia",0,0,0,0,0,0,0,0,0,0,0,0,0,0,0,0,0,0,0,0,0,0,0,0,0,110010016004013,2,201,201,2,psa_55,2D1
1000000US110010005021013,"Block 1013, Block Group 1, Census Tract 5.02, District of Columbia, District of Columbia",50,46,0,0,4,0,0,0,50,48,44,0,0,4,0,0,0,2,2,0,0,0,0,0,0,110010005021013,2,204,204,2,psa_44,2D2
1000000US110010056002024,"Block 2024, Block Group 2, Census Tract 56, District of Columbia, District of Columbia",0,0,0,0,0,0,0,0,0,0,0,0,0,0,0,0,0,0,0,0,0,0,0,0,0,110010056002024,2,207,207,2,psa_24,2D3
1000000US110010062021059,"Block 1059, Block Group 1, Census Tract 62.02, District of Columbia, District of Columbia",0,0,0,0,0,0,0,0,0,0,0,0,0,0,0,0,0,0,0,0,0,0,0,0,0,110010062021059,2,207,207,2,psa_24,2D3
1000000US110010076015022,"Block 5022, Block Group 5, Census Tract 76.01, District of Columbia, District of Columbia",80,8,69,1,0,0,0,2,80,77,8,68,0,0,0,0,1,3,0,1,1,0,0,0,1,110010076015022,6,607,607,6,psa_10,6D2
1000000US110010082002009,"Block 2009, Block Group 2, Census Tract 82, District of Columbia, District of Columbia",70,59,8,0,1,0,0,2,70,69,59,8,0,0,0,0,2,1,0,0,0,1,0,0,0,110010082002009,1,108,108,1,psa_17,1D2
1000000US110010088042010,"Block 2010, Block Group 2, Census Tract 88.04, District of Columbia, District of Columbia",21,0,21,0,0,0,0,0,21,20,0,20,0,0,0,0,0,1,0,1,0,0,0,0,0,110010088042010,5,506,506,5,psa_26,5D3
1000000US110010094002011,"Block 2011, Block Group 2, Census Tract 94, District of Columbia, District of Columbia",134,20,100,1,7,0,0,6,134,129,20,95,1,7,0,0,6,5,0,5,0,0,0,0,0,110010094002011,5,504,504,5,psa_43,5D2
1000000US110010095081004,"Block 1004, Block Group 1, Census Tract 95.08, District of Columbia, District of Columbia",293,48,224,2,5,0,7,7,293,277,44,221,2,5,0,0,5,16,4,3,0,0,0,7,2,110010095081004,4,406,406,4,psa_54,4D2
1000000US110010049021005,"Block 1005, Block Group 1, Census Tract 49.02, District of Columbia, District of Columbia",65,37,17,0,2,0,7,2,65,57,36,17,0,2,0,0,2,8,1,0,0,0,0,7,0,110010049021005,3,307,307,3,psa_28,3D3
1000000US110010091022002,"Block 2002, Block Group 2, Census Tract 91.02, District of Columbia, District of Columbia",13,0,12,0,0,0,0,1,13,12,0,12,0,0,0,0,0,1,0,0,0,0,0,0,1,110010091022002,5,505,505,5,psa_34,5D2
1000000US110010078081003,"Block 1003, Block Group 1, Census Tract 78.08, District of Columbia, District of Columbia",0,0,0,0,0,0,0,0,0,0,0,0,0,0,0,0,0,0,0,0,0,0,0,0,0,110010078081003,6,608,608,6,psa_19,6D1
1000000US110010068021002,"Block 1002, Block Group 1, Census Tract 68.02, District of Columbia, District of Columbia",0,0,0,0,0,0,0,0,0,0,0,0,0,0,0,0,0,0,0,0,0,0,0,0,0,110010068021002,1,107,107,1,psa_16,1D2
1000000US110010017022020,"Block 2020, Block Group 2, Census Tract 17.02, District of Columbia, District of Columbia",112,19,92,0,1,0,0,0,112,105,13,91,0,1,0,0,0,7,6,1,0,0,0,0,0,110010017022020,4,406,406,4,psa_54,4D2
1000000US110010020011008,"Block 1008, Block Group 1, Census Tract 20.01, District of Columbia, District of Columbia",2,0,2,0,0,0,0,0,2,2,0,2,0,0,0,0,0,0,0,0,0,0,0,0,0,110010020011008,4,403,403,4,psa_51,4D1
1000000US110010078061002,"Block 1002, Block Group 1, Census Tract 78.06, District of Columbia, District of Columbia",253,6,235,0,1,0,1,10,253,248,6,231,0,1,0,0,10,5,0,4,0,0,0,1,0,110010078061002,6,602,602,6,psa_25,6D1
1000000US110010068022003,"Block 2003, Block Group 2, Census Tract 68.02, District of Columbia, District of Columbia",169,83,76,2,1,0,2,5,169,160,78,74,2,1,0,0,5,9,5,2,0,0,0,2,0,110010068022003,1,107,107,1,psa_16,1D2
1000000US110010099012003,"Block 2003, Block Group 2, Census Tract 99.01, District of Columbia, District of Columbia",57,7,46,4,0,0,0,0,57,51,1,46,4,0,0,0,0,6,6,0,0,0,0,0,0,110010099012003,6,605,605,6,psa_11,6D2
1000000US110010021014000,"Block 4000, Block Group 4, Census Tract 21.01, District of Columbia, District of Columbia",271,23,146,4,2,0,89,7,271,149,3,139,2,2,0,0,3,122,20,7,2,0,0,89,4,110010021014000,4,403,403,4,psa_51,4D1
1000000US110010016001000,"Block 1000, Block Group 1, Census Tract 16, District of Columbia, District of Columbia",0,0,0,0,0,0,0,0,0,0,0,0,0,0,0,0,0,0,0,0,0,0,0,0,0,110010016001000,4,401,401,4,psa_56,4D1
1000000US110010077072003,"Block 2003, Block Group 2, Census Tract 77.07, District of Columbia, District of Columbia",39,1,38,0,0,0,0,0,39,38,1,37,0,0,0,0,0,1,0,1,0,0,0,0,0,110010077072003,6,605,605,6,psa_11,6D2
1000000US110010040011002,"Block 1002, Block Group 1, Census Tract 40.01, District of Columbia, District of Columbia",518,431,17,0,16,0,20,34,518,424,366,14,0,16,0,0,28,94,65,3,0,0,0,20,6,110010040011002,3,303,303,3,psa_37,3D3
1000000US110010072002030,"Block 2030, Block Group 2, Census Tract 72, District of Columbia, District of Columbia",0,0,0,0,0,0,0,0,0,0,0,0,0,0,0,0,0,0,0,0,0,0,0,0,0,110010072002030,1,106,106,1,psa_13,1D3
1000000US110010076031002,"Block 1002, Block Group 1, Census Tract 76.03, District of Columbia, District of Columbia",203,8,185,6,2,0,2,0,203,201,8,185,6,2,0,0,0,2,0,0,0,0,0,2,0,110010076031002,6,606,606,6,psa_7,6D2
1000000US110010095082008,"Block 2008, Block Group 2, Census Tract 95.08, District of Columbia, District of Columbia",66,0,66,0,0,0,0,0,66,66,0,66,0,0,0,0,0,0,0,0,0,0,0,0,0,110010095082008,4,406,406,4,psa_54,4D2
1000000US110010015001027,"Block 1027, Block Group 1, Census Tract 15, District of Columbia, District of Columbia",100,92,4,0,4,0,0,0,100,99,91,4,0,4,0,0,0,1,1,0,0,0,0,0,0,110010015001027,2,201,201,2,psa_55,2D1
1000000US110010019011012,"Block 1012, Block Group 1, Census Tract 19.01, District of Columbia, District of Columbia",78,10,63,3,0,0,1,1,78,67,3,63,0,0,0,0,1,11,7,0,3,0,0,1,0,110010019011012,4,402,402,4,psa_53,4D1
1000000US110010011002004,"Block 2004, Block Group 2, Census Tract 11, District of Columbia, District of Columbia",98,67,5,2,12,0,3,9,98,82,62,5,0,12,0,2,1,16,5,0,2,0,0,1,8,110010011002004,2,202,202,2,psa_52,2D1
1000000US110010073011113,"Block 1113, Block Group 1, Census Tract 73.01, District of Columbia, District of Columbia",0,0,0,0,0,0,0,0,0,0,0,0,0,0,0,0,0,0,0,0,0,0,0,0,0,110010073011113,7,708,708,7,psa_1,7D3
1000000US110010037003000,"Block 3000, Block Group 3, Census Tract 37, District of Columbia, District of Columbia",0,0,0,0,0,0,0,0,0,0,0,0,0,0,0,0,0,0,0,0,0,0,0,0,0,110010037003000,3,304,304,3,psa_36,3D1
1000000US110010111001028,"Block 1028, Block Group 1, Census Tract 111, District of Columbia, District of Columbia",0,0,0,0,0,0,0,0,0,0,0,0,0,0,0,0,0,0,0,0,0,0,0,0,0,110010111001028,5,503,503,5,psa_45,5D2
1000000US110010013011015,"Block 1015, Block Group 1, Census Tract 13.01, District of Columbia, District of Columbia",24,24,0,0,0,0,0,0,24,22,22,0,0,0,0,0,0,2,2,0,0,0,0,0,0,110010013011015,2,203,203,2,psa_50,2D1
1000000US110010084101001,"Block 1001, Block Group 1, Census Tract 84.10, District of Columbia, District of Columbia",116,4,98,1,1,0,9,3,116,97,3,91,1,1,0,0,1,19,1,7,0,0,0,9,2,110010084101001,1,104,104,1,psa_21,1D2
1000000US110010107001017,"Block 1017, Block Group 1, Census Tract 107, District of Columbia, District of Columbia",0,0,0,0,0,0,0,0,0,0,0,0,0,0,0,0,0,0,0,0,0,0,0,0,0,110010107001017,2,207,207,2,psa_24,2D3
1000000US110010014022000,"Block 2000, Block Group 2, Census Tract 14.02, District of Columbia, District of Columbia",390,318,48,0,4,0,7,13,390,376,313,48,0,4,0,0,11,14,5,0,0,0,0,7,2,110010014022000,2,201,201,2,psa_55,2D1
1000000US110010062021213,"Block 1213, Block Group 1, Census Tract 62.02, District of Columbia, District of Columbia",0,0,0,0,0,0,0,0,0,0,0,0,0,0,0,0,0,0,0,0,0,0,0,0,0,110010062021213,1,103,103,1,psa_12,1D1
1000000US110010072002060,"Block 2060, Block Group 2, Census Tract 72, District of Columbia, District of Columbia",0,0,0,0,0,0,0,0,0,0,0,0,0,0,0,0,0,0,0,0,0,0,0,0,0,110010072002060,1,106,106,1,psa_13,1D3
1000000US110010092041001,"Block 1001, Block Group 1, Census Tract 92.04, District of Columbia, District of Columbia",150,9,128,0,0,0,13,0,150,135,9,126,0,0,0,0,0,15,0,2,0,0,0,13,0,110010092041001,5,502,502,5,psa_40,5D1
1000000US110010002021001,"Block 1001, Block Group 1, Census Tract 2.02, District of Columbia, District of Columbia",174,152,11,0,7,1,2,1,174,167,146,11,0,7,1,1,1,7,6,0,0,0,0,1,0,110010002021001,2,206,206,2,psa_29,2D2
1000000US110010021022000,"Block 2000, Block Group 2, Census Tract 21.02, District of Columbia, District of Columbia",155,19,122,0,1,0,8,5,155,135,12,117,0,1,0,0,5,20,7,5,0,0,0,8,0,110010021022000,4,406,406,4,psa_54,4D2
1000000US110010035001005,"Block 1005, Block Group 1, Census Tract 35, District of Columbia, District of Columbia",214,121,63,0,18,0,5,7,214,179,96,61,0,18,0,0,4,35,25,2,0,0,0,5,3,110010035001005,3,304,304,3,psa_36,3D1
1000000US110010062021052,"Block 1052, Block Group 1, Census Tract 62.02, District of Columbia, District of Columbia",0,0,0,0,0,0,0,0,0,0,0,0,0,0,0,0,0,0,0,0,0,0,0,0,0,110010062021052,2,207,207,2,psa_24,2D3
1000000US110010008013004,"Block 3004, Block Group 3, Census Tract 8.01, District of Columbia, District of Columbia",31,27,3,0,1,0,0,0,31,31,27,3,0,1,0,0,0,0,0,0,0,0,0,0,0,110010008013004,2,205,205,2,psa_46,2D2
1000000US110010073011004,"Block 1004, Block Group 1, Census Tract 73.01, District of Columbia, District of Columbia",0,0,0,0,0,0,0,0,0,0,0,0,0,0,0,0,0,0,0,0,0,0,0,0,0,110010073011004,7,703,703,7,psa_8,7D1
1000000US110010050023007,"Block 3007, Block Group 3, Census Tract 50.02, District of Columbia, District of Columbia",267,221,24,0,11,0,4,7,267,254,213,23,0,11,0,1,6,13,8,1,0,0,0,3,1,110010050023007,3,307,307,3,psa_28,3D3
1000000US110010062021067,"Block 1067, Block Group 1, Census Tract 62.02, District of Columbia, District of Columbia",0,0,0,0,0,0,0,0,0,0,0,0,0,0,0,0,0,0,0,0,0,0,0,0,0,110010062021067,2,207,207,2,psa_24,2D3
1000000US110010073011047,"Block 1047, Block Group 1, Census Tract 73.01, District of Columbia, District of Columbia",0,0,0,0,0,0,0,0,0,0,0,0,0,0,0,0,0,0,0,0,0,0,0,0,0,110010073011047,7,708,708,7,psa_1,7D3
1000000US110010096011030,"Block 1030, Block Group 1, Census Tract 96.01, District of Columbia, District of Columbia",40,1,34,0,0,0,5,0,40,35,1,34,0,0,0,0,0,5,0,0,0,0,0,5,0,110010096011030,6,601,601,6,psa_30,6D1
1000000US110010021022006,"Block 2006, Block Group 2, Census Tract 21.02, District of Columbia, District of Columbia",53,1,50,0,0,0,0,2,53,52,1,49,0,0,0,0,2,1,0,1,0,0,0,0,0,110010021022006,4,403,403,4,psa_51,4D1
1000000US110010081003005,"Block 3005, Block Group 3, Census Tract 81, District of Columbia, District of Columbia",0,0,0,0,0,0,0,0,0,0,0,0,0,0,0,0,0,0,0,0,0,0,0,0,0,110010081003005,1,108,108,1,psa_17,1D2
1000000US110010016002006,"Block 2006, Block Group 2, Census Tract 16, District of Columbia, District of Columbia",44,23,19,0,0,0,2,0,44,44,23,19,0,0,0,2,0,0,0,0,0,0,0,0,0,110010016002006,4,401,401,4,psa_56,4D1
1000000US110010040013008,"Block 3008, Block Group 3, Census Tract 40.01, District of Columbia, District of Columbia",245,221,5,0,8,0,11,0,245,227,214,5,0,8,0,0,0,18,7,0,0,0,0,11,0,110010040013008,3,303,303,3,psa_37,3D3
1000000US110010014011011,"Block 1011, Block Group 1, Census Tract 14.01, District of Columbia, District of Columbia",39,37,0,0,1,0,0,1,39,36,34,0,0,1,0,0,1,3,3,0,0,0,0,0,0,110010014011011,2,201,201,2,psa_55,2D1
1000000US110010027012003,"Block 2003, Block Group 2, Census Tract 27.01, District of Columbia, District of Columbia",396,225,66,3,26,0,58,18,396,294,197,62,0,24,0,1,10,102,28,4,3,2,0,57,8,110010027012003,3,302,302,3,psa_42,3D1
1000000US110010076051007,"Block 1007, Block Group 1, Census Tract 76.05, District of Columbia, District of Columbia",32,0,31,1,0,0,0,0,32,32,0,31,1,0,0,0,0,0,0,0,0,0,0,0,0,110010076051007,6,607,607,6,psa_10,6D2
1000000US110010068041016,"Block 1016, Block Group 1, Census Tract 68.04, District of Columbia, District of Columbia",0,0,0,0,0,0,0,0,0,0,0,0,0,0,0,0,0,0,0,0,0,0,0,0,0,110010068041016,1,107,107,1,psa_16,1D2
1000000US110010073011142,"Block 1142, Block Group 1, Census Tract 73.01, District of Columbia, District of Columbia",97,55,16,0,12,0,0,14,97,83,51,14,0,9,0,0,9,14,4,2,0,3,0,0,5,110010073011142,7,707,707,7,psa_4,7D2
1000000US110010078041013,"Block 1013, Block Group 1, Census Tract 78.04, District of Columbia, District of Columbia",16,0,16,0,0,0,0,0,16,16,0,16,0,0,0,0,0,0,0,0,0,0,0,0,0,110010078041013,6,602,602,6,psa_25,6D1
1000000US110010095012003,"Block 2003, Block Group 2, Census Tract 95.01, District of Columbia, District of Columbia",144,16,117,0,2,0,1,8,144,135,13,115,0,1,0,1,5,9,3,2,0,1,0,0,3,110010095012003,4,405,405,4,psa_49,4D2
1000000US110010016001009,"Block 1009, Block Group 1, Census Tract 16, District of Columbia, District of Columbia",38,2,35,1,0,0,0,0,38,34,1,32,1,0,0,0,0,4,1,3,0,0,0,0,0,110010016001009,4,401,401,4,psa_56,4D1
1000000US110010076042023,"Block 2023, Block Group 2, Census Tract 76.04, District of Columbia, District of Columbia",19,2,17,0,0,0,0,0,19,19,2,17,0,0,0,0,0,0,0,0,0,0,0,0,0,110010076042023,6,606,606,6,psa_7,6D2
1000000US110010091021009,"Block 1009, Block Group 1, Census Tract 91.02, District of Columbia, District of Columbia",41,0,39,0,0,0,2,0,41,40,0,39,0,0,0,1,0,1,0,0,0,0,0,1,0,110010091021009,5,505,505,5,psa_34,5D2
1000000US110010099042009,"Block 2009, Block Group 2, Census Tract 99.04, District of Columbia, District of Columbia",493,5,478,1,6,0,0,3,493,488,0,478,1,6,0,0,3,5,5,0,0,0,0,0,0,110010099042009,6,604,604,6,psa_14,6D3
1000000US110010042021010,"Block 1010, Block Group 1, Census Tract 42.02, District of Columbia, District of Columbia",0,0,0,0,0,0,0,0,0,0,0,0,0,0,0,0,0,0,0,0,0,0,0,0,0,110010042021010,2,208,208,2,psa_33,2D3
1000000US110010001004028,"Block 4028, Block Group 4, Census Tract 1, District of Columbia, District of Columbia",0,0,0,0,0,0,0,0,0,0,0,0,0,0,0,0,0,0,0,0,0,0,0,0,0,110010001004028,2,206,206,2,psa_29,2D2
1000000US110010072002058,"Block 2058, Block Group 2, Census Tract 72, District of Columbia, District of Columbia",0,0,0,0,0,0,0,0,0,0,0,0,0,0,0,0,0,0,0,0,0,0,0,0,0,110010072002058,1,106,106,1,psa_13,1D3
1000000US110010046002011,"Block 2011, Block Group 2, Census Tract 46, District of Columbia, District of Columbia",0,0,0,0,0,0,0,0,0,0,0,0,0,0,0,0,0,0,0,0,0,0,0,0,0,110010046002011,3,308,308,3,psa_27,3D2
1000000US110010011002028,"Block 2028, Block Group 2, Census Tract 11, District of Columbia, District of Columbia",48,38,6,0,1,0,2,1,48,46,38,6,0,1,0,1,0,2,0,0,0,0,0,1,1,110010011002028,2,202,202,2,psa_52,2D1
1000000US110010068041010,"Block 1010, Block Group 1, Census Tract 68.04, District of Columbia, District of Columbia",0,0,0,0,0,0,0,0,0,0,0,0,0,0,0,0,0,0,0,0,0,0,0,0,0,110010068041010,1,108,108,1,psa_17,1D2
1000000US110010011004002,"Block 4002, Block Group 4, Census Tract 11, District of Columbia, District of Columbia",48,48,0,0,0,0,0,0,48,44,44,0,0,0,0,0,0,4,4,0,0,0,0,0,0,110010011004002,2,202,202,2,psa_52,2D1
1000000US110010079013002,"Block 3002, Block Group 3, Census Tract 79.01, District of Columbia, District of Columbia",114,20,91,0,0,0,0,3,114,107,14,91,0,0,0,0,2,7,6,0,0,0,0,0,1,110010079013002,5,507,507,5,psa_23,5D3
1000000US110010078091002,"Block 1002, Block Group 1, Census Tract 78.09, District of Columbia, District of Columbia",307,5,294,0,1,0,0,7,307,303,1,294,0,1,0,0,7,4,4,0,0,0,0,0,0,110010078091002,6,608,608,6,psa_19,6D1
1000000US110010096041012,"Block 1012, Block Group 1, Census Tract 96.04, District of Columbia, District of Columbia",156,0,155,0,0,0,0,1,156,156,0,155,0,0,0,0,1,0,0,0,0,0,0,0,0,110010096041012,6,603,603,6,psa_15,6D3
1000000US110010095032008,"Block 2008, Block Group 2, Census Tract 95.03, District of Columbia, District of Columbia",67,7,58,0,1,0,0,1,67,67,7,58,0,1,0,0,1,0,0,0,0,0,0,0,0,110010095032008,5,504,504,5,psa_43,5D2
1000000US110010044002017,"Block 2017, Block Group 2, Census Tract 44, District of Columbia, District of Columbia",46,25,19,0,2,0,0,0,46,46,25,19,0,2,0,0,0,0,0,0,0,0,0,0,0,110010044002017,3,305,305,3,psa_32,3D2
1000000US110010004002029,"Block 2029, Block Group 2, Census Tract 4, District of Columbia, District of Columbia",305,240,16,0,37,0,6,6,305,278,220,16,0,37,0,0,5,27,20,0,0,0,0,6,1,110010004002029,2,204,204,2,psa_44,2D2
1000000US110010102002013,"Block 2013, Block Group 2, Census Tract 102, District of Columbia, District of Columbia",0,0,0,0,0,0,0,0,0,0,0,0,0,0,0,0,0,0,0,0,0,0,0,0,0,110010102002013,1,103,103,1,psa_12,1D1
1000000US110010010012021,"Block 2021, Block Group 2, Census Tract 10.01, District of Columbia, District of Columbia",0,0,0,0,0,0,0,0,0,0,0,0,0,0,0,0,0,0,0,0,0,0,0,0,0,110010010012021,2,202,202,2,psa_52,2D1
1000000US110010077032007,"Block 2007, Block Group 2, Census Tract 77.03, District of Columbia, District of Columbia",231,2,223,0,0,0,0,6,231,227,2,219,0,0,0,0,6,4,0,4,0,0,0,0,0,110010077032007,6,603,603,6,psa_15,6D3
1000000US110010075032002,"Block 2002, Block Group 2, Census Tract 75.03, District of Columbia, District of Columbia",166,7,149,2,4,0,4,0,166,161,7,149,0,4,0,1,0,5,0,0,2,0,0,3,0,110010075032002,7,701,701,7,psa_9,7D1
1000000US110010073011034,"Block 1034, Block Group 1, Census Tract 73.01, District of Columbia, District of Columbia",0,0,0,0,0,0,0,0,0,0,0,0,0,0,0,0,0,0,0,0,0,0,0,0,0,110010073011034,7,707,707,7,psa_4,7D2
1000000US110010095031004,"Block 1004, Block Group 1, Census Tract 95.03, District of Columbia, District of Columbia",0,0,0,0,0,0,0,0,0,0,0,0,0,0,0,0,0,0,0,0,0,0,0,0,0,110010095031004,4,405,405,4,psa_49,4D2
1000000US110010104002029,"Block 2029, Block Group 2, Census Tract 104, District of Columbia, District of Columbia",0,0,0,0,0,0,0,0,0,0,0,0,0,0,0,0,0,0,0,0,0,0,0,0,0,110010104002029,7,703,703,7,psa_8,7D1
1000000US110010014011015,"Block 1015, Block Group 1, Census Tract 14.01, District of Columbia, District of Columbia",96,85,8,0,0,0,0,3,96,95,84,8,0,0,0,0,3,1,1,0,0,0,0,0,0,110010014011015,2,201,201,2,psa_55,2D1
1000000US110010111003049,"Block 3049, Block Group 3, Census Tract 111, District of Columbia, District of Columbia",0,0,0,0,0,0,0,0,0,0,0,0,0,0,0,0,0,0,0,0,0,0,0,0,0,110010111003049,5,503,503,5,psa_45,5D2
1000000US110010023021021,"Block 1021, Block Group 1, Census Tract 23.02, District of Columbia, District of Columbia",0,0,0,0,0,0,0,0,0,0,0,0,0,0,0,0,0,0,0,0,0,0,0,0,0,110010023021021,4,405,405,4,psa_49,4D2
1000000US110010096032005,"Block 2005, Block Group 2, Census Tract 96.03, District of Columbia, District of Columbia",86,0,84,0,0,0,2,0,86,84,0,83,0,0,0,1,0,2,0,1,0,0,0,1,0,110010096032005,6,603,603,6,psa_15,6D3
1000000US110010073011036,"Block 1036, Block Group 1, Census Tract 73.01, District of Columbia, District of Columbia",30,11,14,0,3,0,0,2,30,27,8,14,0,3,0,0,2,3,3,0,0,0,0,0,0,110010073011036,7,707,707,7,psa_4,7D2
1000000US110010111002014,"Block 2014, Block Group 2, Census Tract 111, District of Columbia, District of Columbia",109,11,78,0,2,0,16,2,109,93,11,78,0,2,0,0,2,16,0,0,0,0,0,16,0,110010111002014,5,503,503,5,psa_45,5D2
1000000US110010087011011,"Block 1011, Block Group 1, Census Tract 87.01, District of Columbia, District of Columbia",92,21,71,0,0,0,0,0,92,88,21,67,0,0,0,0,0,4,0,4,0,0,0,0,0,110010087011011,5,502,502,5,psa_40,5D1
1000000US110010093013004,"Block 3004, Block Group 3, Census Tract 93.01, District of Columbia, District of Columbia",44,9,32,0,1,0,0,2,44,34,2,30,0,1,0,0,1,10,7,2,0,0,0,0,1,110010093013004,5,504,504,5,psa_43,5D2
1000000US110010099021001,"Block 1001, Block Group 1, Census Tract 99.02, District of Columbia, District of Columbia",43,3,40,0,0,0,0,0,43,43,3,40,0,0,0,0,0,0,0,0,0,0,0,0,0,110010099021001,6,605,605,6,psa_11,6D2
1000000US110010068021001,"Block 1001, Block Group 1, Census Tract 68.02, District of Columbia, District of Columbia",141,47,86,1,2,0,3,2,141,134,43,86,1,2,0,2,0,7,4,0,0,0,0,1,2,110010068021001,1,107,107,1,psa_16,1D2
1000000US110010004001021,"Block 1021, Block Group 1, Census Tract 4, District of Columbia, District of Columbia",28,28,0,0,0,0,0,0,28,28,28,0,0,0,0,0,0,0,0,0,0,0,0,0,0,110010004001021,2,204,204,2,psa_44,2D2
1000000US110010009012005,"Block 2005, Block Group 2, Census Tract 9.01, District of Columbia, District of Columbia",0,0,0,0,0,0,0,0,0,0,0,0,0,0,0,0,0,0,0,0,0,0,0,0,0,110010009012005,2,205,205,2,psa_46,2D2
1000000US110010062021046,"Block 1046, Block Group 1, Census Tract 62.02, District of Columbia, District of Columbia",0,0,0,0,0,0,0,0,0,0,0,0,0,0,0,0,0,0,0,0,0,0,0,0,0,110010062021046,2,207,207,2,psa_24,2D3
1000000US110010064002004,"Block 2004, Block Group 2, Census Tract 64, District of Columbia, District of Columbia",195,13,163,9,0,0,4,6,195,192,12,163,9,0,0,2,6,3,1,0,0,0,0,2,0,110010064002004,1,105,105,1,psa_22,1D3
1000000US110010012001009,"Block 1009, Block Group 1, Census Tract 12, District of Columbia, District of Columbia",38,28,0,0,3,0,5,2,38,34,26,0,0,3,0,3,2,4,2,0,0,0,0,2,0,110010012001009,2,203,203,2,psa_50,2D1
1000000US110010099021009,"Block 1009, Block Group 1, Census Tract 99.02, District of Columbia, District of Columbia",43,2,41,0,0,0,0,0,43,43,2,41,0,0,0,0,0,0,0,0,0,0,0,0,0,110010099021009,6,605,605,6,psa_11,6D2
1000000US110010102002033,"Block 2033, Block Group 2, Census Tract 102, District of Columbia, District of Columbia",0,0,0,0,0,0,0,0,0,0,0,0,0,0,0,0,0,0,0,0,0,0,0,0,0,110010102002033,1,103,103,1,psa_12,1D1
1000000US110010004001001,"Block 1001, Block Group 1, Census Tract 4, District of Columbia, District of Columbia",0,0,0,0,0,0,0,0,0,0,0,0,0,0,0,0,0,0,0,0,0,0,0,0,0,110010004001001,2,204,204,2,psa_44,2D2
1000000US110010094004008,"Block 4008, Block Group 4, Census Tract 94, District of Columbia, District of Columbia",41,0,39,0,0,0,0,2,41,41,0,39,0,0,0,0,2,0,0,0,0,0,0,0,0,110010094004008,5,503,503,5,psa_45,5D2
1000000US110010096041000,"Block 1000, Block Group 1, Census Tract 96.04, District of Columbia, District of Columbia",0,0,0,0,0,0,0,0,0,0,0,0,0,0,0,0,0,0,0,0,0,0,0,0,0,110010096041000,6,603,603,6,psa_15,6D3
1000000US110010032002004,"Block 2004, Block Group 2, Census Tract 32, District of Columbia, District of Columbia",126,33,83,1,0,0,9,0,126,110,27,82,1,0,0,0,0,16,6,1,0,0,0,9,0,110010032002004,4,409,409,4,psa_41,4D3
1000000US110010104002001,"Block 2001, Block Group 2, Census Tract 104, District of Columbia, District of Columbia",77,0,77,0,0,0,0,0,77,76,0,76,0,0,0,0,0,1,0,1,0,0,0,0,0,110010104002001,7,703,703,7,psa_8,7D1
1000000US110010017021014,"Block 1014, Block Group 1, Census Tract 17.02, District of Columbia, District of Columbia",41,13,17,0,1,0,5,5,41,36,13,17,0,1,0,0,5,5,0,0,0,0,0,5,0,110010017021014,4,401,401,4,psa_56,4D1
1000000US110010095032007,"Block 2007, Block Group 2, Census Tract 95.03, District of Columbia, District of Columbia",84,10,57,0,1,0,4,12,84,75,7,54,0,1,0,1,12,9,3,3,0,0,0,3,0,110010095032007,5,504,504,5,psa_43,5D2
1000000US110010009013001,"Block 3001, Block Group 3, Census Tract 9.01, District of Columbia, District of Columbia",48,45,1,0,2,0,0,0,48,38,35,1,0,2,0,0,0,10,10,0,0,0,0,0,0,110010009013001,2,205,205,2,psa_46,2D2
1000000US110010079012005,"Block 2005, Block Group 2, Census Tract 79.01, District of Columbia, District of Columbia",124,33,88,1,1,0,0,1,124,117,26,88,1,1,0,0,1,7,7,0,0,0,0,0,0,110010079012005,5,507,507,5,psa_23,5D3
1000000US110010102001003,"Block 1003, Block Group 1, Census Tract 102, District of Columbia, District of Columbia",0,0,0,0,0,0,0,0,0,0,0,0,0,0,0,0,0,0,0,0,0,0,0,0,0,110010102001003,1,103,103,1,psa_12,1D1
1000000US110010058001016,"Block 1016, Block Group 1, Census Tract 58, District of Columbia, District of Columbia",0,0,0,0,0,0,0,0,0,0,0,0,0,0,0,0,0,0,0,0,0,0,0,0,0,110010058001016,1,101,101,1,psa_20,1D1
1000000US110010093011011,"Block 1011, Block Group 1, Census Tract 93.01, District of Columbia, District of Columbia",45,11,27,0,0,0,0,7,45,38,9,26,0,0,0,0,3,7,2,1,0,0,0,0,4,110010093011011,5,504,504,5,psa_43,5D2
1000000US110010020021005,"Block 1005, Block Group 1, Census Tract 20.02, District of Columbia, District of Columbia",20,12,8,0,0,0,0,0,20,20,12,8,0,0,0,0,0,0,0,0,0,0,0,0,0,110010020021005,4,404,404,4,psa_48,4D3
1000000US110010078042008,"Block 2008, Block Group 2, Census Tract 78.04, District of Columbia, District of Columbia",267,2,244,0,0,0,14,7,267,252,1,244,0,0,0,0,7,15,1,0,0,0,0,14,0,110010078042008,6,602,602,6,psa_25,6D1
1000000US110010050011009,"Block 1009, Block Group 1, Census Tract 50.01, District of Columbia, District of Columbia",56,37,10,0,0,0,8,1,56,52,37,10,0,0,0,4,1,4,0,0,0,0,0,4,0,110010050011009,3,307,307,3,psa_28,3D3
1000000US110010022012014,"Block 2014, Block Group 2, Census Tract 22.01, District of Columbia, District of Columbia",0,0,0,0,0,0,0,0,0,0,0,0,0,0,0,0,0,0,0,0,0,0,0,0,0,110010022012014,4,407,407,4,psa_47,4D2
1000000US110010047012001,"Block 2001, Block Group 2, Census Tract 47.01, District of Columbia, District of Columbia",0,0,0,0,0,0,0,0,0,0,0,0,0,0,0,0,0,0,0,0,0,0,0,0,0,110010047012001,1,102,102,1,psa_18,1D1
1000000US110010044001017,"Block 1017, Block Group 1, Census Tract 44, District of Columbia, District of Columbia",377,285,44,0,29,0,7,12,377,352,267,44,0,28,0,1,12,25,18,0,0,1,0,6,0,110010044001017,3,305,305,3,psa_32,3D2
1000000US110010093011008,"Block 1008, Block Group 1, Census Tract 93.01, District of Columbia, District of Columbia",31,13,16,0,0,0,0,2,31,31,13,16,0,0,0,0,2,0,0,0,0,0,0,0,0,110010093011008,5,504,504,5,psa_43,5D2
1000000US110010098101003,"Block 1003, Block Group 1, Census Tract 98.10, District of Columbia, District of Columbia",0,0,0,0,0,0,0,0,0,0,0,0,0,0,0,0,0,0,0,0,0,0,0,0,0,110010098101003,7,708,708,7,psa_1,7D3
1000000US110010010015008,"Block 5008, Block Group 5, Census Tract 10.01, District of Columbia, District of Columbia",61,50,0,1,6,0,0,4,61,61,50,0,1,6,0,0,4,0,0,0,0,0,0,0,0,110010010015008,2,202,202,2,psa_52,2D1
1000000US110010099041009,"Block 1009, Block Group 1, Census Tract 99.04, District of Columbia, District of Columbia",0,0,0,0,0,0,0,0,0,0,0,0,0,0,0,0,0,0,0,0,0,0,0,0,0,110010099041009,6,604,604,6,psa_14,6D3
1000000US110010102002037,"Block 2037, Block Group 2, Census Tract 102, District of Columbia, District of Columbia",0,0,0,0,0,0,0,0,0,0,0,0,0,0,0,0,0,0,0,0,0,0,0,0,0,110010102002037,1,103,103,1,psa_12,1D1
1000000US110010010012031,"Block 2031, Block Group 2, Census Tract 10.01, District of Columbia, District of Columbia",37,16,14,0,3,0,4,0,37,32,13,14,0,3,0,2,0,5,3,0,0,0,0,2,0,110010010012031,2,202,202,2,psa_52,2D1
1000000US110010064002012,"Block 2012, Block Group 2, Census Tract 64, District of Columbia, District of Columbia",0,0,0,0,0,0,0,0,0,0,0,0,0,0,0,0,0,0,0,0,0,0,0,0,0,110010064002012,1,105,105,1,psa_22,1D3
1000000US110010075031009,"Block 1009, Block Group 1, Census Tract 75.03, District of Columbia, District of Columbia",41,0,41,0,0,0,0,0,41,41,0,41,0,0,0,0,0,0,0,0,0,0,0,0,0,110010075031009,7,701,701,7,psa_9,7D1
1000000US110010075031006,"Block 1006, Block Group 1, Census Tract 75.03, District of Columbia, District of Columbia",36,0,36,0,0,0,0,0,36,36,0,36,0,0,0,0,0,0,0,0,0,0,0,0,0,110010075031006,7,701,701,7,psa_9,7D1
1000000US110010093012000,"Block 2000, Block Group 2, Census Tract 93.01, District of Columbia, District of Columbia",35,14,20,0,1,0,0,0,35,31,11,19,0,1,0,0,0,4,3,1,0,0,0,0,0,110010093012000,5,504,504,5,psa_43,5D2
1000000US110010098011009,"Block 1009, Block Group 1, Census Tract 98.01, District of Columbia, District of Columbia",0,0,0,0,0,0,0,0,0,0,0,0,0,0,0,0,0,0,0,0,0,0,0,0,0,110010098011009,7,708,708,7,psa_1,7D3
1000000US110010010011010,"Block 1010, Block Group 1, Census Tract 10.01, District of Columbia, District of Columbia",79,75,0,0,4,0,0,0,79,77,74,0,0,3,0,0,0,2,1,0,0,1,0,0,0,110010010011010,2,202,202,2,psa_52,2D1
1000000US110010109002015,"Block 2015, Block Group 2, Census Tract 109, District of Columbia, District of Columbia",0,0,0,0,0,0,0,0,0,0,0,0,0,0,0,0,0,0,0,0,0,0,0,0,0,110010109002015,7,708,708,7,psa_1,7D3
1000000US110010009013000,"Block 3000, Block Group 3, Census Tract 9.01, District of Columbia, District of Columbia",0,0,0,0,0,0,0,0,0,0,0,0,0,0,0,0,0,0,0,0,0,0,0,0,0,110010009013000,2,205,205,2,psa_46,2D2
1000000US110010078062014,"Block 2014, Block Group 2, Census Tract 78.06, District of Columbia, District of Columbia",50,0,50,0,0,0,0,0,50,50,0,50,0,0,0,0,0,0,0,0,0,0,0,0,0,110010078062014,6,602,602,6,psa_25,6D1
1000000US110010032004005,"Block 4005, Block Group 4, Census Tract 32, District of Columbia, District of Columbia",0,0,0,0,0,0,0,0,0,0,0,0,0,0,0,0,0,0,0,0,0,0,0,0,0,110010032004005,4,409,409,4,psa_41,4D3
1000000US110010018042012,"Block 2012, Block Group 2, Census Tract 18.04, District of Columbia, District of Columbia",25,6,16,0,0,0,1,2,25,22,5,15,0,0,0,0,2,3,1,1,0,0,0,1,0,110010018042012,4,402,402,4,psa_53,4D1
1000000US110010070002002,"Block 2002, Block Group 2, Census Tract 70, District of Columbia, District of Columbia",0,0,0,0,0,0,0,0,0,0,0,0,0,0,0,0,0,0,0,0,0,0,0,0,0,110010070002002,1,107,107,1,psa_16,1D2
1000000US110010095051002,"Block 1002, Block Group 1, Census Tract 95.05, District of Columbia, District of Columbia",17,0,17,0,0,0,0,0,17,17,0,17,0,0,0,0,0,0,0,0,0,0,0,0,0,110010095051002,4,406,406,4,psa_54,4D2
1000000US110010072001025,"Block 1025, Block Group 1, Census Tract 72, District of Columbia, District of Columbia",0,0,0,0,0,0,0,0,0,0,0,0,0,0,0,0,0,0,0,0,0,0,0,0,0,110010072001025,1,106,106,1,psa_13,1D3
1000000US110010003004001,"Block 4001, Block Group 4, Census Tract 3, District of Columbia, District of Columbia",218,199,4,0,9,0,0,6,218,209,191,4,0,9,0,0,5,9,8,0,0,0,0,0,1,110010003004001,2,204,204,2,psa_44,2D2
1000000US110010019011000,"Block 1000, Block Group 1, Census Tract 19.01, District of Columbia, District of Columbia",101,1,98,0,0,0,0,2,101,101,1,98,0,0,0,0,2,0,0,0,0,0,0,0,0,110010019011000,4,402,402,4,psa_53,4D1
1000000US110010074072007,"Block 2007, Block Group 2, Census Tract 74.07, District of Columbia, District of Columbia",119,1,114,0,4,0,0,0,119,118,1,113,0,4,0,0,0,1,0,1,0,0,0,0,0,110010074072007,7,703,703,7,psa_8,7D1
1000000US110010093011012,"Block 1012, Block Group 1, Census Tract 93.01, District of Columbia, District of Columbia",38,4,29,0,0,0,5,0,38,33,4,29,0,0,0,0,0,5,0,0,0,0,0,5,0,110010093011012,5,504,504,5,psa_43,5D2
1000000US110010036003004,"Block 3004, Block Group 3, Census Tract 36, District of Columbia, District of Columbia",104,51,35,0,0,0,11,7,104,78,40,35,0,0,0,0,3,26,11,0,0,0,0,11,4,110010036003004,3,304,304,3,psa_36,3D1
1000000US110010078083007,"Block 3007, Block Group 3, Census Tract 78.08, District of Columbia, District of Columbia",150,2,127,0,0,0,18,3,150,130,0,127,0,0,0,1,2,20,2,0,0,0,0,17,1,110010078083007,6,608,608,6,psa_19,6D1
1000000US110010041002010,"Block 2010, Block Group 2, Census Tract 41, District of Columbia, District of Columbia",248,216,12,1,12,2,5,0,248,232,204,12,1,12,2,1,0,16,12,0,0,0,0,4,0,110010041002010,2,208,208,2,psa_33,2D3
1000000US110010093013003,"Block 3003, Block Group 3, Census Tract 93.01, District of Columbia, District of Columbia",42,10,23,0,7,0,0,2,42,41,10,22,0,7,0,0,2,1,0,1,0,0,0,0,0,110010093013003,5,504,504,5,psa_43,5D2
1000000US110010099042000,"Block 2000, Block Group 2, Census Tract 99.04, District of Columbia, District of Columbia",6,0,6,0,0,0,0,0,6,6,0,6,0,0,0,0,0,0,0,0,0,0,0,0,0,110010099042000,6,604,604,6,psa_14,6D3
1000000US110010008012002,"Block 2002, Block Group 2, Census Tract 8.01, District of Columbia, District of Columbia",34,30,0,0,3,0,0,1,34,34,30,0,0,3,0,0,1,0,0,0,0,0,0,0,0,110010008012002,2,205,205,2,psa_46,2D2
1000000US110010095042002,"Block 2002, Block Group 2, Census Tract 95.04, District of Columbia, District of Columbia",56,8,48,0,0,0,0,0,56,55,7,48,0,0,0,0,0,1,1,0,0,0,0,0,0,110010095042002,4,405,405,4,psa_49,4D2
1000000US110010076041009,"Block 1009, Block Group 1, Census Tract 76.04, District of Columbia, District of Columbia",236,7,227,0,1,0,0,1,236,233,6,225,0,1,0,0,1,3,1,2,0,0,0,0,0,110010076041009,6,607,607,6,psa_10,6D2
1000000US110010091022008,"Block 2008, Block Group 2, Census Tract 91.02, District of Columbia, District of Columbia",166,2,148,0,0,0,16,0,166,148,2,146,0,0,0,0,0,18,0,2,0,0,0,16,0,110010091022008,5,505,505,5,psa_34,5D2
1000000US110010108001006,"Block 1006, Block Group 1, Census Tract 108.00, District of Columbia, District of Columbia",198,171,6,0,15,0,0,6,198,198,171,6,0,15,0,0,6,0,0,0,0,0,0,0,0,110010108001006,2,207,207,2,psa_24,2D3
1000000US110010001003004,"Block 3004, Block Group 3, Census Tract 1, District of Columbia, District of Columbia",52,43,6,0,3,0,0,0,52,48,40,6,0,2,0,0,0,4,3,0,0,1,0,0,0,110010001003004,2,206,206,2,psa_29,2D2
1000000US110010016002000,"Block 2000, Block Group 2, Census Tract 16, District of Columbia, District of Columbia",0,0,0,0,0,0,0,0,0,0,0,0,0,0,0,0,0,0,0,0,0,0,0,0,0,110010016002000,4,401,401,4,psa_56,4D1
1000000US110010073011028,"Block 1028, Block Group 1, Census Tract 73.01, District of Columbia, District of Columbia",0,0,0,0,0,0,0,0,0,0,0,0,0,0,0,0,0,0,0,0,0,0,0,0,0,110010073011028,7,703,703,7,psa_8,7D1
1000000US110010076043005,"Block 3005, Block Group 3, Census Tract 76.04, District of Columbia, District of Columbia",126,6,116,1,0,0,1,2,126,117,0,115,0,0,0,0,2,9,6,1,1,0,0,1,0,110010076043005,6,607,607,6,psa_10,6D2
1000000US110010080021011,"Block 1011, Block Group 1, Census Tract 80.02, District of Columbia, District of Columbia",276,230,31,0,10,0,1,4,276,269,225,30,0,10,0,0,4,7,5,1,0,0,0,1,0,110010080021011,1,108,108,1,psa_17,1D2
1000000US110010089031016,"Block 1016, Block Group 1, Census Tract 89.03, District of Columbia, District of Columbia",0,0,0,0,0,0,0,0,0,0,0,0,0,0,0,0,0,0,0,0,0,0,0,0,0,110010089031016,5,507,507,5,psa_23,5D3
1000000US110010102001007,"Block 1007, Block Group 1, Census Tract 102, District of Columbia, District of Columbia",0,0,0,0,0,0,0,0,0,0,0,0,0,0,0,0,0,0,0,0,0,0,0,0,0,110010102001007,1,103,103,1,psa_12,1D1
1000000US110010065002016,"Block 2016, Block Group 2, Census Tract 65, District of Columbia, District of Columbia",0,0,0,0,0,0,0,0,0,0,0,0,0,0,0,0,0,0,0,0,0,0,0,0,0,110010065002016,1,107,107,1,psa_16,1D2
1000000US110010075022003,"Block 2003, Block Group 2, Census Tract 75.02, District of Columbia, District of Columbia",144,3,134,0,0,0,3,4,144,141,2,132,0,0,0,3,4,3,1,2,0,0,0,0,0,110010075022003,7,702,702,7,psa_6,7D1
1000000US110010105002013,"Block 2013, Block Group 2, Census Tract 105, District of Columbia, District of Columbia",0,0,0,0,0,0,0,0,0,0,0,0,0,0,0,0,0,0,0,0,0,0,0,0,0,110010105002013,1,103,103,1,psa_12,1D1
1000000US110010076042013,"Block 2013, Block Group 2, Census Tract 76.04, District of Columbia, District of Columbia",33,4,29,0,0,0,0,0,33,32,3,29,0,0,0,0,0,1,1,0,0,0,0,0,0,110010076042013,6,606,606,6,psa_7,6D2
1000000US110010010013014,"Block 3014, Block Group 3, Census Tract 10.01, District of Columbia, District of Columbia",46,43,0,0,1,0,0,2,46,46,43,0,0,1,0,0,2,0,0,0,0,0,0,0,0,110010010013014,2,202,202,2,psa_52,2D1
1000000US110010072002057,"Block 2057, Block Group 2, Census Tract 72, District of Columbia, District of Columbia",0,0,0,0,0,0,0,0,0,0,0,0,0,0,0,0,0,0,0,0,0,0,0,0,0,110010072002057,1,106,106,1,psa_13,1D3
1000000US110010082002010,"Block 2010, Block Group 2, Census Tract 82, District of Columbia, District of Columbia",63,59,0,0,0,0,4,0,63,54,54,0,0,0,0,0,0,9,5,0,0,0,0,4,0,110010082002010,1,108,108,1,psa_17,1D2
1000000US110010012001001,"Block 1001, Block Group 1, Census Tract 12, District of Columbia, District of Columbia",0,0,0,0,0,0,0,0,0,0,0,0,0,0,0,0,0,0,0,0,0,0,0,0,0,110010012001001,2,203,203,2,psa_50,2D1
1000000US110010021011010,"Block 1010, Block Group 1, Census Tract 21.01, District of Columbia, District of Columbia",174,31,111,0,0,0,30,2,174,125,12,111,0,0,0,0,2,49,19,0,0,0,0,30,0,110010021011010,4,403,403,4,psa_51,4D1
1000000US110010048011016,"Block 1016, Block Group 1, Census Tract 48.01, District of Columbia, District of Columbia",158,90,24,2,31,5,0,6,158,140,77,24,2,31,0,0,6,18,13,0,0,0,5,0,0,110010048011016,3,308,308,3,psa_27,3D2
1000000US110010088031008,"Block 1008, Block Group 1, Census Tract 88.03, District of Columbia, District of Columbia",57,0,52,0,0,0,0,5,57,57,0,52,0,0,0,0,5,0,0,0,0,0,0,0,0,110010088031008,5,506,506,5,psa_26,5D3
1000000US110010023021018,"Block 1018, Block Group 1, Census Tract 23.02, District of Columbia, District of Columbia",882,217,577,0,46,0,10,32,882,833,192,570,0,46,0,2,23,49,25,7,0,0,0,8,9,110010023021018,4,405,405,4,psa_49,4D2
1000000US110010094004001,"Block 4001, Block Group 4, Census Tract 94, District of Columbia, District of Columbia",22,0,22,0,0,0,0,0,22,22,0,22,0,0,0,0,0,0,0,0,0,0,0,0,0,110010094004001,5,503,503,5,psa_45,5D2
1000000US110010111003056,"Block 3056, Block Group 3, Census Tract 111, District of Columbia, District of Columbia",0,0,0,0,0,0,0,0,0,0,0,0,0,0,0,0,0,0,0,0,0,0,0,0,0,110010111003056,5,507,507,5,psa_23,5D3
1000000US110010014012008,"Block 2008, Block Group 2, Census Tract 14.01, District of Columbia, District of Columbia",49,43,4,0,1,0,1,0,49,46,40,4,0,1,0,1,0,3,3,0,0,0,0,0,0,110010014012008,2,201,201,2,psa_55,2D1
1000000US110010030002001,"Block 2001, Block Group 2, Census Tract 30, District of Columbia, District of Columbia",655,88,534,0,4,0,11,18,655,616,80,517,0,4,0,0,15,39,8,17,0,0,0,11,3,110010030002001,3,302,302,3,psa_42,3D1
1000000US110010107002018,"Block 2018, Block Group 2, Census Tract 107, District of Columbia, District of Columbia",5,4,0,0,0,0,1,0,5,4,4,0,0,0,0,0,0,1,0,0,0,0,0,1,0,110010107002018,2,208,208,2,psa_33,2D3
1000000US110010103002009,"Block 2009, Block Group 2, Census Tract 103, District of Columbia, District of Columbia",149,43,88,0,1,0,12,5,149,135,42,87,0,1,0,1,4,14,1,1,0,0,0,11,1,110010103002009,4,401,401,4,psa_56,4D1
1000000US110010026001014,"Block 1014, Block Group 1, Census Tract 26, District of Columbia, District of Columbia",0,0,0,0,0,0,0,0,0,0,0,0,0,0,0,0,0,0,0,0,0,0,0,0,0,110010026001014,2,203,203,2,psa_50,2D1
1000000US110010062021114,"Block 1114, Block Group 1, Census Tract 62.02, District of Columbia, District of Columbia",0,0,0,0,0,0,0,0,0,0,0,0,0,0,0,0,0,0,0,0,0,0,0,0,0,110010062021114,1,102,102,1,psa_18,1D1
1000000US110010091022005,"Block 2005, Block Group 2, Census Tract 91.02, District of Columbia, District of Columbia",357,18,325,0,4,0,4,6,357,348,18,320,0,4,0,0,6,9,0,5,0,0,0,4,0,110010091022005,5,505,505,5,psa_34,5D2
1000000US110010007014004,"Block 4004, Block Group 4, Census Tract 7.01, District of Columbia, District of Columbia",362,295,16,0,27,0,12,12,362,327,271,16,0,26,0,4,10,35,24,0,0,1,0,8,2,110010007014004,2,204,204,2,psa_44,2D2
1000000US110010102002027,"Block 2027, Block Group 2, Census Tract 102, District of Columbia, District of Columbia",0,0,0,0,0,0,0,0,0,0,0,0,0,0,0,0,0,0,0,0,0,0,0,0,0,110010102002027,1,103,103,1,psa_12,1D1
1000000US110010021024005,"Block 4005, Block Group 4, Census Tract 21.02, District of Columbia, District of Columbia",35,1,33,0,0,0,0,1,35,35,1,33,0,0,0,0,1,0,0,0,0,0,0,0,0,110010021024005,4,403,403,4,psa_51,4D1
1000000US110010095071001,"Block 1001, Block Group 1, Census Tract 95.07, District of Columbia, District of Columbia",341,19,292,10,1,0,9,10,341,299,0,291,1,1,0,0,6,42,19,1,9,0,0,9,4,110010095071001,4,406,406,4,psa_54,4D2
1000000US110010105001002,"Block 1002, Block Group 1, Census Tract 105, District of Columbia, District of Columbia",0,0,0,0,0,0,0,0,0,0,0,0,0,0,0,0,0,0,0,0,0,0,0,0,0,110010105001002,1,103,103,1,psa_12,1D1
1000000US110010004001020,"Block 1020, Block Group 1, Census Tract 4, District of Columbia, District of Columbia",111,88,11,1,6,0,4,1,111,101,80,11,0,6,0,3,1,10,8,0,1,0,0,1,0,110010004001020,2,204,204,2,psa_44,2D2
1000000US110010001002005,"Block 2005, Block Group 2, Census Tract 1, District of Columbia, District of Columbia",0,0,0,0,0,0,0,0,0,0,0,0,0,0,0,0,0,0,0,0,0,0,0,0,0,110010001002005,2,206,206,2,psa_29,2D2
1000000US110010079013004,"Block 3004, Block Group 3, Census Tract 79.01, District of Columbia, District of Columbia",96,18,66,1,2,0,9,0,96,86,18,66,0,2,0,0,0,10,0,0,1,0,0,9,0,110010079013004,5,507,507,5,psa_23,5D3
1000000US110010090001007,"Block 1007, Block Group 1, Census Tract 90, District of Columbia, District of Columbia",0,0,0,0,0,0,0,0,0,0,0,0,0,0,0,0,0,0,0,0,0,0,0,0,0,110010090001007,5,503,503,5,psa_45,5D2
1000000US110010089042005,"Block 2005, Block Group 2, Census Tract 89.04, District of Columbia, District of Columbia",90,1,87,1,0,0,0,1,90,86,0,85,1,0,0,0,0,4,1,2,0,0,0,0,1,110010089042005,5,507,507,5,psa_23,5D3
1000000US110010062021239,"Block 1239, Block Group 1, Census Tract 62.02, District of Columbia, District of Columbia",0,0,0,0,0,0,0,0,0,0,0,0,0,0,0,0,0,0,0,0,0,0,0,0,0,110010062021239,2,207,207,2,psa_24,2D3
1000000US110010004001009,"Block 1009, Block Group 1, Census Tract 4, District of Columbia, District of Columbia",1,1,0,0,0,0,0,0,1,1,1,0,0,0,0,0,0,0,0,0,0,0,0,0,0,110010004001009,2,204,204,2,psa_44,2D2
1000000US110010074012001,"Block 2001, Block Group 2, Census Tract 74.01, District of Columbia, District of Columbia",53,0,53,0,0,0,0,0,53,53,0,53,0,0,0,0,0,0,0,0,0,0,0,0,0,110010074012001,7,703,703,7,psa_8,7D1
1000000US110010077082002,"Block 2002, Block Group 2, Census Tract 77.08, District of Columbia, District of Columbia",0,0,0,0,0,0,0,0,0,0,0,0,0,0,0,0,0,0,0,0,0,0,0,0,0,110010077082002,6,603,603,6,psa_15,6D3
1000000US110010024002007,"Block 2007, Block Group 2, Census Tract 24, District of Columbia, District of Columbia",129,16,113,0,0,0,0,0,129,128,15,113,0,0,0,0,0,1,1,0,0,0,0,0,0,110010024002007,4,407,407,4,psa_47,4D2
1000000US110010107001018,"Block 1018, Block Group 1, Census Tract 107, District of Columbia, District of Columbia",0,0,0,0,0,0,0,0,0,0,0,0,0,0,0,0,0,0,0,0,0,0,0,0,0,110010107001018,2,207,207,2,psa_24,2D3
1000000US110010015001030,"Block 1030, Block Group 1, Census Tract 15, District of Columbia, District of Columbia",0,0,0,0,0,0,0,0,0,0,0,0,0,0,0,0,0,0,0,0,0,0,0,0,0,110010015001030,2,201,201,2,psa_55,2D1
1000000US110010010011013,"Block 1013, Block Group 1, Census Tract 10.01, District of Columbia, District of Columbia",83,72,1,0,5,0,1,4,83,77,67,1,0,5,0,1,3,6,5,0,0,0,0,0,1,110010010011013,2,202,202,2,psa_52,2D1
1000000US110010072002063,"Block 2063, Block Group 2, Census Tract 72, District of Columbia, District of Columbia",0,0,0,0,0,0,0,0,0,0,0,0,0,0,0,0,0,0,0,0,0,0,0,0,0,110010072002063,1,106,106,1,psa_13,1D3
1000000US110010104001008,"Block 1008, Block Group 1, Census Tract 104, District of Columbia, District of Columbia",68,13,55,0,0,0,0,0,68,60,5,55,0,0,0,0,0,8,8,0,0,0,0,0,0,110010104001008,7,705,705,7,psa_3,7D2
1000000US110010078041010,"Block 1010, Block Group 1, Census Tract 78.04, District of Columbia, District of Columbia",0,0,0,0,0,0,0,0,0,0,0,0,0,0,0,0,0,0,0,0,0,0,0,0,0,110010078041010,6,602,602,6,psa_25,6D1
1000000US110010028011003,"Block 1003, Block Group 1, Census Tract 28.01, District of Columbia, District of Columbia",1059,527,321,3,49,1,112,46,1059,855,464,316,1,46,0,1,27,204,63,5,2,3,1,111,19,110010028011003,4,408,408,4,psa_39,4D3
1000000US110010080013002,"Block 3002, Block Group 3, Census Tract 80.01, District of Columbia, District of Columbia",114,68,40,1,1,0,0,4,114,108,63,40,1,1,0,0,3,6,5,0,0,0,0,0,1,110010080013002,1,108,108,1,psa_17,1D2
1000000US110010101001027,"Block 1027, Block Group 1, Census Tract 101, District of Columbia, District of Columbia",188,165,4,0,17,0,0,2,188,175,153,4,0,16,0,0,2,13,12,0,0,1,0,0,0,110010101001027,2,207,207,2,psa_24,2D3
1000000US110010075031015,"Block 1015, Block Group 1, Census Tract 75.03, District of Columbia, District of Columbia",59,3,53,0,0,0,3,0,59,56,3,53,0,0,0,0,0,3,0,0,0,0,0,3,0,110010075031015,7,701,701,7,psa_9,7D1
1000000US110010058001020,"Block 1020, Block Group 1, Census Tract 58, District of Columbia, District of Columbia",0,0,0,0,0,0,0,0,0,0,0,0,0,0,0,0,0,0,0,0,0,0,0,0,0,110010058001020,2,209,209,2,psa_57,2D3
1000000US110010096011004,"Block 1004, Block Group 1, Census Tract 96.01, District of Columbia, District of Columbia",0,0,0,0,0,0,0,0,0,0,0,0,0,0,0,0,0,0,0,0,0,0,0,0,0,110010096011004,5,503,503,5,psa_45,5D2
1000000US110010109001002,"Block 1002, Block Group 1, Census Tract 109, District of Columbia, District of Columbia",146,2,139,0,1,0,0,4,146,145,2,138,0,1,0,0,4,1,0,1,0,0,0,0,0,110010109001002,7,708,708,7,psa_1,7D3
1000000US110010005022004,"Block 2004, Block Group 2, Census Tract 5.02, District of Columbia, District of Columbia",0,0,0,0,0,0,0,0,0,0,0,0,0,0,0,0,0,0,0,0,0,0,0,0,0,110010005022004,2,204,204,2,psa_44,2D2
1000000US110010023012010,"Block 2010, Block Group 2, Census Tract 23.01, District of Columbia, District of Columbia",158,30,80,0,5,0,41,2,158,109,25,78,0,5,0,0,1,49,5,2,0,0,0,41,1,110010023012010,4,407,407,4,psa_47,4D2
1000000US110010073011009,"Block 1009, Block Group 1, Census Tract 73.01, District of Columbia, District of Columbia",0,0,0,0,0,0,0,0,0,0,0,0,0,0,0,0,0,0,0,0,0,0,0,0,0,110010073011009,1,105,105,1,psa_22,1D3
1000000US110010092042002,"Block 2002, Block Group 2, Census Tract 92.04, District of Columbia, District of Columbia",296,5,235,0,2,0,44,10,296,245,3,234,0,2,0,1,5,51,2,1,0,0,0,43,5,110010092042002,5,502,502,5,psa_40,5D1
1000000US110010095041007,"Block 1007, Block Group 1, Census Tract 95.04, District of Columbia, District of Columbia",0,0,0,0,0,0,0,0,0,0,0,0,0,0,0,0,0,0,0,0,0,0,0,0,0,110010095041007,4,405,405,4,psa_49,4D2
1000000US110010015005010,"Block 5010, Block Group 5, Census Tract 15, District of Columbia, District of Columbia",104,103,0,0,1,0,0,0,104,104,103,0,0,1,0,0,0,0,0,0,0,0,0,0,0,110010015005010,2,201,201,2,psa_55,2D1
1000000US110010093013005,"Block 3005, Block Group 3, Census Tract 93.01, District of Columbia, District of Columbia",45,13,32,0,0,0,0,0,45,39,10,29,0,0,0,0,0,6,3,3,0,0,0,0,0,110010093013005,5,504,504,5,psa_43,5D2
1000000US110010019021014,"Block 1014, Block Group 1, Census Tract 19.02, District of Columbia, District of Columbia",75,3,58,0,1,0,7,6,75,65,3,57,0,1,0,0,4,10,0,1,0,0,0,7,2,110010019021014,4,406,406,4,psa_54,4D2
1000000US110010080012003,"Block 2003, Block Group 2, Census Tract 80.01, District of Columbia, District of Columbia",211,119,80,0,6,0,0,6,211,207,115,80,0,6,0,0,6,4,4,0,0,0,0,0,0,110010080012003,1,104,104,1,psa_21,1D2
1000000US110010098042000,"Block 2000, Block Group 2, Census Tract 98.04, District of Columbia, District of Columbia",61,0,56,0,0,0,0,5,61,61,0,56,0,0,0,0,5,0,0,0,0,0,0,0,0,110010098042000,7,705,705,7,psa_3,7D2
1000000US110010104002032,"Block 2032, Block Group 2, Census Tract 104, District of Columbia, District of Columbia",0,0,0,0,0,0,0,0,0,0,0,0,0,0,0,0,0,0,0,0,0,0,0,0,0,110010104002032,7,703,703,7,psa_8,7D1
1000000US110010088031012,"Block 1012, Block Group 1, Census Tract 88.03, District of Columbia, District of Columbia",60,2,53,0,1,0,0,4,60,55,1,51,0,0,0,0,3,5,1,2,0,1,0,0,1,110010088031012,5,506,506,5,psa_26,5D3
1000000US110010111003021,"Block 3021, Block Group 3, Census Tract 111, District of Columbia, District of Columbia",0,0,0,0,0,0,0,0,0,0,0,0,0,0,0,0,0,0,0,0,0,0,0,0,0,110010111003021,5,506,506,5,psa_26,5D3
1000000US110010024001003,"Block 1003, Block Group 1, Census Tract 24, District of Columbia, District of Columbia",211,44,104,0,13,0,34,16,211,147,28,97,0,13,0,4,5,64,16,7,0,0,0,30,11,110010024001003,4,407,407,4,psa_47,4D2
1000000US110010056001000,"Block 1000, Block Group 1, Census Tract 56, District of Columbia, District of Columbia",0,0,0,0,0,0,0,0,0,0,0,0,0,0,0,0,0,0,0,0,0,0,0,0,0,110010056001000,2,207,207,2,psa_24,2D3
1000000US110010082002018,"Block 2018, Block Group 2, Census Tract 82, District of Columbia, District of Columbia",127,115,2,0,6,0,0,4,127,124,112,2,0,6,0,0,4,3,3,0,0,0,0,0,0,110010082002018,1,108,108,1,psa_17,1D2
1000000US110010094002022,"Block 2022, Block Group 2, Census Tract 94, District of Columbia, District of Columbia",0,0,0,0,0,0,0,0,0,0,0,0,0,0,0,0,0,0,0,0,0,0,0,0,0,110010094002022,5,504,504,5,psa_43,5D2
1000000US110010096011031,"Block 1031, Block Group 1, Census Tract 96.01, District of Columbia, District of Columbia",33,0,32,0,0,0,0,1,33,33,0,32,0,0,0,0,1,0,0,0,0,0,0,0,0,110010096011031,6,601,601,6,psa_30,6D1
1000000US110010075031017,"Block 1017, Block Group 1, Census Tract 75.03, District of Columbia, District of Columbia",7,0,7,0,0,0,0,0,7,7,0,7,0,0,0,0,0,0,0,0,0,0,0,0,0,110010075031017,7,701,701,7,psa_9,7D1
1000000US110010021011006,"Block 1006, Block Group 1, Census Tract 21.01, District of Columbia, District of Columbia",31,0,31,0,0,0,0,0,31,31,0,31,0,0,0,0,0,0,0,0,0,0,0,0,0,110010021011006,4,403,403,4,psa_51,4D1
1000000US110010096041002,"Block 1002, Block Group 1, Census Tract 96.04, District of Columbia, District of Columbia",154,0,154,0,0,0,0,0,154,152,0,152,0,0,0,0,0,2,0,2,0,0,0,0,0,110010096041002,6,603,603,6,psa_15,6D3
1000000US110010109002044,"Block 2044, Block Group 2, Census Tract 109, District of Columbia, District of Columbia",0,0,0,0,0,0,0,0,0,0,0,0,0,0,0,0,0,0,0,0,0,0,0,0,0,110010109002044,7,708,708,7,psa_1,7D3
1000000US110010092031004,"Block 1004, Block Group 1, Census Tract 92.03, District of Columbia, District of Columbia",45,0,41,0,0,0,0,4,45,45,0,41,0,0,0,0,4,0,0,0,0,0,0,0,0,110010092031004,5,502,502,5,psa_40,5D1
1000000US110010002023012,"Block 3012, Block Group 3, Census Tract 2.02, District of Columbia, District of Columbia",111,106,0,0,4,0,0,1,111,103,98,0,0,4,0,0,1,8,8,0,0,0,0,0,0,110010002023012,2,206,206,2,psa_29,2D2
1000000US110010067003000,"Block 3000, Block Group 3, Census Tract 67, District of Columbia, District of Columbia",60,53,5,0,2,0,0,0,60,59,52,5,0,2,0,0,0,1,1,0,0,0,0,0,0,110010067003000,1,107,107,1,psa_16,1D2
1000000US110010078042009,"Block 2009, Block Group 2, Census Tract 78.04, District of Columbia, District of Columbia",241,0,229,0,0,0,5,7,241,239,0,229,0,0,0,5,5,2,0,0,0,0,0,0,2,110010078042009,6,602,602,6,psa_25,6D1
1000000US110010016003015,"Block 3015, Block Group 3, Census Tract 16, District of Columbia, District of Columbia",5,0,2,0,1,0,0,2,5,5,0,2,0,1,0,0,2,0,0,0,0,0,0,0,0,110010016003015,4,401,401,4,psa_56,4D1
1000000US110010041003011,"Block 3011, Block Group 3, Census Tract 41, District of Columbia, District of Columbia",41,36,0,3,0,0,0,2,41,40,35,0,3,0,0,0,2,1,1,0,0,0,0,0,0,110010041003011,2,208,208,2,psa_33,2D3
1000000US110010098011002,"Block 1002, Block Group 1, Census Tract 98.01, District of Columbia, District of Columbia",0,0,0,0,0,0,0,0,0,0,0,0,0,0,0,0,0,0,0,0,0,0,0,0,0,110010098011002,7,706,706,7,psa_2,7D3
1000000US110010076015017,"Block 5017, Block Group 5, Census Tract 76.01, District of Columbia, District of Columbia",128,0,120,0,0,0,1,7,128,122,0,116,0,0,0,1,5,6,0,4,0,0,0,0,2,110010076015017,6,607,607,6,psa_10,6D2
1000000US110010010011002,"Block 1002, Block Group 1, Census Tract 10.01, District of Columbia, District of Columbia",73,59,4,0,3,0,2,5,73,61,49,4,0,3,0,0,5,12,10,0,0,0,0,2,0,110010010011002,2,202,202,2,psa_52,2D1
1000000US110010019011001,"Block 1001, Block Group 1, Census Tract 19.01, District of Columbia, District of Columbia",62,0,62,0,0,0,0,0,62,62,0,62,0,0,0,0,0,0,0,0,0,0,0,0,0,110010019011001,4,402,402,4,psa_53,4D1
1000000US110010092011013,"Block 1013, Block Group 1, Census Tract 92.01, District of Columbia, District of Columbia",0,0,0,0,0,0,0,0,0,0,0,0,0,0,0,0,0,0,0,0,0,0,0,0,0,110010092011013,5,502,502,5,psa_40,5D1
1000000US110010103003002,"Block 3002, Block Group 3, Census Tract 103, District of Columbia, District of Columbia",39,18,21,0,0,0,0,0,39,39,18,21,0,0,0,0,0,0,0,0,0,0,0,0,0,110010103003002,4,401,401,4,psa_56,4D1
1000000US110010010016015,"Block 6015, Block Group 6, Census Tract 10.01, District of Columbia, District of Columbia",63,55,6,0,0,0,0,2,63,63,55,6,0,0,0,0,2,0,0,0,0,0,0,0,0,110010010016015,2,202,202,2,psa_52,2D1
1000000US110010073041004,"Block 1004, Block Group 1, Census Tract 73.04, District of Columbia, District of Columbia",230,4,221,0,0,0,0,5,230,227,4,219,0,0,0,0,4,3,0,2,0,0,0,0,1,110010073041004,7,705,705,7,psa_3,7D2
1000000US110010094002010,"Block 2010, Block Group 2, Census Tract 94, District of Columbia, District of Columbia",53,7,46,0,0,0,0,0,53,47,2,45,0,0,0,0,0,6,5,1,0,0,0,0,0,110010094002010,5,503,503,5,psa_45,5D2
1000000US110010023021002,"Block 1002, Block Group 1, Census Tract 23.02, District of Columbia, District of Columbia",883,724,116,10,8,0,9,16,883,855,706,116,10,8,0,0,15,28,18,0,0,0,0,9,1,110010023021002,4,405,405,4,psa_49,4D2
1000000US110010027023015,"Block 3015, Block Group 3, Census Tract 27.02, District of Columbia, District of Columbia",0,0,0,0,0,0,0,0,0,0,0,0,0,0,0,0,0,0,0,0,0,0,0,0,0,110010027023015,3,303,303,3,psa_37,3D3
1000000US110010047021018,"Block 1018, Block Group 1, Census Tract 47.02, District of Columbia, District of Columbia",0,0,0,0,0,0,0,0,0,0,0,0,0,0,0,0,0,0,0,0,0,0,0,0,0,110010047021018,1,101,101,1,psa_20,1D1
1000000US110010095083004,"Block 3004, Block Group 3, Census Tract 95.08, District of Columbia, District of Columbia",50,0,49,0,0,0,0,1,50,50,0,49,0,0,0,0,1,0,0,0,0,0,0,0,0,110010095083004,4,406,406,4,psa_54,4D2
1000000US110010006002004,"Block 2004, Block Group 2, Census Tract 6, District of Columbia, District of Columbia",33,31,1,0,1,0,0,0,33,33,31,1,0,1,0,0,0,0,0,0,0,0,0,0,0,110010006002004,2,203,203,2,psa_50,2D1
1000000US110010034001004,"Block 1004, Block Group 1, Census Tract 34, District of Columbia, District of Columbia",147,52,80,0,6,0,5,4,147,134,46,79,0,2,0,3,4,13,6,1,0,4,0,2,0,110010034001004,3,306,306,3,psa_38,3D2
1000000US110010105002027,"Block 2027, Block Group 2, Census Tract 105, District of Columbia, District of Columbia",436,101,242,1,59,1,13,19,436,398,87,236,1,58,1,2,13,38,14,6,0,1,0,11,6,110010105002027,1,103,103,1,psa_12,1D1
1000000US110010001001006,"Block 1006, Block Group 1, Census Tract 1, District of Columbia, District of Columbia",108,105,0,0,0,0,3,0,108,102,102,0,0,0,0,0,0,6,3,0,0,0,0,3,0,110010001001006,2,206,206,2,psa_29,2D2
1000000US110010011002005,"Block 2005, Block Group 2, Census Tract 11, District of Columbia, District of Columbia",98,83,4,1,5,0,0,5,98,95,81,4,1,5,0,0,4,3,2,0,0,0,0,0,1,110010011002005,2,202,202,2,psa_52,2D1
1000000US110010009022036,"Block 2036, Block Group 2, Census Tract 9.02, District of Columbia, District of Columbia",59,54,3,0,2,0,0,0,59,59,54,3,0,2,0,0,0,0,0,0,0,0,0,0,0,110010009022036,2,205,205,2,psa_46,2D2
1000000US110010020023008,"Block 3008, Block Group 3, Census Tract 20.02, District of Columbia, District of Columbia",98,34,56,0,3,0,0,5,98,95,32,55,0,3,0,0,5,3,2,1,0,0,0,0,0,110010020023008,4,404,404,4,psa_48,4D3
1000000US110010058001009,"Block 1009, Block Group 1, Census Tract 58, District of Columbia, District of Columbia",2,0,2,0,0,0,0,0,2,2,0,2,0,0,0,0,0,0,0,0,0,0,0,0,0,110010058001009,2,209,209,2,psa_57,2D3
1000000US110010062021066,"Block 1066, Block Group 1, Census Tract 62.02, District of Columbia, District of Columbia",0,0,0,0,0,0,0,0,0,0,0,0,0,0,0,0,0,0,0,0,0,0,0,0,0,110010062021066,2,207,207,2,psa_24,2D3
1000000US110010014023008,"Block 3008, Block Group 3, Census Tract 14.02, District of Columbia, District of Columbia",219,190,19,0,8,0,0,2,219,217,188,19,0,8,0,0,2,2,2,0,0,0,0,0,0,110010014023008,2,201,201,2,psa_55,2D1
1000000US110010019012005,"Block 2005, Block Group 2, Census Tract 19.01, District of Columbia, District of Columbia",103,0,98,1,1,0,3,0,103,96,0,94,1,1,0,0,0,7,0,4,0,0,0,3,0,110010019012005,4,402,402,4,psa_53,4D1
1000000US110010048011005,"Block 1005, Block Group 1, Census Tract 48.01, District of Columbia, District of Columbia",232,48,154,3,4,0,18,5,232,211,44,154,1,4,0,3,5,21,4,0,2,0,0,15,0,110010048011005,3,308,308,3,psa_27,3D2
1000000US110010062021221,"Block 1221, Block Group 1, Census Tract 62.02, District of Columbia, District of Columbia",0,0,0,0,0,0,0,0,0,0,0,0,0,0,0,0,0,0,0,0,0,0,0,0,0,110010062021221,1,103,103,1,psa_12,1D1
1000000US110010055005003,"Block 5003, Block Group 5, Census Tract 55, District of Columbia, District of Columbia",420,333,18,0,44,0,6,19,420,382,304,17,0,42,0,2,17,38,29,1,0,2,0,4,2,110010055005003,2,208,208,2,psa_33,2D3
1000000US110010062021073,"Block 1073, Block Group 1, Census Tract 62.02, District of Columbia, District of Columbia",0,0,0,0,0,0,0,0,0,0,0,0,0,0,0,0,0,0,0,0,0,0,0,0,0,110010062021073,2,207,207,2,psa_24,2D3
1000000US110010078041009,"Block 1009, Block Group 1, Census Tract 78.04, District of Columbia, District of Columbia",152,1,141,0,0,0,5,5,152,146,1,141,0,0,0,0,4,6,0,0,0,0,0,5,1,110010078041009,6,602,602,6,psa_25,6D1
1000000US110010066001007,"Block 1007, Block Group 1, Census Tract 66, District of Columbia, District of Columbia",53,50,2,0,0,0,0,1,53,51,49,2,0,0,0,0,0,2,1,0,0,0,0,0,1,110010066001007,1,106,106,1,psa_13,1D3
1000000US110010098102005,"Block 2005, Block Group 2, Census Tract 98.10, District of Columbia, District of Columbia",141,0,140,0,0,0,1,0,141,139,0,138,0,0,0,1,0,2,0,2,0,0,0,0,0,110010098102005,7,708,708,7,psa_1,7D3
1000000US110010065002007,"Block 2007, Block Group 2, Census Tract 65, District of Columbia, District of Columbia",123,108,3,0,2,0,2,8,123,115,101,3,0,2,0,1,8,8,7,0,0,0,0,1,0,110010065002007,1,106,106,1,psa_13,1D3
1000000US110010084101013,"Block 1013, Block Group 1, Census Tract 84.10, District of Columbia, District of Columbia",113,37,74,0,2,0,0,0,113,112,36,74,0,2,0,0,0,1,1,0,0,0,0,0,0,110010084101013,1,104,104,1,psa_21,1D2
1000000US110010094003013,"Block 3013, Block Group 3, Census Tract 94, District of Columbia, District of Columbia",97,13,66,0,0,0,15,3,97,76,10,64,0,0,0,0,2,21,3,2,0,0,0,15,1,110010094003013,5,503,503,5,psa_45,5D2
1000000US110010006003006,"Block 3006, Block Group 3, Census Tract 6, District of Columbia, District of Columbia",57,53,0,0,1,0,0,3,57,52,48,0,0,1,0,0,3,5,5,0,0,0,0,0,0,110010006003006,2,204,204,2,psa_44,2D2
1000000US110010074081008,"Block 1008, Block Group 1, Census Tract 74.08, District of Columbia, District of Columbia",41,0,41,0,0,0,0,0,41,41,0,41,0,0,0,0,0,0,0,0,0,0,0,0,0,110010074081008,7,702,702,7,psa_6,7D1
1000000US110010088031014,"Block 1014, Block Group 1, Census Tract 88.03, District of Columbia, District of Columbia",84,2,78,1,1,0,0,2,84,84,2,78,1,1,0,0,2,0,0,0,0,0,0,0,0,110010088031014,5,506,506,5,psa_26,5D3
1000000US110010062021184,"Block 1184, Block Group 1, Census Tract 62.02, District of Columbia, District of Columbia",0,0,0,0,0,0,0,0,0,0,0,0,0,0,0,0,0,0,0,0,0,0,0,0,0,110010062021184,2,207,207,2,psa_24,2D3
1000000US110010099053003,"Block 3003, Block Group 3, Census Tract 99.05, District of Columbia, District of Columbia",123,0,118,0,0,1,0,4,123,122,0,117,0,0,1,0,4,1,0,1,0,0,0,0,0,110010099053003,6,604,604,6,psa_14,6D3
1000000US110010020021011,"Block 1011, Block Group 1, Census Tract 20.02, District of Columbia, District of Columbia",42,14,25,0,0,0,0,3,42,41,13,25,0,0,0,0,3,1,1,0,0,0,0,0,0,110010020021011,4,404,404,4,psa_48,4D3
1000000US110010077032004,"Block 2004, Block Group 2, Census Tract 77.03, District of Columbia, District of Columbia",100,0,100,0,0,0,0,0,100,100,0,100,0,0,0,0,0,0,0,0,0,0,0,0,0,110010077032004,6,603,603,6,psa_15,6D3
1000000US110010079031007,"Block 1007, Block Group 1, Census Tract 79.03, District of Columbia, District of Columbia",142,6,132,0,0,0,0,4,142,142,6,132,0,0,0,0,4,0,0,0,0,0,0,0,0,110010079031007,5,507,507,5,psa_23,5D3
1000000US110010002023009,"Block 3009, Block Group 3, Census Tract 2.02, District of Columbia, District of Columbia",22,22,0,0,0,0,0,0,22,21,21,0,0,0,0,0,0,1,1,0,0,0,0,0,0,110010002023009,2,206,206,2,psa_29,2D2
1000000US110010019022016,"Block 2016, Block Group 2, Census Tract 19.02, District of Columbia, District of Columbia",23,0,18,0,4,0,0,1,23,21,0,16,0,4,0,0,1,2,0,2,0,0,0,0,0,110010019022016,4,402,402,4,psa_53,4D1
1000000US110010062021166,"Block 1166, Block Group 1, Census Tract 62.02, District of Columbia, District of Columbia",0,0,0,0,0,0,0,0,0,0,0,0,0,0,0,0,0,0,0,0,0,0,0,0,0,110010062021166,2,207,207,2,psa_24,2D3
1000000US110010067001000,"Block 1000, Block Group 1, Census Tract 67, District of Columbia, District of Columbia",190,120,59,1,5,0,0,5,190,184,116,58,1,5,0,0,4,6,4,1,0,0,0,0,1,110010067001000,1,107,107,1,psa_16,1D2
1000000US110010095052011,"Block 2011, Block Group 2, Census Tract 95.05, District of Columbia, District of Columbia",105,8,80,0,3,0,9,5,105,90,7,80,0,3,0,0,0,15,1,0,0,0,0,9,5,110010095052011,4,406,406,4,psa_54,4D2
1000000US110010019021011,"Block 1011, Block Group 1, Census Tract 19.02, District of Columbia, District of Columbia",50,4,40,0,4,0,0,2,50,50,4,40,0,4,0,0,2,0,0,0,0,0,0,0,0,110010019021011,4,402,402,4,psa_53,4D1
1000000US110010030001000,"Block 1000, Block Group 1, Census Tract 30, District of Columbia, District of Columbia",128,63,30,0,8,0,22,5,128,100,57,29,0,8,0,2,4,28,6,1,0,0,0,20,1,110010030001000,3,302,302,3,psa_42,3D1
1000000US110010109002030,"Block 2030, Block Group 2, Census Tract 109, District of Columbia, District of Columbia",0,0,0,0,0,0,0,0,0,0,0,0,0,0,0,0,0,0,0,0,0,0,0,0,0,110010109002030,7,708,708,7,psa_1,7D3
1000000US110010008012013,"Block 2013, Block Group 2, Census Tract 8.01, District of Columbia, District of Columbia",14,14,0,0,0,0,0,0,14,14,14,0,0,0,0,0,0,0,0,0,0,0,0,0,0,110010008012013,2,205,205,2,psa_46,2D2
1000000US110010034001005,"Block 1005, Block Group 1, Census Tract 34, District of Columbia, District of Columbia",0,0,0,0,0,0,0,0,0,0,0,0,0,0,0,0,0,0,0,0,0,0,0,0,0,110010034001005,3,306,306,3,psa_38,3D2
1000000US110010058001030,"Block 1030, Block Group 1, Census Tract 58, District of Columbia, District of Columbia",0,0,0,0,0,0,0,0,0,0,0,0,0,0,0,0,0,0,0,0,0,0,0,0,0,110010058001030,2,209,209,2,psa_57,2D3
1000000US110010094003012,"Block 3012, Block Group 3, Census Tract 94, District of Columbia, District of Columbia",78,0,77,0,0,0,0,1,78,78,0,77,0,0,0,0,1,0,0,0,0,0,0,0,0,110010094003012,5,503,503,5,psa_45,5D2
1000000US110010009013006,"Block 3006, Block Group 3, Census Tract 9.01, District of Columbia, District of Columbia",43,43,0,0,0,0,0,0,43,41,41,0,0,0,0,0,0,2,2,0,0,0,0,0,0,110010009013006,2,205,205,2,psa_46,2D2
1000000US110010021021013,"Block 1013, Block Group 1, Census Tract 21.02, District of Columbia, District of Columbia",3,1,2,0,0,0,0,0,3,3,1,2,0,0,0,0,0,0,0,0,0,0,0,0,0,110010021021013,4,403,403,4,psa_51,4D1
1000000US110010034002004,"Block 2004, Block Group 2, Census Tract 34, District of Columbia, District of Columbia",242,10,208,1,8,1,1,13,242,228,10,196,1,8,1,1,11,14,0,12,0,0,0,0,2,110010034002004,3,306,306,3,psa_38,3D2
1000000US110010009022025,"Block 2025, Block Group 2, Census Tract 9.02, District of Columbia, District of Columbia",34,34,0,0,0,0,0,0,34,32,32,0,0,0,0,0,0,2,2,0,0,0,0,0,0,110010009022025,2,205,205,2,psa_46,2D2
1000000US110010011001009,"Block 1009, Block Group 1, Census Tract 11, District of Columbia, District of Columbia",45,41,0,0,4,0,0,0,45,45,41,0,0,4,0,0,0,0,0,0,0,0,0,0,0,110010011001009,2,201,201,2,psa_55,2D1
1000000US110010010015005,"Block 5005, Block Group 5, Census Tract 10.01, District of Columbia, District of Columbia",3,3,0,0,0,0,0,0,3,3,3,0,0,0,0,0,0,0,0,0,0,0,0,0,0,110010010015005,2,202,202,2,psa_52,2D1
1000000US110010041003015,"Block 3015, Block Group 3, Census Tract 41, District of Columbia, District of Columbia",38,29,0,0,9,0,0,0,38,36,27,0,0,9,0,0,0,2,2,0,0,0,0,0,0,110010041003015,2,208,208,2,psa_33,2D3
1000000US110010050011005,"Block 1005, Block Group 1, Census Tract 50.01, District of Columbia, District of Columbia",140,99,30,0,6,0,4,1,140,123,86,29,0,6,0,2,0,17,13,1,0,0,0,2,1,110010050011005,3,307,307,3,psa_28,3D3
1000000US110010055002009,"Block 2009, Block Group 2, Census Tract 55, District of Columbia, District of Columbia",0,0,0,0,0,0,0,0,0,0,0,0,0,0,0,0,0,0,0,0,0,0,0,0,0,110010055002009,2,206,206,2,psa_29,2D2
1000000US110010093014005,"Block 4005, Block Group 4, Census Tract 93.01, District of Columbia, District of Columbia",45,22,20,0,0,0,0,3,45,39,16,20,0,0,0,0,3,6,6,0,0,0,0,0,0,110010093014005,5,504,504,5,psa_43,5D2
1000000US110010039001003,"Block 1003, Block Group 1, Census Tract 39, District of Columbia, District of Columbia",420,289,63,0,27,1,27,13,420,352,249,63,0,26,1,5,8,68,40,0,0,1,0,22,5,110010039001003,3,303,303,3,psa_37,3D3
1000000US110010078033005,"Block 3005, Block Group 3, Census Tract 78.03, District of Columbia, District of Columbia",34,0,33,0,0,0,0,1,34,29,0,28,0,0,0,0,1,5,0,5,0,0,0,0,0,110010078033005,6,602,602,6,psa_25,6D1
1000000US110010098072008,"Block 2008, Block Group 2, Census Tract 98.07, District of Columbia, District of Columbia",316,1,313,1,0,0,0,1,316,316,1,313,1,0,0,0,1,0,0,0,0,0,0,0,0,110010098072008,7,708,708,7,psa_1,7D3
1000000US110010058001028,"Block 1028, Block Group 1, Census Tract 58, District of Columbia, District of Columbia",0,0,0,0,0,0,0,0,0,0,0,0,0,0,0,0,0,0,0,0,0,0,0,0,0,110010058001028,2,209,209,2,psa_57,2D3
1000000US110010099053000,"Block 3000, Block Group 3, Census Tract 99.05, District of Columbia, District of Columbia",90,2,88,0,0,0,0,0,90,90,2,88,0,0,0,0,0,0,0,0,0,0,0,0,0,110010099053000,6,604,604,6,psa_14,6D3
1000000US110010072002054,"Block 2054, Block Group 2, Census Tract 72, District of Columbia, District of Columbia",7,7,0,0,0,0,0,0,7,6,6,0,0,0,0,0,0,1,1,0,0,0,0,0,0,110010072002054,1,106,106,1,psa_13,1D3
1000000US110010095051007,"Block 1007, Block Group 1, Census Tract 95.05, District of Columbia, District of Columbia",138,6,127,0,0,4,1,0,138,132,6,126,0,0,0,0,0,6,0,1,0,0,4,1,0,110010095051007,4,406,406,4,psa_54,4D2
1000000US110010026001019,"Block 1019, Block Group 1, Census Tract 26, District of Columbia, District of Columbia",0,0,0,0,0,0,0,0,0,0,0,0,0,0,0,0,0,0,0,0,0,0,0,0,0,110010026001019,4,404,404,4,psa_48,4D3
1000000US110010066001011,"Block 1011, Block Group 1, Census Tract 66, District of Columbia, District of Columbia",99,86,2,0,8,0,0,3,99,93,80,2,0,8,0,0,3,6,6,0,0,0,0,0,0,110010066001011,1,107,107,1,psa_16,1D2
1000000US110010010015003,"Block 5003, Block Group 5, Census Tract 10.01, District of Columbia, District of Columbia",92,61,11,1,5,0,6,8,92,84,53,11,1,5,0,6,8,8,8,0,0,0,0,0,0,110010010015003,2,202,202,2,psa_52,2D1
1000000US110010106002054,"Block 2054, Block Group 2, Census Tract 106, District of Columbia, District of Columbia",0,0,0,0,0,0,0,0,0,0,0,0,0,0,0,0,0,0,0,0,0,0,0,0,0,110010106002054,1,102,102,1,psa_18,1D1
1000000US110010072002011,"Block 2011, Block Group 2, Census Tract 72, District of Columbia, District of Columbia",0,0,0,0,0,0,0,0,0,0,0,0,0,0,0,0,0,0,0,0,0,0,0,0,0,110010072002011,1,106,106,1,psa_13,1D3
1000000US110010073011084,"Block 1084, Block Group 1, Census Tract 73.01, District of Columbia, District of Columbia",0,0,0,0,0,0,0,0,0,0,0,0,0,0,0,0,0,0,0,0,0,0,0,0,0,110010073011084,7,707,707,7,psa_4,7D2
1000000US110010104002002,"Block 2002, Block Group 2, Census Tract 104, District of Columbia, District of Columbia",0,0,0,0,0,0,0,0,0,0,0,0,0,0,0,0,0,0,0,0,0,0,0,0,0,110010104002002,7,703,703,7,psa_8,7D1
1000000US110010055002001,"Block 2001, Block Group 2, Census Tract 55, District of Columbia, District of Columbia",171,132,9,0,21,0,0,9,171,157,118,9,0,21,0,0,9,14,14,0,0,0,0,0,0,110010055002001,2,207,207,2,psa_24,2D3
1000000US110010065001006,"Block 1006, Block Group 1, Census Tract 65, District of Columbia, District of Columbia",171,147,8,0,8,1,5,2,171,163,142,8,0,8,1,2,2,8,5,0,0,0,0,3,0,110010065001006,1,106,106,1,psa_13,1D3
1000000US110010012004012,"Block 4012, Block Group 4, Census Tract 12, District of Columbia, District of Columbia",103,85,11,1,5,0,1,0,103,94,76,11,1,5,0,1,0,9,9,0,0,0,0,0,0,110010012004012,2,202,202,2,psa_52,2D1
1000000US110010046002019,"Block 2019, Block Group 2, Census Tract 46, District of Columbia, District of Columbia",39,19,20,0,0,0,0,0,39,37,19,18,0,0,0,0,0,2,0,2,0,0,0,0,0,110010046002019,3,308,308,3,psa_27,3D2
1000000US110010064002030,"Block 2030, Block Group 2, Census Tract 64, District of Columbia, District of Columbia",0,0,0,0,0,0,0,0,0,0,0,0,0,0,0,0,0,0,0,0,0,0,0,0,0,110010064002030,1,105,105,1,psa_22,1D3
1000000US110010003004007,"Block 4007, Block Group 4, Census Tract 3, District of Columbia, District of Columbia",137,123,3,0,6,0,5,0,137,126,117,3,0,6,0,0,0,11,6,0,0,0,0,5,0,110010003004007,2,204,204,2,psa_44,2D2
1000000US110010074011003,"Block 1003, Block Group 1, Census Tract 74.01, District of Columbia, District of Columbia",0,0,0,0,0,0,0,0,0,0,0,0,0,0,0,0,0,0,0,0,0,0,0,0,0,110010074011003,7,701,701,7,psa_9,7D1
1000000US110010009013009,"Block 3009, Block Group 3, Census Tract 9.01, District of Columbia, District of Columbia",0,0,0,0,0,0,0,0,0,0,0,0,0,0,0,0,0,0,0,0,0,0,0,0,0,110010009013009,2,205,205,2,psa_46,2D2
1000000US110010073011065,"Block 1065, Block Group 1, Census Tract 73.01, District of Columbia, District of Columbia",0,0,0,0,0,0,0,0,0,0,0,0,0,0,0,0,0,0,0,0,0,0,0,0,0,110010073011065,7,707,707,7,psa_4,7D2
1000000US110010020021002,"Block 1002, Block Group 1, Census Tract 20.02, District of Columbia, District of Columbia",15,3,10,0,0,0,2,0,15,12,2,10,0,0,0,0,0,3,1,0,0,0,0,2,0,110010020021002,4,403,403,4,psa_51,4D1
1000000US110010010022001,"Block 2001, Block Group 2, Census Tract 10.02, District of Columbia, District of Columbia",215,175,12,0,13,0,2,13,215,194,157,12,0,13,0,0,12,21,18,0,0,0,0,2,1,110010010022001,2,204,204,2,psa_44,2D2
1000000US110010074011034,"Block 1034, Block Group 1, Census Tract 74.01, District of Columbia, District of Columbia",0,0,0,0,0,0,0,0,0,0,0,0,0,0,0,0,0,0,0,0,0,0,0,0,0,110010074011034,7,703,703,7,psa_8,7D1
1000000US110010078031003,"Block 1003, Block Group 1, Census Tract 78.03, District of Columbia, District of Columbia",0,0,0,0,0,0,0,0,0,0,0,0,0,0,0,0,0,0,0,0,0,0,0,0,0,110010078031003,6,602,602,6,psa_25,6D1
1000000US110010095083001,"Block 3001, Block Group 3, Census Tract 95.08, District of Columbia, District of Columbia",97,9,88,0,0,0,0,0,97,88,0,88,0,0,0,0,0,9,9,0,0,0,0,0,0,110010095083001,4,406,406,4,psa_54,4D2
1000000US110010015001028,"Block 1028, Block Group 1, Census Tract 15, District of Columbia, District of Columbia",52,31,10,0,0,1,10,0,52,40,29,10,0,0,1,0,0,12,2,0,0,0,0,10,0,110010015001028,2,201,201,2,psa_55,2D1
1000000US110010009022020,"Block 2020, Block Group 2, Census Tract 9.02, District of Columbia, District of Columbia",41,41,0,0,0,0,0,0,41,41,41,0,0,0,0,0,0,0,0,0,0,0,0,0,0,110010009022020,2,205,205,2,psa_46,2D2
1000000US110010065002004,"Block 2004, Block Group 2, Census Tract 65, District of Columbia, District of Columbia",0,0,0,0,0,0,0,0,0,0,0,0,0,0,0,0,0,0,0,0,0,0,0,0,0,110010065002004,1,106,106,1,psa_13,1D3
1000000US110010095011000,"Block 1000, Block Group 1, Census Tract 95.01, District of Columbia, District of Columbia",0,0,0,0,0,0,0,0,0,0,0,0,0,0,0,0,0,0,0,0,0,0,0,0,0,110010095011000,4,405,405,4,psa_49,4D2
1000000US110010072002045,"Block 2045, Block Group 2, Census Tract 72, District of Columbia, District of Columbia",0,0,0,0,0,0,0,0,0,0,0,0,0,0,0,0,0,0,0,0,0,0,0,0,0,110010072002045,1,106,106,1,psa_13,1D3
1000000US110010098032004,"Block 2004, Block Group 2, Census Tract 98.03, District of Columbia, District of Columbia",0,0,0,0,0,0,0,0,0,0,0,0,0,0,0,0,0,0,0,0,0,0,0,0,0,110010098032004,7,707,707,7,psa_4,7D2
1000000US110010109002035,"Block 2035, Block Group 2, Census Tract 109, District of Columbia, District of Columbia",0,0,0,0,0,0,0,0,0,0,0,0,0,0,0,0,0,0,0,0,0,0,0,0,0,110010109002035,7,708,708,7,psa_1,7D3
1000000US110010002024020,"Block 4020, Block Group 4, Census Tract 2.02, District of Columbia, District of Columbia",0,0,0,0,0,0,0,0,0,0,0,0,0,0,0,0,0,0,0,0,0,0,0,0,0,110010002024020,2,206,206,2,psa_29,2D2
1000000US110010095011003,"Block 1003, Block Group 1, Census Tract 95.01, District of Columbia, District of Columbia",63,1,58,0,1,0,3,0,63,60,1,58,0,1,0,0,0,3,0,0,0,0,0,3,0,110010095011003,4,405,405,4,psa_49,4D2
1000000US110010062021012,"Block 1012, Block Group 1, Census Tract 62.02, District of Columbia, District of Columbia",0,0,0,0,0,0,0,0,0,0,0,0,0,0,0,0,0,0,0,0,0,0,0,0,0,110010062021012,1,102,102,1,psa_18,1D1
1000000US110010089032002,"Block 2002, Block Group 2, Census Tract 89.03, District of Columbia, District of Columbia",658,1,644,1,0,0,4,8,658,654,1,641,1,0,0,3,8,4,0,3,0,0,0,1,0,110010089032002,5,507,507,5,psa_23,5D3
1000000US110010105001000,"Block 1000, Block Group 1, Census Tract 105, District of Columbia, District of Columbia",0,0,0,0,0,0,0,0,0,0,0,0,0,0,0,0,0,0,0,0,0,0,0,0,0,110010105001000,1,103,103,1,psa_12,1D1
1000000US110010022012015,"Block 2015, Block Group 2, Census Tract 22.01, District of Columbia, District of Columbia",173,31,112,1,6,0,21,2,173,139,19,111,1,6,0,0,2,34,12,1,0,0,0,21,0,110010022012015,4,407,407,4,psa_47,4D2
1000000US110010033013003,"Block 3003, Block Group 3, Census Tract 33.01, District of Columbia, District of Columbia",175,36,124,0,3,0,5,7,175,169,33,122,0,3,0,4,7,6,3,2,0,0,0,1,0,110010033013003,3,306,306,3,psa_38,3D2
1000000US110010109002016,"Block 2016, Block Group 2, Census Tract 109, District of Columbia, District of Columbia",0,0,0,0,0,0,0,0,0,0,0,0,0,0,0,0,0,0,0,0,0,0,0,0,0,110010109002016,7,708,708,7,psa_1,7D3
1000000US110010111001036,"Block 1036, Block Group 1, Census Tract 111, District of Columbia, District of Columbia",72,6,56,0,0,0,10,0,72,62,6,56,0,0,0,0,0,10,0,0,0,0,0,10,0,110010111001036,5,503,503,5,psa_45,5D2
1000000US110010111002008,"Block 2008, Block Group 2, Census Tract 111, District of Columbia, District of Columbia",20,5,15,0,0,0,0,0,20,17,4,13,0,0,0,0,0,3,1,2,0,0,0,0,0,110010111002008,5,503,503,5,psa_45,5D2
1000000US110010083012003,"Block 2003, Block Group 2, Census Tract 83.01, District of Columbia, District of Columbia",121,97,18,0,5,0,0,1,121,120,96,18,0,5,0,0,1,1,1,0,0,0,0,0,0,110010083012003,1,104,104,1,psa_21,1D2
1000000US110010095042015,"Block 2015, Block Group 2, Census Tract 95.04, District of Columbia, District of Columbia",43,14,29,0,0,0,0,0,43,39,14,25,0,0,0,0,0,4,0,4,0,0,0,0,0,110010095042015,4,405,405,4,psa_49,4D2
1000000US110010081002008,"Block 2008, Block Group 2, Census Tract 81, District of Columbia, District of Columbia",86,73,9,2,0,0,2,0,86,84,73,9,2,0,0,0,0,2,0,0,0,0,0,2,0,110010081002008,1,108,108,1,psa_17,1D2
1000000US110010078043009,"Block 3009, Block Group 3, Census Tract 78.04, District of Columbia, District of Columbia",57,0,57,0,0,0,0,0,57,57,0,57,0,0,0,0,0,0,0,0,0,0,0,0,0,110010078043009,6,608,608,6,psa_19,6D1
1000000US110010062021230,"Block 1230, Block Group 1, Census Tract 62.02, District of Columbia, District of Columbia",0,0,0,0,0,0,0,0,0,0,0,0,0,0,0,0,0,0,0,0,0,0,0,0,0,110010062021230,2,207,207,2,psa_24,2D3
1000000US110010072002033,"Block 2033, Block Group 2, Census Tract 72, District of Columbia, District of Columbia",0,0,0,0,0,0,0,0,0,0,0,0,0,0,0,0,0,0,0,0,0,0,0,0,0,110010072002033,1,106,106,1,psa_13,1D3
1000000US110010105001007,"Block 1007, Block Group 1, Census Tract 105, District of Columbia, District of Columbia",0,0,0,0,0,0,0,0,0,0,0,0,0,0,0,0,0,0,0,0,0,0,0,0,0,110010105001007,1,105,105,1,psa_22,1D3
1000000US110010062021129,"Block 1129, Block Group 1, Census Tract 62.02, District of Columbia, District of Columbia",0,0,0,0,0,0,0,0,0,0,0,0,0,0,0,0,0,0,0,0,0,0,0,0,0,110010062021129,1,102,102,1,psa_18,1D1
1000000US110010001003012,"Block 3012, Block Group 3, Census Tract 1, District of Columbia, District of Columbia",86,72,4,0,5,0,0,5,86,84,71,4,0,5,0,0,4,2,1,0,0,0,0,0,1,110010001003012,2,206,206,2,psa_29,2D2
1000000US110010015001033,"Block 1033, Block Group 1, Census Tract 15, District of Columbia, District of Columbia",86,70,4,0,1,0,1,10,86,77,64,3,0,1,0,0,9,9,6,1,0,0,0,1,1,110010015001033,2,201,201,2,psa_55,2D1
1000000US110010034002011,"Block 2011, Block Group 2, Census Tract 34, District of Columbia, District of Columbia",0,0,0,0,0,0,0,0,0,0,0,0,0,0,0,0,0,0,0,0,0,0,0,0,0,110010034002011,3,306,306,3,psa_38,3D2
1000000US110010087022008,"Block 2008, Block Group 2, Census Tract 87.02, District of Columbia, District of Columbia",67,18,41,1,0,0,2,5,67,61,17,41,1,0,0,0,2,6,1,0,0,0,0,2,3,110010087022008,5,502,502,5,psa_40,5D1
1000000US110010101001010,"Block 1010, Block Group 1, Census Tract 101, District of Columbia, District of Columbia",0,0,0,0,0,0,0,0,0,0,0,0,0,0,0,0,0,0,0,0,0,0,0,0,0,110010101001010,2,209,209,2,psa_57,2D3
1000000US110010109002005,"Block 2005, Block Group 2, Census Tract 109, District of Columbia, District of Columbia",0,0,0,0,0,0,0,0,0,0,0,0,0,0,0,0,0,0,0,0,0,0,0,0,0,110010109002005,7,708,708,7,psa_1,7D3
1000000US110010059001039,"Block 1039, Block Group 1, Census Tract 59, District of Columbia, District of Columbia",0,0,0,0,0,0,0,0,0,0,0,0,0,0,0,0,0,0,0,0,0,0,0,0,0,110010059001039,1,102,102,1,psa_18,1D1
1000000US110010077092009,"Block 2009, Block Group 2, Census Tract 77.09, District of Columbia, District of Columbia",0,0,0,0,0,0,0,0,0,0,0,0,0,0,0,0,0,0,0,0,0,0,0,0,0,110010077092009,6,605,605,6,psa_11,6D2
1000000US110010095041019,"Block 1019, Block Group 1, Census Tract 95.04, District of Columbia, District of Columbia",115,73,33,0,3,0,0,6,115,110,69,33,0,3,0,0,5,5,4,0,0,0,0,0,1,110010095041019,5,504,504,5,psa_43,5D2
1000000US110010009022013,"Block 2013, Block Group 2, Census Tract 9.02, District of Columbia, District of Columbia",0,0,0,0,0,0,0,0,0,0,0,0,0,0,0,0,0,0,0,0,0,0,0,0,0,110010009022013,2,205,205,2,psa_46,2D2
1000000US110010064002023,"Block 2023, Block Group 2, Census Tract 64, District of Columbia, District of Columbia",0,0,0,0,0,0,0,0,0,0,0,0,0,0,0,0,0,0,0,0,0,0,0,0,0,110010064002023,1,105,105,1,psa_22,1D3
1000000US110010109002006,"Block 2006, Block Group 2, Census Tract 109, District of Columbia, District of Columbia",0,0,0,0,0,0,0,0,0,0,0,0,0,0,0,0,0,0,0,0,0,0,0,0,0,110010109002006,7,708,708,7,psa_1,7D3
1000000US110010111002027,"Block 2027, Block Group 2, Census Tract 111, District of Columbia, District of Columbia",22,0,22,0,0,0,0,0,22,22,0,22,0,0,0,0,0,0,0,0,0,0,0,0,0,110010111002027,5,505,505,5,psa_34,5D2
1000000US110010024004000,"Block 4000, Block Group 4, Census Tract 24, District of Columbia, District of Columbia",95,15,78,0,0,0,2,0,95,94,15,78,0,0,0,1,0,1,0,0,0,0,0,1,0,110010024004000,4,407,407,4,psa_47,4D2
1000000US110010023011002,"Block 1002, Block Group 1, Census Tract 23.01, District of Columbia, District of Columbia",57,3,54,0,0,0,0,0,57,55,1,54,0,0,0,0,0,2,2,0,0,0,0,0,0,110010023011002,4,407,407,4,psa_47,4D2
1000000US110010076013011,"Block 3011, Block Group 3, Census Tract 76.01, District of Columbia, District of Columbia",148,3,144,1,0,0,0,0,148,147,3,143,1,0,0,0,0,1,0,1,0,0,0,0,0,110010076013011,6,607,607,6,psa_10,6D2
1000000US110010107001015,"Block 1015, Block Group 1, Census Tract 107, District of Columbia, District of Columbia",0,0,0,0,0,0,0,0,0,0,0,0,0,0,0,0,0,0,0,0,0,0,0,0,0,110010107001015,2,207,207,2,psa_24,2D3
1000000US110010026001015,"Block 1015, Block Group 1, Census Tract 26, District of Columbia, District of Columbia",0,0,0,0,0,0,0,0,0,0,0,0,0,0,0,0,0,0,0,0,0,0,0,0,0,110010026001015,2,203,203,2,psa_50,2D1
1000000US110010080013001,"Block 3001, Block Group 3, Census Tract 80.01, District of Columbia, District of Columbia",100,47,49,0,0,0,2,2,100,98,45,49,0,0,0,2,2,2,2,0,0,0,0,0,0,110010080013001,1,108,108,1,psa_17,1D2
1000000US110010010014009,"Block 4009, Block Group 4, Census Tract 10.01, District of Columbia, District of Columbia",46,40,1,0,3,0,0,2,46,44,38,1,0,3,0,0,2,2,2,0,0,0,0,0,0,110010010014009,2,202,202,2,psa_52,2D1
1000000US110010012002006,"Block 2006, Block Group 2, Census Tract 12, District of Columbia, District of Columbia",81,81,0,0,0,0,0,0,81,74,74,0,0,0,0,0,0,7,7,0,0,0,0,0,0,110010012002006,2,202,202,2,psa_52,2D1
1000000US110010087012006,"Block 2006, Block Group 2, Census Tract 87.01, District of Columbia, District of Columbia",111,29,82,0,0,0,0,0,111,107,25,82,0,0,0,0,0,4,4,0,0,0,0,0,0,110010087012006,5,502,502,5,psa_40,5D1
1000000US110010109002041,"Block 2041, Block Group 2, Census Tract 109, District of Columbia, District of Columbia",0,0,0,0,0,0,0,0,0,0,0,0,0,0,0,0,0,0,0,0,0,0,0,0,0,110010109002041,7,708,708,7,psa_1,7D3
1000000US110010022021002,"Block 1002, Block Group 1, Census Tract 22.02, District of Columbia, District of Columbia",134,8,73,0,0,1,40,12,134,84,2,71,0,0,0,0,11,50,6,2,0,0,1,40,1,110010022021002,4,407,407,4,psa_47,4D2
1000000US110010048011020,"Block 1020, Block Group 1, Census Tract 48.01, District of Columbia, District of Columbia",97,53,23,0,6,0,12,3,97,84,51,23,0,6,0,1,3,13,2,0,0,0,0,11,0,110010048011020,3,308,308,3,psa_27,3D2
1000000US110010065001004,"Block 1004, Block Group 1, Census Tract 65, District of Columbia, District of Columbia",46,39,5,0,2,0,0,0,46,42,38,2,0,2,0,0,0,4,1,3,0,0,0,0,0,110010065001004,1,106,106,1,psa_13,1D3
1000000US110010095033015,"Block 3015, Block Group 3, Census Tract 95.03, District of Columbia, District of Columbia",44,31,9,0,3,0,1,0,44,41,29,9,0,3,0,0,0,3,2,0,0,0,0,1,0,110010095033015,5,504,504,5,psa_43,5D2
1000000US110010008012005,"Block 2005, Block Group 2, Census Tract 8.01, District of Columbia, District of Columbia",39,31,3,0,5,0,0,0,39,34,26,3,0,5,0,0,0,5,5,0,0,0,0,0,0,110010008012005,2,205,205,2,psa_46,2D2
1000000US110010026002006,"Block 2006, Block Group 2, Census Tract 26, District of Columbia, District of Columbia",128,44,77,0,4,0,3,0,128,122,40,77,0,4,0,1,0,6,4,0,0,0,0,2,0,110010026002006,4,403,403,4,psa_51,4D1
1000000US110010013013001,"Block 3001, Block Group 3, Census Tract 13.01, District of Columbia, District of Columbia",95,88,6,0,0,0,0,1,95,95,88,6,0,0,0,0,1,0,0,0,0,0,0,0,0,110010013013001,2,203,203,2,psa_50,2D1
1000000US110010062021249,"Block 1249, Block Group 1, Census Tract 62.02, District of Columbia, District of Columbia",0,0,0,0,0,0,0,0,0,0,0,0,0,0,0,0,0,0,0,0,0,0,0,0,0,110010062021249,2,207,207,2,psa_24,2D3
1000000US110010064001009,"Block 1009, Block Group 1, Census Tract 64, District of Columbia, District of Columbia",89,13,73,0,3,0,0,0,89,86,12,71,0,3,0,0,0,3,1,2,0,0,0,0,0,110010064001009,1,105,105,1,psa_22,1D3
1000000US110010095071007,"Block 1007, Block Group 1, Census Tract 95.07, District of Columbia, District of Columbia",136,10,102,0,0,0,22,2,136,104,0,101,0,0,0,1,2,32,10,1,0,0,0,21,0,110010095071007,4,406,406,4,psa_54,4D2
1000000US110010103001017,"Block 1017, Block Group 1, Census Tract 103, District of Columbia, District of Columbia",62,5,29,0,4,0,14,10,62,47,4,28,0,4,0,1,10,15,1,1,0,0,0,13,0,110010103001017,4,401,401,4,psa_56,4D1
1000000US110010010012006,"Block 2006, Block Group 2, Census Tract 10.01, District of Columbia, District of Columbia",0,0,0,0,0,0,0,0,0,0,0,0,0,0,0,0,0,0,0,0,0,0,0,0,0,110010010012006,2,202,202,2,psa_52,2D1
1000000US110010046001005,"Block 1005, Block Group 1, Census Tract 46, District of Columbia, District of Columbia",144,32,98,1,9,0,2,2,144,142,32,98,1,9,0,0,2,2,0,0,0,0,0,2,0,110010046001005,3,308,308,3,psa_27,3D2
1000000US110010078041001,"Block 1001, Block Group 1, Census Tract 78.04, District of Columbia, District of Columbia",0,0,0,0,0,0,0,0,0,0,0,0,0,0,0,0,0,0,0,0,0,0,0,0,0,110010078041001,6,608,608,6,psa_19,6D1
1000000US110010047021014,"Block 1014, Block Group 1, Census Tract 47.02, District of Columbia, District of Columbia",0,0,0,0,0,0,0,0,0,0,0,0,0,0,0,0,0,0,0,0,0,0,0,0,0,110010047021014,1,101,101,1,psa_20,1D1
1000000US110010091022022,"Block 2022, Block Group 2, Census Tract 91.02, District of Columbia, District of Columbia",0,0,0,0,0,0,0,0,0,0,0,0,0,0,0,0,0,0,0,0,0,0,0,0,0,110010091022022,5,505,505,5,psa_34,5D2
1000000US110010092032011,"Block 2011, Block Group 2, Census Tract 92.03, District of Columbia, District of Columbia",135,11,104,1,0,0,11,8,135,121,10,104,1,0,0,0,6,14,1,0,0,0,0,11,2,110010092032011,5,502,502,5,psa_40,5D1
1000000US110010009022016,"Block 2016, Block Group 2, Census Tract 9.02, District of Columbia, District of Columbia",0,0,0,0,0,0,0,0,0,0,0,0,0,0,0,0,0,0,0,0,0,0,0,0,0,110010009022016,2,205,205,2,psa_46,2D2
1000000US110010099061003,"Block 1003, Block Group 1, Census Tract 99.06, District of Columbia, District of Columbia",118,0,115,0,0,0,0,3,118,112,0,111,0,0,0,0,1,6,0,4,0,0,0,0,2,110010099061003,6,604,604,6,psa_14,6D3
1000000US110010020021003,"Block 1003, Block Group 1, Census Tract 20.02, District of Columbia, District of Columbia",25,3,19,0,0,0,0,3,25,25,3,19,0,0,0,0,3,0,0,0,0,0,0,0,0,110010020021003,4,403,403,4,psa_51,4D1
1000000US110010067003002,"Block 3002, Block Group 3, Census Tract 67, District of Columbia, District of Columbia",115,100,6,0,2,0,4,3,115,108,97,5,0,2,0,1,3,7,3,1,0,0,0,3,0,110010067003002,1,107,107,1,psa_16,1D2
1000000US110010034002016,"Block 2016, Block Group 2, Census Tract 34, District of Columbia, District of Columbia",63,7,45,0,4,0,2,5,63,60,7,45,0,4,0,1,3,3,0,0,0,0,0,1,2,110010034002016,3,306,306,3,psa_38,3D2
1000000US110010080022016,"Block 2016, Block Group 2, Census Tract 80.02, District of Columbia, District of Columbia",138,101,27,0,6,0,0,4,138,128,93,25,0,6,0,0,4,10,8,2,0,0,0,0,0,110010080022016,1,108,108,1,psa_17,1D2
1000000US110010006002001,"Block 2001, Block Group 2, Census Tract 6, District of Columbia, District of Columbia",151,112,10,0,13,0,5,11,151,128,101,7,0,12,0,0,8,23,11,3,0,1,0,5,3,110010006002001,2,203,203,2,psa_50,2D1
1000000US110010014011019,"Block 1019, Block Group 1, Census Tract 14.01, District of Columbia, District of Columbia",84,69,4,0,4,0,0,7,84,76,64,4,0,4,0,0,4,8,5,0,0,0,0,0,3,110010014011019,2,201,201,2,psa_55,2D1
1000000US110010111003046,"Block 3046, Block Group 3, Census Tract 111, District of Columbia, District of Columbia",0,0,0,0,0,0,0,0,0,0,0,0,0,0,0,0,0,0,0,0,0,0,0,0,0,110010111003046,5,503,503,5,psa_45,5D2
1000000US110010009022035,"Block 2035, Block Group 2, Census Tract 9.02, District of Columbia, District of Columbia",29,24,3,1,1,0,0,0,29,28,24,3,0,1,0,0,0,1,0,0,1,0,0,0,0,110010009022035,2,205,205,2,psa_46,2D2
1000000US110010028021001,"Block 1001, Block Group 1, Census Tract 28.02, District of Columbia, District of Columbia",529,261,87,6,43,0,116,16,529,279,147,82,0,42,0,1,7,250,114,5,6,1,0,115,9,110010028021001,3,302,302,3,psa_42,3D1
1000000US110010049012010,"Block 2010, Block Group 2, Census Tract 49.01, District of Columbia, District of Columbia",0,0,0,0,0,0,0,0,0,0,0,0,0,0,0,0,0,0,0,0,0,0,0,0,0,110010049012010,3,307,307,3,psa_28,3D3
1000000US110010062021107,"Block 1107, Block Group 1, Census Tract 62.02, District of Columbia, District of Columbia",0,0,0,0,0,0,0,0,0,0,0,0,0,0,0,0,0,0,0,0,0,0,0,0,0,110010062021107,1,102,102,1,psa_18,1D1
1000000US110010067002008,"Block 2008, Block Group 2, Census Tract 67, District of Columbia, District of Columbia",87,76,3,0,3,0,0,5,87,86,76,3,0,3,0,0,4,1,0,0,0,0,0,0,1,110010067002008,1,107,107,1,psa_16,1D2
1000000US110010010023004,"Block 3004, Block Group 3, Census Tract 10.02, District of Columbia, District of Columbia",0,0,0,0,0,0,0,0,0,0,0,0,0,0,0,0,0,0,0,0,0,0,0,0,0,110010010023004,2,202,202,2,psa_52,2D1
1000000US110010032001005,"Block 1005, Block Group 1, Census Tract 32, District of Columbia, District of Columbia",137,15,109,1,0,0,11,1,137,124,13,109,1,0,0,0,1,13,2,0,0,0,0,11,0,110010032001005,4,409,409,4,psa_41,4D3
1000000US110010099041000,"Block 1000, Block Group 1, Census Tract 99.04, District of Columbia, District of Columbia",0,0,0,0,0,0,0,0,0,0,0,0,0,0,0,0,0,0,0,0,0,0,0,0,0,110010099041000,6,604,604,6,psa_14,6D3
1000000US110010010013002,"Block 3002, Block Group 3, Census Tract 10.01, District of Columbia, District of Columbia",59,51,1,0,2,0,0,5,59,59,51,1,0,2,0,0,5,0,0,0,0,0,0,0,0,110010010013002,2,202,202,2,psa_52,2D1
1000000US110010011002014,"Block 2014, Block Group 2, Census Tract 11, District of Columbia, District of Columbia",0,0,0,0,0,0,0,0,0,0,0,0,0,0,0,0,0,0,0,0,0,0,0,0,0,110010011002014,2,202,202,2,psa_52,2D1
1000000US110010089041004,"Block 1004, Block Group 1, Census Tract 89.04, District of Columbia, District of Columbia",913,9,875,3,0,0,4,22,913,904,9,871,3,0,0,0,21,9,0,4,0,0,0,4,1,110010089041004,5,507,507,5,psa_23,5D3
1000000US110010011004000,"Block 4000, Block Group 4, Census Tract 11, District of Columbia, District of Columbia",4,1,0,0,1,0,0,2,4,4,1,0,0,1,0,0,2,0,0,0,0,0,0,0,0,110010011004000,2,202,202,2,psa_52,2D1
1000000US110010016001004,"Block 1004, Block Group 1, Census Tract 16, District of Columbia, District of Columbia",70,8,61,0,0,0,1,0,70,70,8,61,0,0,0,1,0,0,0,0,0,0,0,0,0,110010016001004,4,401,401,4,psa_56,4D1
1000000US110010078043017,"Block 3017, Block Group 3, Census Tract 78.04, District of Columbia, District of Columbia",6,0,2,1,0,0,0,3,6,6,0,2,1,0,0,0,3,0,0,0,0,0,0,0,0,110010078043017,6,608,608,6,psa_19,6D1
1000000US110010007014000,"Block 4000, Block Group 4, Census Tract 7.01, District of Columbia, District of Columbia",0,0,0,0,0,0,0,0,0,0,0,0,0,0,0,0,0,0,0,0,0,0,0,0,0,110010007014000,2,204,204,2,psa_44,2D2
1000000US110010088021003,"Block 1003, Block Group 1, Census Tract 88.02, District of Columbia, District of Columbia",111,1,108,2,0,0,0,0,111,103,0,101,2,0,0,0,0,8,1,7,0,0,0,0,0,110010088021003,5,506,506,5,psa_26,5D3
1000000US110010073011006,"Block 1006, Block Group 1, Census Tract 73.01, District of Columbia, District of Columbia",0,0,0,0,0,0,0,0,0,0,0,0,0,0,0,0,0,0,0,0,0,0,0,0,0,110010073011006,7,703,703,7,psa_8,7D1
1000000US110010099012011,"Block 2011, Block Group 2, Census Tract 99.01, District of Columbia, District of Columbia",62,1,60,0,0,0,0,1,62,58,0,57,0,0,0,0,1,4,1,3,0,0,0,0,0,110010099012011,6,605,605,6,psa_11,6D2
1000000US110010002021003,"Block 1003, Block Group 1, Census Tract 2.02, District of Columbia, District of Columbia",65,57,0,0,4,0,0,4,65,62,55,0,0,4,0,0,3,3,2,0,0,0,0,0,1,110010002021003,2,206,206,2,psa_29,2D2
1000000US110010017022014,"Block 2014, Block Group 2, Census Tract 17.02, District of Columbia, District of Columbia",71,43,24,0,0,0,0,4,71,64,36,24,0,0,0,0,4,7,7,0,0,0,0,0,0,110010017022014,4,401,401,4,psa_56,4D1
1000000US110010067002001,"Block 2001, Block Group 2, Census Tract 67, District of Columbia, District of Columbia",107,93,12,0,2,0,0,0,107,98,86,10,0,2,0,0,0,9,7,2,0,0,0,0,0,110010067002001,1,107,107,1,psa_16,1D2
1000000US110010079014004,"Block 4004, Block Group 4, Census Tract 79.01, District of Columbia, District of Columbia",94,14,78,0,0,0,0,2,94,92,14,78,0,0,0,0,0,2,0,0,0,0,0,0,2,110010079014004,5,507,507,5,psa_23,5D3
1000000US110010017021001,"Block 1001, Block Group 1, Census Tract 17.02, District of Columbia, District of Columbia",298,184,87,1,12,0,6,8,298,276,171,85,1,12,0,0,7,22,13,2,0,0,0,6,1,110010017021001,4,401,401,4,psa_56,4D1
1000000US110010088031024,"Block 1024, Block Group 1, Census Tract 88.03, District of Columbia, District of Columbia",0,0,0,0,0,0,0,0,0,0,0,0,0,0,0,0,0,0,0,0,0,0,0,0,0,110010088031024,5,501,501,5,psa_35,5D1
1000000US110010009022029,"Block 2029, Block Group 2, Census Tract 9.02, District of Columbia, District of Columbia",45,38,1,0,5,0,0,1,45,42,37,0,0,5,0,0,0,3,1,1,0,0,0,0,1,110010009022029,2,205,205,2,psa_46,2D2
1000000US110010010014003,"Block 4003, Block Group 4, Census Tract 10.01, District of Columbia, District of Columbia",72,67,4,0,0,0,1,0,72,58,54,4,0,0,0,0,0,14,13,0,0,0,0,1,0,110010010014003,2,202,202,2,psa_52,2D1
1000000US110010083012002,"Block 2002, Block Group 2, Census Tract 83.01, District of Columbia, District of Columbia",193,157,29,0,1,0,1,5,193,185,153,26,0,1,0,0,5,8,4,3,0,0,0,1,0,110010083012002,1,104,104,1,psa_21,1D2
1000000US110010014021003,"Block 1003, Block Group 1, Census Tract 14.02, District of Columbia, District of Columbia",55,53,2,0,0,0,0,0,55,55,53,2,0,0,0,0,0,0,0,0,0,0,0,0,0,110010014021003,2,201,201,2,psa_55,2D1
1000000US110010080022019,"Block 2019, Block Group 2, Census Tract 80.02, District of Columbia, District of Columbia",106,79,26,0,1,0,0,0,106,97,70,26,0,1,0,0,0,9,9,0,0,0,0,0,0,110010080022019,1,108,108,1,psa_17,1D2
1000000US110010062021040,"Block 1040, Block Group 1, Census Tract 62.02, District of Columbia, District of Columbia",0,0,0,0,0,0,0,0,0,0,0,0,0,0,0,0,0,0,0,0,0,0,0,0,0,110010062021040,2,207,207,2,psa_24,2D3
1000000US110010095052005,"Block 2005, Block Group 2, Census Tract 95.05, District of Columbia, District of Columbia",105,2,98,0,0,0,4,1,105,100,2,98,0,0,0,0,0,5,0,0,0,0,0,4,1,110010095052005,4,406,406,4,psa_54,4D2
1000000US110010108001005,"Block 1005, Block Group 1, Census Tract 108.00, District of Columbia, District of Columbia",609,526,21,0,41,0,1,20,609,608,526,21,0,41,0,0,20,1,0,0,0,0,0,1,0,110010108001005,2,207,207,2,psa_24,2D3
1000000US110010072002025,"Block 2025, Block Group 2, Census Tract 72, District of Columbia, District of Columbia",0,0,0,0,0,0,0,0,0,0,0,0,0,0,0,0,0,0,0,0,0,0,0,0,0,110010072002025,1,106,106,1,psa_13,1D3
1000000US110010111002022,"Block 2022, Block Group 2, Census Tract 111, District of Columbia, District of Columbia",19,0,19,0,0,0,0,0,19,19,0,19,0,0,0,0,0,0,0,0,0,0,0,0,0,110010111002022,5,503,503,5,psa_45,5D2
1000000US110010025021002,"Block 1002, Block Group 1, Census Tract 25.02, District of Columbia, District of Columbia",275,44,128,1,0,0,79,23,275,147,25,119,0,0,0,0,3,128,19,9,1,0,0,79,20,110010025021002,4,404,404,4,psa_48,4D3
1000000US110010070001015,"Block 1015, Block Group 1, Census Tract 70, District of Columbia, District of Columbia",0,0,0,0,0,0,0,0,0,0,0,0,0,0,0,0,0,0,0,0,0,0,0,0,0,110010070001015,1,106,106,1,psa_13,1D3
1000000US110010007021007,"Block 1007, Block Group 1, Census Tract 7.02, District of Columbia, District of Columbia",0,0,0,0,0,0,0,0,0,0,0,0,0,0,0,0,0,0,0,0,0,0,0,0,0,110010007021007,2,204,204,2,psa_44,2D2
1000000US110010073011077,"Block 1077, Block Group 1, Census Tract 73.01, District of Columbia, District of Columbia",0,0,0,0,0,0,0,0,0,0,0,0,0,0,0,0,0,0,0,0,0,0,0,0,0,110010073011077,7,708,708,7,psa_1,7D3
1000000US110010077092001,"Block 2001, Block Group 2, Census Tract 77.09, District of Columbia, District of Columbia",135,0,125,1,0,0,9,0,135,130,0,125,1,0,0,4,0,5,0,0,0,0,0,5,0,110010077092001,6,605,605,6,psa_11,6D2
1000000US110010095092005,"Block 2005, Block Group 2, Census Tract 95.09, District of Columbia, District of Columbia",119,3,112,0,0,0,0,4,119,119,3,112,0,0,0,0,4,0,0,0,0,0,0,0,0,110010095092005,4,405,405,4,psa_49,4D2
1000000US110010076015020,"Block 5020, Block Group 5, Census Tract 76.01, District of Columbia, District of Columbia",121,5,116,0,0,0,0,0,121,120,5,115,0,0,0,0,0,1,0,1,0,0,0,0,0,110010076015020,6,607,607,6,psa_10,6D2
1000000US110010068012002,"Block 2002, Block Group 2, Census Tract 68.01, District of Columbia, District of Columbia",123,70,41,0,4,0,3,5,123,115,64,41,0,4,0,1,5,8,6,0,0,0,0,2,0,110010068012002,1,107,107,1,psa_16,1D2
1000000US110010099032006,"Block 2006, Block Group 2, Census Tract 99.03, District of Columbia, District of Columbia",30,0,30,0,0,0,0,0,30,30,0,30,0,0,0,0,0,0,0,0,0,0,0,0,0,110010099032006,6,604,604,6,psa_14,6D3
1000000US110010039002011,"Block 2011, Block Group 2, Census Tract 39, District of Columbia, District of Columbia",141,127,3,2,4,0,0,5,141,135,121,3,2,4,0,0,5,6,6,0,0,0,0,0,0,110010039002011,3,303,303,3,psa_37,3D3
1000000US110010088031011,"Block 1011, Block Group 1, Census Tract 88.03, District of Columbia, District of Columbia",8,0,8,0,0,0,0,0,8,8,0,8,0,0,0,0,0,0,0,0,0,0,0,0,0,110010088031011,5,506,506,5,psa_26,5D3
1000000US110010055002005,"Block 2005, Block Group 2, Census Tract 55, District of Columbia, District of Columbia",335,286,7,1,30,0,1,10,335,312,267,7,0,29,0,0,9,23,19,0,1,1,0,1,1,110010055002005,2,207,207,2,psa_24,2D3
1000000US110010059001022,"Block 1022, Block Group 1, Census Tract 59, District of Columbia, District of Columbia",0,0,0,0,0,0,0,0,0,0,0,0,0,0,0,0,0,0,0,0,0,0,0,0,0,110010059001022,1,102,102,1,psa_18,1D1
1000000US110010046002007,"Block 2007, Block Group 2, Census Tract 46, District of Columbia, District of Columbia",81,22,45,0,2,0,4,8,81,74,22,45,0,2,0,0,5,7,0,0,0,0,0,4,3,110010046002007,3,308,308,3,psa_27,3D2
1000000US110010068041012,"Block 1012, Block Group 1, Census Tract 68.04, District of Columbia, District of Columbia",0,0,0,0,0,0,0,0,0,0,0,0,0,0,0,0,0,0,0,0,0,0,0,0,0,110010068041012,1,107,107,1,psa_16,1D2
1000000US110010071001014,"Block 1014, Block Group 1, Census Tract 71, District of Columbia, District of Columbia",0,0,0,0,0,0,0,0,0,0,0,0,0,0,0,0,0,0,0,0,0,0,0,0,0,110010071001014,1,106,106,1,psa_13,1D3
1000000US110010104002015,"Block 2015, Block Group 2, Census Tract 104, District of Columbia, District of Columbia",133,0,132,0,0,0,0,1,133,129,0,128,0,0,0,0,1,4,0,4,0,0,0,0,0,110010104002015,7,707,707,7,psa_4,7D2
1000000US110010011004025,"Block 4025, Block Group 4, Census Tract 11, District of Columbia, District of Columbia",5,5,0,0,0,0,0,0,5,5,5,0,0,0,0,0,0,0,0,0,0,0,0,0,0,110010011004025,2,202,202,2,psa_52,2D1
1000000US110010015001019,"Block 1019, Block Group 1, Census Tract 15, District of Columbia, District of Columbia",0,0,0,0,0,0,0,0,0,0,0,0,0,0,0,0,0,0,0,0,0,0,0,0,0,110010015001019,2,201,201,2,psa_55,2D1
1000000US110010056002023,"Block 2023, Block Group 2, Census Tract 56, District of Columbia, District of Columbia",0,0,0,0,0,0,0,0,0,0,0,0,0,0,0,0,0,0,0,0,0,0,0,0,0,110010056002023,2,207,207,2,psa_24,2D3
1000000US110010068041019,"Block 1019, Block Group 1, Census Tract 68.04, District of Columbia, District of Columbia",0,0,0,0,0,0,0,0,0,0,0,0,0,0,0,0,0,0,0,0,0,0,0,0,0,110010068041019,5,507,507,5,psa_23,5D3
1000000US110010094001004,"Block 1004, Block Group 1, Census Tract 94, District of Columbia, District of Columbia",5,0,5,0,0,0,0,0,5,5,0,5,0,0,0,0,0,0,0,0,0,0,0,0,0,110010094001004,5,503,503,5,psa_45,5D2
1000000US110010096011016,"Block 1016, Block Group 1, Census Tract 96.01, District of Columbia, District of Columbia",43,0,43,0,0,0,0,0,43,43,0,43,0,0,0,0,0,0,0,0,0,0,0,0,0,110010096011016,6,601,601,6,psa_30,6D1
1000000US110010099011003,"Block 1003, Block Group 1, Census Tract 99.01, District of Columbia, District of Columbia",28,2,26,0,0,0,0,0,28,28,2,26,0,0,0,0,0,0,0,0,0,0,0,0,0,110010099011003,6,605,605,6,psa_11,6D2
1000000US110010073011027,"Block 1027, Block Group 1, Census Tract 73.01, District of Columbia, District of Columbia",0,0,0,0,0,0,0,0,0,0,0,0,0,0,0,0,0,0,0,0,0,0,0,0,0,110010073011027,7,703,703,7,psa_8,7D1
1000000US110010104002022,"Block 2022, Block Group 2, Census Tract 104, District of Columbia, District of Columbia",0,0,0,0,0,0,0,0,0,0,0,0,0,0,0,0,0,0,0,0,0,0,0,0,0,110010104002022,7,703,703,7,psa_8,7D1
1000000US110010110004001,"Block 4001, Block Group 4, Census Tract 110, District of Columbia, District of Columbia",374,183,156,1,19,0,3,12,374,363,178,154,1,19,0,0,11,11,5,2,0,0,0,3,1,110010110004001,1,105,105,1,psa_22,1D3
1000000US110010088031026,"Block 1026, Block Group 1, Census Tract 88.03, District of Columbia, District of Columbia",0,0,0,0,0,0,0,0,0,0,0,0,0,0,0,0,0,0,0,0,0,0,0,0,0,110010088031026,5,501,501,5,psa_35,5D1
1000000US110010087012008,"Block 2008, Block Group 2, Census Tract 87.01, District of Columbia, District of Columbia",134,10,116,0,2,0,6,0,134,128,10,116,0,2,0,0,0,6,0,0,0,0,0,6,0,110010087012008,5,502,502,5,psa_40,5D1
1000000US110010106002057,"Block 2057, Block Group 2, Census Tract 106, District of Columbia, District of Columbia",0,0,0,0,0,0,0,0,0,0,0,0,0,0,0,0,0,0,0,0,0,0,0,0,0,110010106002057,1,102,102,1,psa_18,1D1
1000000US110010106002060,"Block 2060, Block Group 2, Census Tract 106, District of Columbia, District of Columbia",0,0,0,0,0,0,0,0,0,0,0,0,0,0,0,0,0,0,0,0,0,0,0,0,0,110010106002060,1,102,102,1,psa_18,1D1
1000000US110010111001033,"Block 1033, Block Group 1, Census Tract 111, District of Columbia, District of Columbia",0,0,0,0,0,0,0,0,0,0,0,0,0,0,0,0,0,0,0,0,0,0,0,0,0,110010111001033,5,503,503,5,psa_45,5D2
1000000US110010082002012,"Block 2012, Block Group 2, Census Tract 82, District of Columbia, District of Columbia",146,129,10,0,2,0,5,0,146,136,125,10,0,1,0,0,0,10,4,0,0,1,0,5,0,110010082002012,1,108,108,1,psa_17,1D2
1000000US110010010014015,"Block 4015, Block Group 4, Census Tract 10.01, District of Columbia, District of Columbia",61,41,1,0,10,0,0,9,61,49,31,1,0,10,0,0,7,12,10,0,0,0,0,0,2,110010010014015,2,202,202,2,psa_52,2D1
1000000US110010049012000,"Block 2000, Block Group 2, Census Tract 49.01, District of Columbia, District of Columbia",47,24,21,0,2,0,0,0,47,43,20,21,0,2,0,0,0,4,4,0,0,0,0,0,0,110010049012000,3,307,307,3,psa_28,3D3
1000000US110010074093002,"Block 3002, Block Group 3, Census Tract 74.09, District of Columbia, District of Columbia",304,0,303,0,0,0,0,1,304,300,0,299,0,0,0,0,1,4,0,4,0,0,0,0,0,110010074093002,7,704,704,7,psa_5,7D2
1000000US110010080013003,"Block 3003, Block Group 3, Census Tract 80.01, District of Columbia, District of Columbia",122,54,61,0,4,0,1,2,122,114,47,60,0,4,0,1,2,8,7,1,0,0,0,0,0,110010080013003,1,108,108,1,psa_17,1D2
1000000US110010095083005,"Block 3005, Block Group 3, Census Tract 95.08, District of Columbia, District of Columbia",5,1,4,0,0,0,0,0,5,5,1,4,0,0,0,0,0,0,0,0,0,0,0,0,0,110010095083005,4,406,406,4,psa_54,4D2
1000000US110010012004001,"Block 4001, Block Group 4, Census Tract 12, District of Columbia, District of Columbia",51,44,3,0,0,0,0,4,51,50,43,3,0,0,0,0,4,1,1,0,0,0,0,0,0,110010012004001,2,203,203,2,psa_50,2D1
1000000US110010092011002,"Block 1002, Block Group 1, Census Tract 92.01, District of Columbia, District of Columbia",0,0,0,0,0,0,0,0,0,0,0,0,0,0,0,0,0,0,0,0,0,0,0,0,0,110010092011002,5,502,502,5,psa_40,5D1
1000000US110010098112006,"Block 2006, Block Group 2, Census Tract 98.11, District of Columbia, District of Columbia",65,0,65,0,0,0,0,0,65,65,0,65,0,0,0,0,0,0,0,0,0,0,0,0,0,110010098112006,7,706,706,7,psa_2,7D3
1000000US110010049012009,"Block 2009, Block Group 2, Census Tract 49.01, District of Columbia, District of Columbia",90,56,19,2,9,0,0,4,90,80,50,19,2,9,0,0,0,10,6,0,0,0,0,0,4,110010049012009,3,307,307,3,psa_28,3D3
1000000US110010068041014,"Block 1014, Block Group 1, Census Tract 68.04, District of Columbia, District of Columbia",40,7,33,0,0,0,0,0,40,36,5,31,0,0,0,0,0,4,2,2,0,0,0,0,0,110010068041014,1,107,107,1,psa_16,1D2
1000000US110010002011001,"Block 1001, Block Group 1, Census Tract 2.01, District of Columbia, District of Columbia",3888,2915,257,7,481,5,43,180,3888,3614,2716,247,4,479,5,7,156,274,199,10,3,2,0,36,24,110010002011001,2,206,206,2,psa_29,2D2
1000000US110010076033007,"Block 3007, Block Group 3, Census Tract 76.03, District of Columbia, District of Columbia",20,0,20,0,0,0,0,0,20,20,0,20,0,0,0,0,0,0,0,0,0,0,0,0,0,110010076033007,6,606,606,6,psa_7,6D2
1000000US110010010012020,"Block 2020, Block Group 2, Census Tract 10.01, District of Columbia, District of Columbia",0,0,0,0,0,0,0,0,0,0,0,0,0,0,0,0,0,0,0,0,0,0,0,0,0,110010010012020,2,202,202,2,psa_52,2D1
1000000US110010111003013,"Block 3013, Block Group 3, Census Tract 111, District of Columbia, District of Columbia",0,0,0,0,0,0,0,0,0,0,0,0,0,0,0,0,0,0,0,0,0,0,0,0,0,110010111003013,5,505,505,5,psa_34,5D2
1000000US110010011004023,"Block 4023, Block Group 4, Census Tract 11, District of Columbia, District of Columbia",0,0,0,0,0,0,0,0,0,0,0,0,0,0,0,0,0,0,0,0,0,0,0,0,0,110010011004023,2,202,202,2,psa_52,2D1
1000000US110010073011136,"Block 1136, Block Group 1, Census Tract 73.01, District of Columbia, District of Columbia",33,14,16,0,0,0,3,0,33,27,11,16,0,0,0,0,0,6,3,0,0,0,0,3,0,110010073011136,7,707,707,7,psa_4,7D2
1000000US110010036003001,"Block 3001, Block Group 3, Census Tract 36, District of Columbia, District of Columbia",299,169,53,1,9,0,49,18,299,227,147,53,1,9,0,4,13,72,22,0,0,0,0,45,5,110010036003001,3,304,304,3,psa_36,3D1
1000000US110010094003005,"Block 3005, Block Group 3, Census Tract 94, District of Columbia, District of Columbia",0,0,0,0,0,0,0,0,0,0,0,0,0,0,0,0,0,0,0,0,0,0,0,0,0,110010094003005,5,503,503,5,psa_45,5D2
1000000US110010003002002,"Block 2002, Block Group 2, Census Tract 3, District of Columbia, District of Columbia",79,68,2,0,8,0,0,1,79,76,65,2,0,8,0,0,1,3,3,0,0,0,0,0,0,110010003002002,2,204,204,2,psa_44,2D2
1000000US110010078031014,"Block 1014, Block Group 1, Census Tract 78.03, District of Columbia, District of Columbia",0,0,0,0,0,0,0,0,0,0,0,0,0,0,0,0,0,0,0,0,0,0,0,0,0,110010078031014,6,602,602,6,psa_25,6D1
1000000US110010111003042,"Block 3042, Block Group 3, Census Tract 111, District of Columbia, District of Columbia",19,3,16,0,0,0,0,0,19,19,3,16,0,0,0,0,0,0,0,0,0,0,0,0,0,110010111003042,5,503,503,5,psa_45,5D2
1000000US110010062021122,"Block 1122, Block Group 1, Census Tract 62.02, District of Columbia, District of Columbia",0,0,0,0,0,0,0,0,0,0,0,0,0,0,0,0,0,0,0,0,0,0,0,0,0,110010062021122,1,102,102,1,psa_18,1D1
1000000US110010099041003,"Block 1003, Block Group 1, Census Tract 99.04, District of Columbia, District of Columbia",79,2,76,1,0,0,0,0,79,76,2,73,1,0,0,0,0,3,0,3,0,0,0,0,0,110010099041003,6,604,604,6,psa_14,6D3
1000000US110010106002044,"Block 2044, Block Group 2, Census Tract 106, District of Columbia, District of Columbia",90,39,32,0,3,0,13,3,90,76,38,32,0,3,0,0,3,14,1,0,0,0,0,13,0,110010106002044,5,501,501,5,psa_35,5D1
1000000US110010012001002,"Block 1002, Block Group 1, Census Tract 12, District of Columbia, District of Columbia",159,116,23,0,9,0,4,7,159,150,112,23,0,9,0,2,4,9,4,0,0,0,0,2,3,110010012001002,2,203,203,2,psa_50,2D1
1000000US110010070001003,"Block 1003, Block Group 1, Census Tract 70, District of Columbia, District of Columbia",139,122,9,0,5,0,0,3,139,134,117,9,0,5,0,0,3,5,5,0,0,0,0,0,0,110010070001003,1,106,106,1,psa_13,1D3
1000000US110010070002014,"Block 2014, Block Group 2, Census Tract 70, District of Columbia, District of Columbia",161,103,36,1,17,0,4,0,161,154,98,36,1,17,0,2,0,7,5,0,0,0,0,2,0,110010070002014,1,106,106,1,psa_13,1D3
1000000US110010078043015,"Block 3015, Block Group 3, Census Tract 78.04, District of Columbia, District of Columbia",6,0,5,0,0,0,0,1,6,6,0,5,0,0,0,0,1,0,0,0,0,0,0,0,0,110010078043015,6,608,608,6,psa_19,6D1
1000000US110010044002018,"Block 2018, Block Group 2, Census Tract 44, District of Columbia, District of Columbia",166,91,56,0,9,0,0,10,166,152,82,54,0,9,0,0,7,14,9,2,0,0,0,0,3,110010044002018,3,305,305,3,psa_32,3D2
1000000US110010076012000,"Block 2000, Block Group 2, Census Tract 76.01, District of Columbia, District of Columbia",92,2,90,0,0,0,0,0,92,92,2,90,0,0,0,0,0,0,0,0,0,0,0,0,0,110010076012000,6,607,607,6,psa_10,6D2
1000000US110010108003000,"Block 3000, Block Group 3, Census Tract 108.00, District of Columbia, District of Columbia",0,0,0,0,0,0,0,0,0,0,0,0,0,0,0,0,0,0,0,0,0,0,0,0,0,110010108003000,2,207,207,2,psa_24,2D3
1000000US110010011004014,"Block 4014, Block Group 4, Census Tract 11, District of Columbia, District of Columbia",47,31,0,0,10,0,0,6,47,44,29,0,0,10,0,0,5,3,2,0,0,0,0,0,1,110010011004014,2,202,202,2,psa_52,2D1
1000000US110010013011001,"Block 1001, Block Group 1, Census Tract 13.01, District of Columbia, District of Columbia",0,0,0,0,0,0,0,0,0,0,0,0,0,0,0,0,0,0,0,0,0,0,0,0,0,110010013011001,2,203,203,2,psa_50,2D1
1000000US110010096031002,"Block 1002, Block Group 1, Census Tract 96.03, District of Columbia, District of Columbia",0,0,0,0,0,0,0,0,0,0,0,0,0,0,0,0,0,0,0,0,0,0,0,0,0,110010096031002,6,603,603,6,psa_15,6D3
1000000US110010095053009,"Block 3009, Block Group 3, Census Tract 95.05, District of Columbia, District of Columbia",75,1,72,1,0,0,1,0,75,73,1,72,0,0,0,0,0,2,0,0,1,0,0,1,0,110010095053009,4,406,406,4,psa_54,4D2
1000000US110010062021150,"Block 1150, Block Group 1, Census Tract 62.02, District of Columbia, District of Columbia",0,0,0,0,0,0,0,0,0,0,0,0,0,0,0,0,0,0,0,0,0,0,0,0,0,110010062021150,1,103,103,1,psa_12,1D1
1000000US110010019022008,"Block 2008, Block Group 2, Census Tract 19.02, District of Columbia, District of Columbia",14,7,5,0,1,0,1,0,14,13,7,5,0,1,0,0,0,1,0,0,0,0,0,1,0,110010019022008,4,406,406,4,psa_54,4D2
1000000US110010007021000,"Block 1000, Block Group 1, Census Tract 7.02, District of Columbia, District of Columbia",515,439,15,1,27,0,17,16,515,458,399,14,0,27,0,6,12,57,40,1,1,0,0,11,4,110010007021000,2,204,204,2,psa_44,2D2
1000000US110010104002008,"Block 2008, Block Group 2, Census Tract 104, District of Columbia, District of Columbia",0,0,0,0,0,0,0,0,0,0,0,0,0,0,0,0,0,0,0,0,0,0,0,0,0,110010104002008,7,703,703,7,psa_8,7D1
1000000US110010073011024,"Block 1024, Block Group 1, Census Tract 73.01, District of Columbia, District of Columbia",0,0,0,0,0,0,0,0,0,0,0,0,0,0,0,0,0,0,0,0,0,0,0,0,0,110010073011024,7,703,703,7,psa_8,7D1
1000000US110010078032002,"Block 2002, Block Group 2, Census Tract 78.03, District of Columbia, District of Columbia",76,0,76,0,0,0,0,0,76,76,0,76,0,0,0,0,0,0,0,0,0,0,0,0,0,110010078032002,6,602,602,6,psa_25,6D1
1000000US110010015005007,"Block 5007, Block Group 5, Census Tract 15, District of Columbia, District of Columbia",62,51,3,0,2,0,0,6,62,62,51,3,0,2,0,0,6,0,0,0,0,0,0,0,0,110010015005007,2,201,201,2,psa_55,2D1
1000000US110010078081001,"Block 1001, Block Group 1, Census Tract 78.08, District of Columbia, District of Columbia",0,0,0,0,0,0,0,0,0,0,0,0,0,0,0,0,0,0,0,0,0,0,0,0,0,110010078081001,6,608,608,6,psa_19,6D1
1000000US110010098031000,"Block 1000, Block Group 1, Census Tract 98.03, District of Columbia, District of Columbia",252,1,251,0,0,0,0,0,252,250,0,250,0,0,0,0,0,2,1,1,0,0,0,0,0,110010098031000,7,707,707,7,psa_4,7D2
1000000US110010079031005,"Block 1005, Block Group 1, Census Tract 79.03, District of Columbia, District of Columbia",3,0,3,0,0,0,0,0,3,3,0,3,0,0,0,0,0,0,0,0,0,0,0,0,0,110010079031005,5,507,507,5,psa_23,5D3
1000000US110010087021004,"Block 1004, Block Group 1, Census Tract 87.02, District of Columbia, District of Columbia",80,12,68,0,0,0,0,0,80,76,8,68,0,0,0,0,0,4,4,0,0,0,0,0,0,110010087021004,5,502,502,5,psa_40,5D1
1000000US110010078041003,"Block 1003, Block Group 1, Census Tract 78.04, District of Columbia, District of Columbia",90,0,83,0,0,0,5,2,90,85,0,83,0,0,0,0,2,5,0,0,0,0,0,5,0,110010078041003,6,602,602,6,psa_25,6D1
1000000US110010103001003,"Block 1003, Block Group 1, Census Tract 103, District of Columbia, District of Columbia",0,0,0,0,0,0,0,0,0,0,0,0,0,0,0,0,0,0,0,0,0,0,0,0,0,110010103001003,4,401,401,4,psa_56,4D1
1000000US110010109002036,"Block 2036, Block Group 2, Census Tract 109, District of Columbia, District of Columbia",0,0,0,0,0,0,0,0,0,0,0,0,0,0,0,0,0,0,0,0,0,0,0,0,0,110010109002036,7,708,708,7,psa_1,7D3
1000000US110010004002023,"Block 2023, Block Group 2, Census Tract 4, District of Columbia, District of Columbia",23,18,0,0,0,0,0,5,23,23,18,0,0,0,0,0,5,0,0,0,0,0,0,0,0,110010004002023,2,204,204,2,psa_44,2D2
1000000US110010047021020,"Block 1020, Block Group 1, Census Tract 47.02, District of Columbia, District of Columbia",0,0,0,0,0,0,0,0,0,0,0,0,0,0,0,0,0,0,0,0,0,0,0,0,0,110010047021020,1,102,102,1,psa_18,1D1
1000000US110010076053000,"Block 3000, Block Group 3, Census Tract 76.05, District of Columbia, District of Columbia",191,0,181,0,0,0,1,9,191,190,0,180,0,0,0,1,9,1,0,1,0,0,0,0,0,110010076053000,6,607,607,6,psa_10,6D2
1000000US110010084101005,"Block 1005, Block Group 1, Census Tract 84.10, District of Columbia, District of Columbia",50,12,38,0,0,0,0,0,50,49,11,38,0,0,0,0,0,1,1,0,0,0,0,0,0,110010084101005,1,104,104,1,psa_21,1D2
1000000US110010099072002,"Block 2002, Block Group 2, Census Tract 99.07, District of Columbia, District of Columbia",151,0,151,0,0,0,0,0,151,151,0,151,0,0,0,0,0,0,0,0,0,0,0,0,0,110010099072002,6,605,605,6,psa_11,6D2
1000000US110010011001008,"Block 1008, Block Group 1, Census Tract 11, District of Columbia, District of Columbia",118,105,4,0,3,0,0,6,118,111,99,4,0,3,0,0,5,7,6,0,0,0,0,0,1,110010011001008,2,201,201,2,psa_55,2D1
1000000US110010095042018,"Block 2018, Block Group 2, Census Tract 95.04, District of Columbia, District of Columbia",74,0,68,1,0,0,0,5,74,73,0,68,0,0,0,0,5,1,0,0,1,0,0,0,0,110010095042018,4,405,405,4,psa_49,4D2
1000000US110010089042001,"Block 2001, Block Group 2, Census Tract 89.04, District of Columbia, District of Columbia",0,0,0,0,0,0,0,0,0,0,0,0,0,0,0,0,0,0,0,0,0,0,0,0,0,110010089042001,5,507,507,5,psa_23,5D3
1000000US110010007023000,"Block 3000, Block Group 3, Census Tract 7.02, District of Columbia, District of Columbia",59,52,3,0,2,0,0,2,59,52,45,3,0,2,0,0,2,7,7,0,0,0,0,0,0,110010007023000,2,204,204,2,psa_44,2D2
1000000US110010008022006,"Block 2006, Block Group 2, Census Tract 8.02, District of Columbia, District of Columbia",4,4,0,0,0,0,0,0,4,4,4,0,0,0,0,0,0,0,0,0,0,0,0,0,0,110010008022006,2,205,205,2,psa_46,2D2
1000000US110010025021000,"Block 1000, Block Group 1, Census Tract 25.02, District of Columbia, District of Columbia",140,12,114,0,0,0,11,3,140,112,7,101,0,0,0,4,0,28,5,13,0,0,0,7,3,110010025021000,4,404,404,4,psa_48,4D3
1000000US110010026002009,"Block 2009, Block Group 2, Census Tract 26, District of Columbia, District of Columbia",30,7,22,1,0,0,0,0,30,30,7,22,1,0,0,0,0,0,0,0,0,0,0,0,0,110010026002009,4,404,404,4,psa_48,4D3
1000000US110010069001010,"Block 1010, Block Group 1, Census Tract 69, District of Columbia, District of Columbia",128,102,18,0,4,0,0,4,128,127,101,18,0,4,0,0,4,1,1,0,0,0,0,0,0,110010069001010,1,107,107,1,psa_16,1D2
1000000US110010001004047,"Block 4047, Block Group 4, Census Tract 1, District of Columbia, District of Columbia",0,0,0,0,0,0,0,0,0,0,0,0,0,0,0,0,0,0,0,0,0,0,0,0,0,110010001004047,2,206,206,2,psa_29,2D2
1000000US110010055005000,"Block 5000, Block Group 5, Census Tract 55, District of Columbia, District of Columbia",0,0,0,0,0,0,0,0,0,0,0,0,0,0,0,0,0,0,0,0,0,0,0,0,0,110010055005000,2,208,208,2,psa_33,2D3
1000000US110010078034002,"Block 4002, Block Group 4, Census Tract 78.03, District of Columbia, District of Columbia",157,4,148,0,0,0,0,5,157,150,2,148,0,0,0,0,0,7,2,0,0,0,0,0,5,110010078034002,6,602,602,6,psa_25,6D1
1000000US110010079014001,"Block 4001, Block Group 4, Census Tract 79.01, District of Columbia, District of Columbia",513,7,499,0,1,0,3,3,513,508,7,497,0,1,0,0,3,5,0,2,0,0,0,3,0,110010079014001,5,507,507,5,psa_23,5D3
1000000US110010103001007,"Block 1007, Block Group 1, Census Tract 103, District of Columbia, District of Columbia",0,0,0,0,0,0,0,0,0,0,0,0,0,0,0,0,0,0,0,0,0,0,0,0,0,110010103001007,4,401,401,4,psa_56,4D1
1000000US110010008012006,"Block 2006, Block Group 2, Census Tract 8.01, District of Columbia, District of Columbia",0,0,0,0,0,0,0,0,0,0,0,0,0,0,0,0,0,0,0,0,0,0,0,0,0,110010008012006,2,205,205,2,psa_46,2D2
1000000US110010012002003,"Block 2003, Block Group 2, Census Tract 12, District of Columbia, District of Columbia",80,67,6,0,7,0,0,0,80,78,65,6,0,7,0,0,0,2,2,0,0,0,0,0,0,110010012002003,2,202,202,2,psa_52,2D1
1000000US110010023012006,"Block 2006, Block Group 2, Census Tract 23.01, District of Columbia, District of Columbia",103,15,80,0,0,0,8,0,103,91,11,80,0,0,0,0,0,12,4,0,0,0,0,8,0,110010023012006,4,407,407,4,psa_47,4D2
1000000US110010106002009,"Block 2009, Block Group 2, Census Tract 106, District of Columbia, District of Columbia",0,0,0,0,0,0,0,0,0,0,0,0,0,0,0,0,0,0,0,0,0,0,0,0,0,110010106002009,5,501,501,5,psa_35,5D1
1000000US110010008021015,"Block 1015, Block Group 1, Census Tract 8.02, District of Columbia, District of Columbia",0,0,0,0,0,0,0,0,0,0,0,0,0,0,0,0,0,0,0,0,0,0,0,0,0,110010008021015,2,205,205,2,psa_46,2D2
1000000US110010010022000,"Block 2000, Block Group 2, Census Tract 10.02, District of Columbia, District of Columbia",400,327,27,0,28,0,4,14,400,371,302,26,0,28,0,1,14,29,25,1,0,0,0,3,0,110010010022000,2,204,204,2,psa_44,2D2
1000000US110010023021024,"Block 1024, Block Group 1, Census Tract 23.02, District of Columbia, District of Columbia",0,0,0,0,0,0,0,0,0,0,0,0,0,0,0,0,0,0,0,0,0,0,0,0,0,110010023021024,4,405,405,4,psa_49,4D2
1000000US110010002024010,"Block 4010, Block Group 4, Census Tract 2.02, District of Columbia, District of Columbia",0,0,0,0,0,0,0,0,0,0,0,0,0,0,0,0,0,0,0,0,0,0,0,0,0,110010002024010,2,205,205,2,psa_46,2D2
1000000US110010017021012,"Block 1012, Block Group 1, Census Tract 17.02, District of Columbia, District of Columbia",92,71,10,0,6,0,0,5,92,91,70,10,0,6,0,0,5,1,1,0,0,0,0,0,0,110010017021012,4,401,401,4,psa_56,4D1
1000000US110010092041007,"Block 1007, Block Group 1, Census Tract 92.04, District of Columbia, District of Columbia",9,3,4,0,1,0,0,1,9,8,2,4,0,1,0,0,1,1,1,0,0,0,0,0,0,110010092041007,5,502,502,5,psa_40,5D1
1000000US110010055005004,"Block 5004, Block Group 5, Census Tract 55, District of Columbia, District of Columbia",0,0,0,0,0,0,0,0,0,0,0,0,0,0,0,0,0,0,0,0,0,0,0,0,0,110010055005004,2,208,208,2,psa_33,2D3
1000000US110010027023010,"Block 3010, Block Group 3, Census Tract 27.02, District of Columbia, District of Columbia",173,147,12,0,9,0,3,2,173,165,140,12,0,9,0,2,2,8,7,0,0,0,0,1,0,110010027023010,3,302,302,3,psa_42,3D1
1000000US110010048011015,"Block 1015, Block Group 1, Census Tract 48.01, District of Columbia, District of Columbia",114,55,28,0,11,0,9,11,114,98,47,27,0,11,0,4,9,16,8,1,0,0,0,5,2,110010048011015,3,308,308,3,psa_27,3D2
1000000US110010008012011,"Block 2011, Block Group 2, Census Tract 8.01, District of Columbia, District of Columbia",74,72,0,0,0,0,2,0,74,69,68,0,0,0,0,1,0,5,4,0,0,0,0,1,0,110010008012011,2,205,205,2,psa_46,2D2
1000000US110010082002017,"Block 2017, Block Group 2, Census Tract 82, District of Columbia, District of Columbia",230,210,6,2,7,0,0,5,230,224,204,6,2,7,0,0,5,6,6,0,0,0,0,0,0,110010082002017,1,108,108,1,psa_17,1D2
1000000US110010031001007,"Block 1007, Block Group 1, Census Tract 31, District of Columbia, District of Columbia",251,97,93,1,11,0,42,7,251,176,70,92,1,7,0,3,3,75,27,1,0,4,0,39,4,110010031001007,4,409,409,4,psa_41,4D3
1000000US110010078061015,"Block 1015, Block Group 1, Census Tract 78.06, District of Columbia, District of Columbia",35,1,34,0,0,0,0,0,35,35,1,34,0,0,0,0,0,0,0,0,0,0,0,0,0,110010078061015,6,602,602,6,psa_25,6D1
1000000US110010104002039,"Block 2039, Block Group 2, Census Tract 104, District of Columbia, District of Columbia",171,3,157,2,0,0,0,9,171,168,2,157,2,0,0,0,7,3,1,0,0,0,0,0,2,110010104002039,7,707,707,7,psa_4,7D2
1000000US110010111003012,"Block 3012, Block Group 3, Census Tract 111, District of Columbia, District of Columbia",0,0,0,0,0,0,0,0,0,0,0,0,0,0,0,0,0,0,0,0,0,0,0,0,0,110010111003012,5,505,505,5,psa_34,5D2
1000000US110010077082008,"Block 2008, Block Group 2, Census Tract 77.08, District of Columbia, District of Columbia",56,0,56,0,0,0,0,0,56,54,0,54,0,0,0,0,0,2,0,2,0,0,0,0,0,110010077082008,6,603,603,6,psa_15,6D3
1000000US110010016003009,"Block 3009, Block Group 3, Census Tract 16, District of Columbia, District of Columbia",57,9,47,0,0,0,0,1,57,54,9,44,0,0,0,0,1,3,0,3,0,0,0,0,0,110010016003009,4,401,401,4,psa_56,4D1
1000000US110010019021003,"Block 1003, Block Group 1, Census Tract 19.02, District of Columbia, District of Columbia",94,14,51,1,1,0,24,3,94,64,7,51,0,1,0,2,3,30,7,0,1,0,0,22,0,110010019021003,4,402,402,4,psa_53,4D1
1000000US110010015003004,"Block 3004, Block Group 3, Census Tract 15, District of Columbia, District of Columbia",54,53,1,0,0,0,0,0,54,52,51,1,0,0,0,0,0,2,2,0,0,0,0,0,0,110010015003004,2,201,201,2,psa_55,2D1
1000000US110010073011101,"Block 1101, Block Group 1, Census Tract 73.01, District of Columbia, District of Columbia",0,0,0,0,0,0,0,0,0,0,0,0,0,0,0,0,0,0,0,0,0,0,0,0,0,110010073011101,7,707,707,7,psa_4,7D2
1000000US110010077034003,"Block 4003, Block Group 4, Census Tract 77.03, District of Columbia, District of Columbia",439,8,424,0,0,0,1,6,439,432,6,422,0,0,0,0,4,7,2,2,0,0,0,1,2,110010077034003,6,603,603,6,psa_15,6D3
1000000US110010104001001,"Block 1001, Block Group 1, Census Tract 104, District of Columbia, District of Columbia",0,0,0,0,0,0,0,0,0,0,0,0,0,0,0,0,0,0,0,0,0,0,0,0,0,110010104001001,7,703,703,7,psa_8,7D1
1000000US110010095041017,"Block 1017, Block Group 1, Census Tract 95.04, District of Columbia, District of Columbia",57,13,35,1,1,0,0,7,57,54,12,35,1,1,0,0,5,3,1,0,0,0,0,0,2,110010095041017,5,504,504,5,psa_43,5D2
1000000US110010095052002,"Block 2002, Block Group 2, Census Tract 95.05, District of Columbia, District of Columbia",20,0,16,0,1,0,0,3,20,20,0,16,0,1,0,0,3,0,0,0,0,0,0,0,0,110010095052002,4,406,406,4,psa_54,4D2
1000000US110010108001003,"Block 1003, Block Group 1, Census Tract 108.00, District of Columbia, District of Columbia",129,87,7,0,29,0,2,4,129,125,86,7,0,29,0,0,3,4,1,0,0,0,0,2,1,110010108001003,2,207,207,2,psa_24,2D3
1000000US110010104002024,"Block 2024, Block Group 2, Census Tract 104, District of Columbia, District of Columbia",0,0,0,0,0,0,0,0,0,0,0,0,0,0,0,0,0,0,0,0,0,0,0,0,0,110010104002024,7,703,703,7,psa_8,7D1
1000000US110010101001004,"Block 1004, Block Group 1, Census Tract 101, District of Columbia, District of Columbia",553,354,98,1,50,0,21,29,553,469,300,96,1,49,0,0,23,84,54,2,0,1,0,21,6,110010101001004,2,209,209,2,psa_57,2D3
1000000US110010011004016,"Block 4016, Block Group 4, Census Tract 11, District of Columbia, District of Columbia",60,47,7,0,0,0,3,3,60,56,43,7,0,0,0,3,3,4,4,0,0,0,0,0,0,110010011004016,2,202,202,2,psa_52,2D1
1000000US110010014021001,"Block 1001, Block Group 1, Census Tract 14.02, District of Columbia, District of Columbia",9,9,0,0,0,0,0,0,9,9,9,0,0,0,0,0,0,0,0,0,0,0,0,0,0,110010014021001,2,201,201,2,psa_55,2D1
1000000US110010003003007,"Block 3007, Block Group 3, Census Tract 3, District of Columbia, District of Columbia",24,24,0,0,0,0,0,0,24,22,22,0,0,0,0,0,0,2,2,0,0,0,0,0,0,110010003003007,2,206,206,2,psa_29,2D2
1000000US110010015002006,"Block 2006, Block Group 2, Census Tract 15, District of Columbia, District of Columbia",97,92,0,0,1,0,0,4,97,91,88,0,0,1,0,0,2,6,4,0,0,0,0,0,2,110010015002006,2,201,201,2,psa_55,2D1
1000000US110010078033001,"Block 3001, Block Group 3, Census Tract 78.03, District of Columbia, District of Columbia",104,0,103,0,0,0,0,1,104,104,0,103,0,0,0,0,1,0,0,0,0,0,0,0,0,110010078033001,6,602,602,6,psa_25,6D1
1000000US110010099021004,"Block 1004, Block Group 1, Census Tract 99.02, District of Columbia, District of Columbia",67,0,63,1,0,0,3,0,67,64,0,63,1,0,0,0,0,3,0,0,0,0,0,3,0,110010099021004,6,605,605,6,psa_11,6D2
1000000US110010019013008,"Block 3008, Block Group 3, Census Tract 19.01, District of Columbia, District of Columbia",184,25,117,1,1,0,38,2,184,131,12,117,1,1,0,0,0,53,13,0,0,0,0,38,2,110010019013008,4,402,402,4,psa_53,4D1
1000000US110010080022022,"Block 2022, Block Group 2, Census Tract 80.02, District of Columbia, District of Columbia",0,0,0,0,0,0,0,0,0,0,0,0,0,0,0,0,0,0,0,0,0,0,0,0,0,110010080022022,1,107,107,1,psa_16,1D2
1000000US110010011001017,"Block 1017, Block Group 1, Census Tract 11, District of Columbia, District of Columbia",65,62,3,0,0,0,0,0,65,61,58,3,0,0,0,0,0,4,4,0,0,0,0,0,0,110010011001017,2,201,201,2,psa_55,2D1
1000000US110010094003017,"Block 3017, Block Group 3, Census Tract 94, District of Columbia, District of Columbia",63,7,41,3,1,0,6,5,63,54,7,41,3,0,0,0,3,9,0,0,0,1,0,6,2,110010094003017,5,503,503,5,psa_45,5D2
1000000US110010024001004,"Block 1004, Block Group 1, Census Tract 24, District of Columbia, District of Columbia",0,0,0,0,0,0,0,0,0,0,0,0,0,0,0,0,0,0,0,0,0,0,0,0,0,110010024001004,4,407,407,4,psa_47,4D2
1000000US110010078072002,"Block 2002, Block Group 2, Census Tract 78.07, District of Columbia, District of Columbia",79,0,79,0,0,0,0,0,79,79,0,79,0,0,0,0,0,0,0,0,0,0,0,0,0,110010078072002,6,608,608,6,psa_19,6D1
1000000US110010071001031,"Block 1031, Block Group 1, Census Tract 71, District of Columbia, District of Columbia",0,0,0,0,0,0,0,0,0,0,0,0,0,0,0,0,0,0,0,0,0,0,0,0,0,110010071001031,1,106,106,1,psa_13,1D3
1000000US110010017021006,"Block 1006, Block Group 1, Census Tract 17.02, District of Columbia, District of Columbia",16,10,6,0,0,0,0,0,16,16,10,6,0,0,0,0,0,0,0,0,0,0,0,0,0,110010017021006,4,401,401,4,psa_56,4D1
1000000US110010074011026,"Block 1026, Block Group 1, Census Tract 74.01, District of Columbia, District of Columbia",0,0,0,0,0,0,0,0,0,0,0,0,0,0,0,0,0,0,0,0,0,0,0,0,0,110010074011026,7,703,703,7,psa_8,7D1
1000000US110010012003002,"Block 3002, Block Group 3, Census Tract 12, District of Columbia, District of Columbia",81,74,1,0,6,0,0,0,81,74,67,1,0,6,0,0,0,7,7,0,0,0,0,0,0,110010012003002,2,203,203,2,psa_50,2D1
1000000US110010032004007,"Block 4007, Block Group 4, Census Tract 32, District of Columbia, District of Columbia",0,0,0,0,0,0,0,0,0,0,0,0,0,0,0,0,0,0,0,0,0,0,0,0,0,110010032004007,3,306,306,3,psa_38,3D2
1000000US110010039001002,"Block 1002, Block Group 1, Census Tract 39, District of Columbia, District of Columbia",278,217,31,1,8,0,10,11,278,248,205,29,1,8,0,1,4,30,12,2,0,0,0,9,7,110010039001002,3,303,303,3,psa_37,3D3
1000000US110010075031008,"Block 1008, Block Group 1, Census Tract 75.03, District of Columbia, District of Columbia",0,0,0,0,0,0,0,0,0,0,0,0,0,0,0,0,0,0,0,0,0,0,0,0,0,110010075031008,7,701,701,7,psa_9,7D1
1000000US110010078062016,"Block 2016, Block Group 2, Census Tract 78.06, District of Columbia, District of Columbia",51,1,50,0,0,0,0,0,51,50,1,49,0,0,0,0,0,1,0,1,0,0,0,0,0,110010078062016,6,602,602,6,psa_25,6D1
1000000US110010087022001,"Block 2001, Block Group 2, Census Tract 87.02, District of Columbia, District of Columbia",41,8,30,0,0,0,2,1,41,39,8,30,0,0,0,0,1,2,0,0,0,0,0,2,0,110010087022001,5,502,502,5,psa_40,5D1
1000000US110010041002003,"Block 2003, Block Group 2, Census Tract 41, District of Columbia, District of Columbia",15,13,0,1,1,0,0,0,15,12,11,0,0,1,0,0,0,3,2,0,1,0,0,0,0,110010041002003,2,208,208,2,psa_33,2D3
1000000US110010064002024,"Block 2024, Block Group 2, Census Tract 64, District of Columbia, District of Columbia",0,0,0,0,0,0,0,0,0,0,0,0,0,0,0,0,0,0,0,0,0,0,0,0,0,110010064002024,1,105,105,1,psa_22,1D3
1000000US110010078081002,"Block 1002, Block Group 1, Census Tract 78.08, District of Columbia, District of Columbia",60,2,58,0,0,0,0,0,60,59,1,58,0,0,0,0,0,1,1,0,0,0,0,0,0,110010078081002,6,608,608,6,psa_19,6D1
1000000US110010047012004,"Block 2004, Block Group 2, Census Tract 47.01, District of Columbia, District of Columbia",138,4,132,0,0,0,2,0,138,136,4,132,0,0,0,0,0,2,0,0,0,0,0,2,0,110010047012004,1,101,101,1,psa_20,1D1
1000000US110010076041002,"Block 1002, Block Group 1, Census Tract 76.04, District of Columbia, District of Columbia",0,0,0,0,0,0,0,0,0,0,0,0,0,0,0,0,0,0,0,0,0,0,0,0,0,110010076041002,6,607,607,6,psa_10,6D2
1000000US110010014022002,"Block 2002, Block Group 2, Census Tract 14.02, District of Columbia, District of Columbia",76,69,0,0,4,0,0,3,76,70,64,0,0,4,0,0,2,6,5,0,0,0,0,0,1,110010014022002,2,201,201,2,psa_55,2D1
1000000US110010021011007,"Block 1007, Block Group 1, Census Tract 21.01, District of Columbia, District of Columbia",117,5,94,2,1,0,8,7,117,106,5,93,2,1,0,0,5,11,0,1,0,0,0,8,2,110010021011007,4,403,403,4,psa_51,4D1
1000000US110010078043008,"Block 3008, Block Group 3, Census Tract 78.04, District of Columbia, District of Columbia",72,6,64,0,1,0,0,1,72,66,1,64,0,1,0,0,0,6,5,0,0,0,0,0,1,110010078043008,6,608,608,6,psa_19,6D1
1000000US110010071001007,"Block 1007, Block Group 1, Census Tract 71, District of Columbia, District of Columbia",205,13,186,4,1,0,0,1,205,203,11,186,4,1,0,0,1,2,2,0,0,0,0,0,0,110010071001007,1,106,106,1,psa_13,1D3
1000000US110010010012032,"Block 2032, Block Group 2, Census Tract 10.01, District of Columbia, District of Columbia",15,12,1,0,2,0,0,0,15,15,12,1,0,2,0,0,0,0,0,0,0,0,0,0,0,110010010012032,2,202,202,2,psa_52,2D1
1000000US110010095052019,"Block 2019, Block Group 2, Census Tract 95.05, District of Columbia, District of Columbia",0,0,0,0,0,0,0,0,0,0,0,0,0,0,0,0,0,0,0,0,0,0,0,0,0,110010095052019,4,406,406,4,psa_54,4D2
1000000US110010009012004,"Block 2004, Block Group 2, Census Tract 9.01, District of Columbia, District of Columbia",0,0,0,0,0,0,0,0,0,0,0,0,0,0,0,0,0,0,0,0,0,0,0,0,0,110010009012004,2,205,205,2,psa_46,2D2
1000000US110010101002005,"Block 2005, Block Group 2, Census Tract 101, District of Columbia, District of Columbia",0,0,0,0,0,0,0,0,0,0,0,0,0,0,0,0,0,0,0,0,0,0,0,0,0,110010101002005,2,207,207,2,psa_24,2D3
1000000US110010056003005,"Block 3005, Block Group 3, Census Tract 56, District of Columbia, District of Columbia",747,460,25,3,211,0,27,21,747,662,406,25,2,211,0,2,16,85,54,0,1,0,0,25,5,110010056003005,2,207,207,2,psa_24,2D3
1000000US110010025012006,"Block 2006, Block Group 2, Census Tract 25.01, District of Columbia, District of Columbia",169,49,56,2,2,0,30,30,169,92,33,53,0,2,0,0,4,77,16,3,2,0,0,30,26,110010025012006,4,404,404,4,psa_48,4D3
1000000US110010062021110,"Block 1110, Block Group 1, Census Tract 62.02, District of Columbia, District of Columbia",0,0,0,0,0,0,0,0,0,0,0,0,0,0,0,0,0,0,0,0,0,0,0,0,0,110010062021110,1,102,102,1,psa_18,1D1
1000000US110010034002007,"Block 2007, Block Group 2, Census Tract 34, District of Columbia, District of Columbia",0,0,0,0,0,0,0,0,0,0,0,0,0,0,0,0,0,0,0,0,0,0,0,0,0,110010034002007,3,306,306,3,psa_38,3D2
1000000US110010078033000,"Block 3000, Block Group 3, Census Tract 78.03, District of Columbia, District of Columbia",161,2,159,0,0,0,0,0,161,159,0,159,0,0,0,0,0,2,2,0,0,0,0,0,0,110010078033000,6,602,602,6,psa_25,6D1
1000000US110010078034001,"Block 4001, Block Group 4, Census Tract 78.03, District of Columbia, District of Columbia",163,1,154,0,1,0,6,1,163,151,1,149,0,1,0,0,0,12,0,5,0,0,0,6,1,110010078034001,6,602,602,6,psa_25,6D1
1000000US110010020021021,"Block 1021, Block Group 1, Census Tract 20.02, District of Columbia, District of Columbia",72,32,37,1,1,0,0,1,72,71,32,36,1,1,0,0,1,1,0,1,0,0,0,0,0,110010020021021,4,404,404,4,psa_48,4D3
1000000US110010072002028,"Block 2028, Block Group 2, Census Tract 72, District of Columbia, District of Columbia",0,0,0,0,0,0,0,0,0,0,0,0,0,0,0,0,0,0,0,0,0,0,0,0,0,110010072002028,1,106,106,1,psa_13,1D3
1000000US110010095092002,"Block 2002, Block Group 2, Census Tract 95.09, District of Columbia, District of Columbia",42,0,42,0,0,0,0,0,42,42,0,42,0,0,0,0,0,0,0,0,0,0,0,0,0,110010095092002,4,405,405,4,psa_49,4D2
1000000US110010006004018,"Block 4018, Block Group 4, Census Tract 6, District of Columbia, District of Columbia",0,0,0,0,0,0,0,0,0,0,0,0,0,0,0,0,0,0,0,0,0,0,0,0,0,110010006004018,2,203,203,2,psa_50,2D1
1000000US110010078061009,"Block 1009, Block Group 1, Census Tract 78.06, District of Columbia, District of Columbia",61,0,61,0,0,0,0,0,61,61,0,61,0,0,0,0,0,0,0,0,0,0,0,0,0,110010078061009,6,602,602,6,psa_25,6D1
1000000US110010010013015,"Block 3015, Block Group 3, Census Tract 10.01, District of Columbia, District of Columbia",39,35,1,0,2,0,0,1,39,38,34,1,0,2,0,0,1,1,1,0,0,0,0,0,0,110010010013015,2,202,202,2,psa_52,2D1
1000000US110010073011052,"Block 1052, Block Group 1, Census Tract 73.01, District of Columbia, District of Columbia",0,0,0,0,0,0,0,0,0,0,0,0,0,0,0,0,0,0,0,0,0,0,0,0,0,110010073011052,7,708,708,7,psa_1,7D3
1000000US110010090001003,"Block 1003, Block Group 1, Census Tract 90, District of Columbia, District of Columbia",0,0,0,0,0,0,0,0,0,0,0,0,0,0,0,0,0,0,0,0,0,0,0,0,0,110010090001003,5,503,503,5,psa_45,5D2
1000000US110010072001009,"Block 1009, Block Group 1, Census Tract 72, District of Columbia, District of Columbia",0,0,0,0,0,0,0,0,0,0,0,0,0,0,0,0,0,0,0,0,0,0,0,0,0,110010072001009,1,106,106,1,psa_13,1D3
1000000US110010046002015,"Block 2015, Block Group 2, Census Tract 46, District of Columbia, District of Columbia",219,37,167,0,3,0,2,10,219,203,34,161,0,2,0,1,5,16,3,6,0,1,0,1,5,110010046002015,3,308,308,3,psa_27,3D2
1000000US110010008013006,"Block 3006, Block Group 3, Census Tract 8.01, District of Columbia, District of Columbia",0,0,0,0,0,0,0,0,0,0,0,0,0,0,0,0,0,0,0,0,0,0,0,0,0,110010008013006,2,205,205,2,psa_46,2D2
1000000US110010034002021,"Block 2021, Block Group 2, Census Tract 34, District of Columbia, District of Columbia",0,0,0,0,0,0,0,0,0,0,0,0,0,0,0,0,0,0,0,0,0,0,0,0,0,110010034002021,3,306,306,3,psa_38,3D2
1000000US110010098011004,"Block 1004, Block Group 1, Census Tract 98.01, District of Columbia, District of Columbia",537,10,512,0,3,0,2,10,537,534,7,512,0,3,0,2,10,3,3,0,0,0,0,0,0,110010098011004,7,706,706,7,psa_2,7D3
1000000US110010009022024,"Block 2024, Block Group 2, Census Tract 9.02, District of Columbia, District of Columbia",124,98,5,0,9,1,4,7,124,117,95,4,0,9,1,3,5,7,3,1,0,0,0,1,2,110010009022024,2,205,205,2,psa_46,2D2
1000000US110010078092006,"Block 2006, Block Group 2, Census Tract 78.09, District of Columbia, District of Columbia",70,1,65,0,0,0,0,4,70,69,1,65,0,0,0,0,3,1,0,0,0,0,0,0,1,110010078092006,6,602,602,6,psa_25,6D1
1000000US110010092011017,"Block 1017, Block Group 1, Census Tract 92.01, District of Columbia, District of Columbia",0,0,0,0,0,0,0,0,0,0,0,0,0,0,0,0,0,0,0,0,0,0,0,0,0,110010092011017,5,504,504,5,psa_43,5D2
1000000US110010009013017,"Block 3017, Block Group 3, Census Tract 9.01, District of Columbia, District of Columbia",56,53,0,0,3,0,0,0,56,52,49,0,0,3,0,0,0,4,4,0,0,0,0,0,0,110010009013017,2,205,205,2,psa_46,2D2
1000000US110010023021004,"Block 1004, Block Group 1, Census Tract 23.02, District of Columbia, District of Columbia",10,10,0,0,0,0,0,0,10,10,10,0,0,0,0,0,0,0,0,0,0,0,0,0,0,110010023021004,4,405,405,4,psa_49,4D2
1000000US110010010015012,"Block 5012, Block Group 5, Census Tract 10.01, District of Columbia, District of Columbia",60,46,4,0,7,0,1,2,60,60,46,4,0,7,0,1,2,0,0,0,0,0,0,0,0,110010010015012,2,202,202,2,psa_52,2D1
1000000US110010014021015,"Block 1015, Block Group 1, Census Tract 14.02, District of Columbia, District of Columbia",36,20,9,0,2,0,0,5,36,32,16,9,0,2,0,0,5,4,4,0,0,0,0,0,0,110010014021015,2,201,201,2,psa_55,2D1
1000000US110010072002007,"Block 2007, Block Group 2, Census Tract 72, District of Columbia, District of Columbia",0,0,0,0,0,0,0,0,0,0,0,0,0,0,0,0,0,0,0,0,0,0,0,0,0,110010072002007,1,106,106,1,psa_13,1D3
1000000US110010014012007,"Block 2007, Block Group 2, Census Tract 14.01, District of Columbia, District of Columbia",85,66,5,1,6,0,1,6,85,79,64,5,0,6,0,1,3,6,2,0,1,0,0,0,3,110010014012007,2,201,201,2,psa_55,2D1
1000000US110010044001018,"Block 1018, Block Group 1, Census Tract 44, District of Columbia, District of Columbia",39,34,2,0,0,0,0,3,39,39,34,2,0,0,0,0,3,0,0,0,0,0,0,0,0,110010044001018,3,305,305,3,psa_32,3D2
1000000US110010010015001,"Block 5001, Block Group 5, Census Tract 10.01, District of Columbia, District of Columbia",17,15,1,0,0,0,0,1,17,16,14,1,0,0,0,0,1,1,1,0,0,0,0,0,0,110010010015001,2,202,202,2,psa_52,2D1
1000000US110010078033004,"Block 3004, Block Group 3, Census Tract 78.03, District of Columbia, District of Columbia",30,0,30,0,0,0,0,0,30,30,0,30,0,0,0,0,0,0,0,0,0,0,0,0,0,110010078033004,6,602,602,6,psa_25,6D1
1000000US110010106002058,"Block 2058, Block Group 2, Census Tract 106, District of Columbia, District of Columbia",0,0,0,0,0,0,0,0,0,0,0,0,0,0,0,0,0,0,0,0,0,0,0,0,0,110010106002058,1,102,102,1,psa_18,1D1
1000000US110010019022002,"Block 2002, Block Group 2, Census Tract 19.02, District of Columbia, District of Columbia",11,0,11,0,0,0,0,0,11,7,0,7,0,0,0,0,0,4,0,4,0,0,0,0,0,110010019022002,4,406,406,4,psa_54,4D2
1000000US110010095052016,"Block 2016, Block Group 2, Census Tract 95.05, District of Columbia, District of Columbia",21,2,19,0,0,0,0,0,21,21,2,19,0,0,0,0,0,0,0,0,0,0,0,0,0,110010095052016,4,406,406,4,psa_54,4D2
1000000US110010111003010,"Block 3010, Block Group 3, Census Tract 111, District of Columbia, District of Columbia",0,0,0,0,0,0,0,0,0,0,0,0,0,0,0,0,0,0,0,0,0,0,0,0,0,110010111003010,5,505,505,5,psa_34,5D2
1000000US110010048011013,"Block 1013, Block Group 1, Census Tract 48.01, District of Columbia, District of Columbia",129,74,41,0,6,0,1,7,129,122,72,38,0,6,0,0,6,7,2,3,0,0,0,1,1,110010048011013,3,308,308,3,psa_27,3D2
1000000US110010058001031,"Block 1031, Block Group 1, Census Tract 58, District of Columbia, District of Columbia",1,0,1,0,0,0,0,0,1,1,0,1,0,0,0,0,0,0,0,0,0,0,0,0,0,110010058001031,2,209,209,2,psa_57,2D3
1000000US110010074011022,"Block 1022, Block Group 1, Census Tract 74.01, District of Columbia, District of Columbia",0,0,0,0,0,0,0,0,0,0,0,0,0,0,0,0,0,0,0,0,0,0,0,0,0,110010074011022,7,703,703,7,psa_8,7D1
1000000US110010088022003,"Block 2003, Block Group 2, Census Tract 88.02, District of Columbia, District of Columbia",68,0,68,0,0,0,0,0,68,66,0,66,0,0,0,0,0,2,0,2,0,0,0,0,0,110010088022003,5,506,506,5,psa_26,5D3
1000000US110010099012023,"Block 2023, Block Group 2, Census Tract 99.01, District of Columbia, District of Columbia",0,0,0,0,0,0,0,0,0,0,0,0,0,0,0,0,0,0,0,0,0,0,0,0,0,110010099012023,6,605,605,6,psa_11,6D2
1000000US110010107002015,"Block 2015, Block Group 2, Census Tract 107, District of Columbia, District of Columbia",0,0,0,0,0,0,0,0,0,0,0,0,0,0,0,0,0,0,0,0,0,0,0,0,0,110010107002015,2,208,208,2,psa_33,2D3
1000000US110010099022005,"Block 2005, Block Group 2, Census Tract 99.02, District of Columbia, District of Columbia",126,0,126,0,0,0,0,0,126,126,0,126,0,0,0,0,0,0,0,0,0,0,0,0,0,110010099022005,6,605,605,6,psa_11,6D2
1000000US110010111002019,"Block 2019, Block Group 2, Census Tract 111, District of Columbia, District of Columbia",60,3,49,0,1,0,5,2,60,54,3,49,0,1,0,0,1,6,0,0,0,0,0,5,1,110010111002019,5,505,505,5,psa_34,5D2
1000000US110010004001018,"Block 1018, Block Group 1, Census Tract 4, District of Columbia, District of Columbia",19,13,0,0,6,0,0,0,19,19,13,0,0,6,0,0,0,0,0,0,0,0,0,0,0,110010004001018,2,204,204,2,psa_44,2D2
1000000US110010031001013,"Block 1013, Block Group 1, Census Tract 31, District of Columbia, District of Columbia",136,21,45,0,0,0,55,15,136,65,18,45,0,0,0,0,2,71,3,0,0,0,0,55,13,110010031001013,4,409,409,4,psa_41,4D3
1000000US110010047021019,"Block 1019, Block Group 1, Census Tract 47.02, District of Columbia, District of Columbia",0,0,0,0,0,0,0,0,0,0,0,0,0,0,0,0,0,0,0,0,0,0,0,0,0,110010047021019,1,102,102,1,psa_18,1D1
1000000US110010034002015,"Block 2015, Block Group 2, Census Tract 34, District of Columbia, District of Columbia",0,0,0,0,0,0,0,0,0,0,0,0,0,0,0,0,0,0,0,0,0,0,0,0,0,110010034002015,3,306,306,3,psa_38,3D2
1000000US110010055001011,"Block 1011, Block Group 1, Census Tract 55, District of Columbia, District of Columbia",0,0,0,0,0,0,0,0,0,0,0,0,0,0,0,0,0,0,0,0,0,0,0,0,0,110010055001011,2,208,208,2,psa_33,2D3
1000000US110010102002007,"Block 2007, Block Group 2, Census Tract 102, District of Columbia, District of Columbia",0,0,0,0,0,0,0,0,0,0,0,0,0,0,0,0,0,0,0,0,0,0,0,0,0,110010102002007,1,103,103,1,psa_12,1D1
1000000US110010016003003,"Block 3003, Block Group 3, Census Tract 16, District of Columbia, District of Columbia",54,14,34,0,4,0,2,0,54,52,14,34,0,4,0,0,0,2,0,0,0,0,0,2,0,110010016003003,4,401,401,4,psa_56,4D1
1000000US110010014012011,"Block 2011, Block Group 2, Census Tract 14.01, District of Columbia, District of Columbia",0,0,0,0,0,0,0,0,0,0,0,0,0,0,0,0,0,0,0,0,0,0,0,0,0,110010014012011,2,201,201,2,psa_55,2D1
1000000US110010052012003,"Block 2003, Block Group 2, Census Tract 52.01, District of Columbia, District of Columbia",108,80,12,0,10,0,0,6,108,105,77,12,0,10,0,0,6,3,3,0,0,0,0,0,0,110010052012003,2,208,208,2,psa_33,2D3
1000000US110010003002003,"Block 2003, Block Group 2, Census Tract 3, District of Columbia, District of Columbia",134,103,12,0,9,0,3,7,134,114,92,10,0,7,0,0,5,20,11,2,0,2,0,3,2,110010003002003,2,204,204,2,psa_44,2D2
1000000US110010009012016,"Block 2016, Block Group 2, Census Tract 9.01, District of Columbia, District of Columbia",37,35,1,0,0,0,0,1,37,31,29,1,0,0,0,0,1,6,6,0,0,0,0,0,0,110010009012016,2,205,205,2,psa_46,2D2
1000000US110010062021153,"Block 1153, Block Group 1, Census Tract 62.02, District of Columbia, District of Columbia",0,0,0,0,0,0,0,0,0,0,0,0,0,0,0,0,0,0,0,0,0,0,0,0,0,110010062021153,1,103,103,1,psa_12,1D1
1000000US110010076014000,"Block 4000, Block Group 4, Census Tract 76.01, District of Columbia, District of Columbia",31,1,28,0,0,0,0,2,31,29,0,28,0,0,0,0,1,2,1,0,0,0,0,0,1,110010076014000,6,607,607,6,psa_10,6D2
1000000US110010020023007,"Block 3007, Block Group 3, Census Tract 20.02, District of Columbia, District of Columbia",93,10,58,0,1,0,24,0,93,69,10,55,0,1,0,3,0,24,0,3,0,0,0,21,0,110010020023007,4,403,403,4,psa_51,4D1
1000000US110010065002011,"Block 2011, Block Group 2, Census Tract 65, District of Columbia, District of Columbia",0,0,0,0,0,0,0,0,0,0,0,0,0,0,0,0,0,0,0,0,0,0,0,0,0,110010065002011,1,106,106,1,psa_13,1D3
1000000US110010008022004,"Block 2004, Block Group 2, Census Tract 8.02, District of Columbia, District of Columbia",25,24,0,0,1,0,0,0,25,24,23,0,0,1,0,0,0,1,1,0,0,0,0,0,0,110010008022004,2,205,205,2,psa_46,2D2
1000000US110010009022001,"Block 2001, Block Group 2, Census Tract 9.02, District of Columbia, District of Columbia",0,0,0,0,0,0,0,0,0,0,0,0,0,0,0,0,0,0,0,0,0,0,0,0,0,110010009022001,2,205,205,2,psa_46,2D2
1000000US110010025011011,"Block 1011, Block Group 1, Census Tract 25.01, District of Columbia, District of Columbia",100,17,72,0,0,0,0,11,100,93,12,71,0,0,0,0,10,7,5,1,0,0,0,0,1,110010025011011,4,404,404,4,psa_48,4D3
1000000US110010081003001,"Block 3001, Block Group 3, Census Tract 81, District of Columbia, District of Columbia",158,127,20,0,9,0,0,2,158,151,121,19,0,9,0,0,2,7,6,1,0,0,0,0,0,110010081003001,1,108,108,1,psa_17,1D2
1000000US110010025011004,"Block 1004, Block Group 1, Census Tract 25.01, District of Columbia, District of Columbia",0,0,0,0,0,0,0,0,0,0,0,0,0,0,0,0,0,0,0,0,0,0,0,0,0,110010025011004,4,404,404,4,psa_48,4D3
1000000US110010033022001,"Block 2001, Block Group 2, Census Tract 33.02, District of Columbia, District of Columbia",261,99,140,0,4,0,0,18,261,258,96,140,0,4,0,0,18,3,3,0,0,0,0,0,0,110010033022001,3,308,308,3,psa_27,3D2
1000000US110010078041017,"Block 1017, Block Group 1, Census Tract 78.04, District of Columbia, District of Columbia",124,0,117,1,0,0,0,6,124,124,0,117,1,0,0,0,6,0,0,0,0,0,0,0,0,110010078041017,6,602,602,6,psa_25,6D1
1000000US110010062021136,"Block 1136, Block Group 1, Census Tract 62.02, District of Columbia, District of Columbia",0,0,0,0,0,0,0,0,0,0,0,0,0,0,0,0,0,0,0,0,0,0,0,0,0,110010062021136,1,103,103,1,psa_12,1D1
1000000US110010076051001,"Block 1001, Block Group 1, Census Tract 76.05, District of Columbia, District of Columbia",76,0,76,0,0,0,0,0,76,76,0,76,0,0,0,0,0,0,0,0,0,0,0,0,0,110010076051001,6,607,607,6,psa_10,6D2
1000000US110010010012002,"Block 2002, Block Group 2, Census Tract 10.01, District of Columbia, District of Columbia",51,46,0,0,4,0,1,0,51,46,42,0,0,4,0,0,0,5,4,0,0,0,0,1,0,110010010012002,2,202,202,2,psa_52,2D1
1000000US110010039003000,"Block 3000, Block Group 3, Census Tract 39, District of Columbia, District of Columbia",308,225,39,1,19,0,11,13,308,276,209,33,1,19,0,2,12,32,16,6,0,0,0,9,1,110010039003000,3,303,303,3,psa_37,3D3
1000000US110010050012003,"Block 2003, Block Group 2, Census Tract 50.01, District of Columbia, District of Columbia",156,103,45,0,3,0,3,2,156,152,102,45,0,3,0,0,2,4,1,0,0,0,0,3,0,110010050012003,3,307,307,3,psa_28,3D3
1000000US110010075041010,"Block 1010, Block Group 1, Census Tract 75.04, District of Columbia, District of Columbia",30,0,30,0,0,0,0,0,30,30,0,30,0,0,0,0,0,0,0,0,0,0,0,0,0,110010075041010,7,701,701,7,psa_9,7D1
1000000US110010048011008,"Block 1008, Block Group 1, Census Tract 48.01, District of Columbia, District of Columbia",37,18,15,0,3,0,1,0,37,34,15,15,0,3,0,1,0,3,3,0,0,0,0,0,0,110010048011008,3,308,308,3,psa_27,3D2
1000000US110010078082017,"Block 2017, Block Group 2, Census Tract 78.08, District of Columbia, District of Columbia",0,0,0,0,0,0,0,0,0,0,0,0,0,0,0,0,0,0,0,0,0,0,0,0,0,110010078082017,6,608,608,6,psa_19,6D1
1000000US110010108002017,"Block 2017, Block Group 2, Census Tract 108.00, District of Columbia, District of Columbia",0,0,0,0,0,0,0,0,0,0,0,0,0,0,0,0,0,0,0,0,0,0,0,0,0,110010108002017,2,207,207,2,psa_24,2D3
1000000US110010008014001,"Block 4001, Block Group 4, Census Tract 8.01, District of Columbia, District of Columbia",6,6,0,0,0,0,0,0,6,6,6,0,0,0,0,0,0,0,0,0,0,0,0,0,0,110010008014001,2,205,205,2,psa_46,2D2
1000000US110010107001022,"Block 1022, Block Group 1, Census Tract 107, District of Columbia, District of Columbia",32,32,0,0,0,0,0,0,32,32,32,0,0,0,0,0,0,0,0,0,0,0,0,0,0,110010107001022,2,207,207,2,psa_24,2D3
1000000US110010094004004,"Block 4004, Block Group 4, Census Tract 94, District of Columbia, District of Columbia",21,2,19,0,0,0,0,0,21,21,2,19,0,0,0,0,0,0,0,0,0,0,0,0,0,110010094004004,5,503,503,5,psa_45,5D2
1000000US110010003003002,"Block 3002, Block Group 3, Census Tract 3, District of Columbia, District of Columbia",42,38,0,0,0,1,3,0,42,38,37,0,0,0,1,0,0,4,1,0,0,0,0,3,0,110010003003002,2,206,206,2,psa_29,2D2
1000000US110010094004019,"Block 4019, Block Group 4, Census Tract 94, District of Columbia, District of Columbia",0,0,0,0,0,0,0,0,0,0,0,0,0,0,0,0,0,0,0,0,0,0,0,0,0,110010094004019,5,503,503,5,psa_45,5D2
1000000US110010096011014,"Block 1014, Block Group 1, Census Tract 96.01, District of Columbia, District of Columbia",16,2,14,0,0,0,0,0,16,16,2,14,0,0,0,0,0,0,0,0,0,0,0,0,0,110010096011014,6,601,601,6,psa_30,6D1
1000000US110010107001003,"Block 1003, Block Group 1, Census Tract 107, District of Columbia, District of Columbia",0,0,0,0,0,0,0,0,0,0,0,0,0,0,0,0,0,0,0,0,0,0,0,0,0,110010107001003,2,207,207,2,psa_24,2D3
1000000US110010025012004,"Block 2004, Block Group 2, Census Tract 25.01, District of Columbia, District of Columbia",86,42,31,0,0,0,9,4,86,73,38,31,0,0,0,0,4,13,4,0,0,0,0,9,0,110010025012004,4,404,404,4,psa_48,4D3
1000000US110010001004025,"Block 4025, Block Group 4, Census Tract 1, District of Columbia, District of Columbia",0,0,0,0,0,0,0,0,0,0,0,0,0,0,0,0,0,0,0,0,0,0,0,0,0,110010001004025,2,206,206,2,psa_29,2D2
1000000US110010062021084,"Block 1084, Block Group 1, Census Tract 62.02, District of Columbia, District of Columbia",0,0,0,0,0,0,0,0,0,0,0,0,0,0,0,0,0,0,0,0,0,0,0,0,0,110010062021084,2,207,207,2,psa_24,2D3
1000000US110010012001013,"Block 1013, Block Group 1, Census Tract 12, District of Columbia, District of Columbia",78,73,3,1,1,0,0,0,78,77,73,3,0,1,0,0,0,1,0,0,1,0,0,0,0,110010012001013,2,202,202,2,psa_52,2D1
1000000US110010093011007,"Block 1007, Block Group 1, Census Tract 93.01, District of Columbia, District of Columbia",42,9,30,0,3,0,0,0,42,38,8,27,0,3,0,0,0,4,1,3,0,0,0,0,0,110010093011007,5,504,504,5,psa_43,5D2
1000000US110010105002004,"Block 2004, Block Group 2, Census Tract 105, District of Columbia, District of Columbia",0,0,0,0,0,0,0,0,0,0,0,0,0,0,0,0,0,0,0,0,0,0,0,0,0,110010105002004,1,103,103,1,psa_12,1D1
1000000US110010064002015,"Block 2015, Block Group 2, Census Tract 64, District of Columbia, District of Columbia",0,0,0,0,0,0,0,0,0,0,0,0,0,0,0,0,0,0,0,0,0,0,0,0,0,110010064002015,1,105,105,1,psa_22,1D3
1000000US110010076041000,"Block 1000, Block Group 1, Census Tract 76.04, District of Columbia, District of Columbia",160,2,153,0,0,0,0,5,160,160,2,153,0,0,0,0,5,0,0,0,0,0,0,0,0,110010076041000,6,607,607,6,psa_10,6D2
1000000US110010078043003,"Block 3003, Block Group 3, Census Tract 78.04, District of Columbia, District of Columbia",94,0,94,0,0,0,0,0,94,94,0,94,0,0,0,0,0,0,0,0,0,0,0,0,0,110010078043003,6,602,602,6,psa_25,6D1
1000000US110010074011025,"Block 1025, Block Group 1, Census Tract 74.01, District of Columbia, District of Columbia",0,0,0,0,0,0,0,0,0,0,0,0,0,0,0,0,0,0,0,0,0,0,0,0,0,110010074011025,7,703,703,7,psa_8,7D1
1000000US110010028022000,"Block 2000, Block Group 2, Census Tract 28.02, District of Columbia, District of Columbia",568,273,135,6,22,0,112,20,568,387,216,134,3,22,0,1,11,181,57,1,3,0,0,111,9,110010028022000,4,408,408,4,psa_39,4D3
1000000US110010093014006,"Block 4006, Block Group 4, Census Tract 93.01, District of Columbia, District of Columbia",80,33,40,0,2,0,1,4,80,79,32,40,0,2,0,1,4,1,1,0,0,0,0,0,0,110010093014006,5,504,504,5,psa_43,5D2
1000000US110010010016021,"Block 6021, Block Group 6, Census Tract 10.01, District of Columbia, District of Columbia",56,53,2,0,1,0,0,0,56,53,50,2,0,1,0,0,0,3,3,0,0,0,0,0,0,110010010016021,2,202,202,2,psa_52,2D1
1000000US110010049011003,"Block 1003, Block Group 1, Census Tract 49.01, District of Columbia, District of Columbia",100,66,22,0,3,0,8,1,100,88,61,22,0,3,0,1,1,12,5,0,0,0,0,7,0,110010049011003,3,307,307,3,psa_28,3D3
1000000US110010082002003,"Block 2003, Block Group 2, Census Tract 82, District of Columbia, District of Columbia",144,114,13,1,8,0,4,4,144,139,112,12,1,8,0,2,4,5,2,1,0,0,0,2,0,110010082002003,1,108,108,1,psa_17,1D2
1000000US110010044002011,"Block 2011, Block Group 2, Census Tract 44, District of Columbia, District of Columbia",99,62,29,0,5,0,0,3,99,95,58,29,0,5,0,0,3,4,4,0,0,0,0,0,0,110010044002011,3,305,305,3,psa_32,3D2
1000000US110010095033009,"Block 3009, Block Group 3, Census Tract 95.03, District of Columbia, District of Columbia",0,0,0,0,0,0,0,0,0,0,0,0,0,0,0,0,0,0,0,0,0,0,0,0,0,110010095033009,4,405,405,4,psa_49,4D2
1000000US110010095092000,"Block 2000, Block Group 2, Census Tract 95.09, District of Columbia, District of Columbia",64,0,64,0,0,0,0,0,64,64,0,64,0,0,0,0,0,0,0,0,0,0,0,0,0,110010095092000,4,405,405,4,psa_49,4D2
1000000US110010094001015,"Block 1015, Block Group 1, Census Tract 94, District of Columbia, District of Columbia",29,2,26,0,1,0,0,0,29,29,2,26,0,1,0,0,0,0,0,0,0,0,0,0,0,110010094001015,5,503,503,5,psa_45,5D2
1000000US110010095041001,"Block 1001, Block Group 1, Census Tract 95.04, District of Columbia, District of Columbia",37,23,14,0,0,0,0,0,37,34,22,12,0,0,0,0,0,3,1,2,0,0,0,0,0,110010095041001,4,405,405,4,psa_49,4D2
1000000US110010024003007,"Block 3007, Block Group 3, Census Tract 24, District of Columbia, District of Columbia",0,0,0,0,0,0,0,0,0,0,0,0,0,0,0,0,0,0,0,0,0,0,0,0,0,110010024003007,4,407,407,4,psa_47,4D2
1000000US110010096021021,"Block 1021, Block Group 1, Census Tract 96.02, District of Columbia, District of Columbia",0,0,0,0,0,0,0,0,0,0,0,0,0,0,0,0,0,0,0,0,0,0,0,0,0,110010096021021,6,602,602,6,psa_25,6D1
1000000US110010103003009,"Block 3009, Block Group 3, Census Tract 103, District of Columbia, District of Columbia",13,0,12,0,0,0,0,1,13,13,0,12,0,0,0,0,1,0,0,0,0,0,0,0,0,110010103003009,4,401,401,4,psa_56,4D1
1000000US110010007013002,"Block 3002, Block Group 3, Census Tract 7.01, District of Columbia, District of Columbia",329,308,17,2,2,0,0,0,329,316,295,17,2,2,0,0,0,13,13,0,0,0,0,0,0,110010007013002,2,204,204,2,psa_44,2D2
1000000US110010036001000,"Block 1000, Block Group 1, Census Tract 36, District of Columbia, District of Columbia",543,262,178,2,21,0,58,22,543,434,228,172,1,21,0,2,10,109,34,6,1,0,0,56,12,110010036001000,3,304,304,3,psa_36,3D1
1000000US110010073011107,"Block 1107, Block Group 1, Census Tract 73.01, District of Columbia, District of Columbia",0,0,0,0,0,0,0,0,0,0,0,0,0,0,0,0,0,0,0,0,0,0,0,0,0,110010073011107,7,708,708,7,psa_1,7D3
1000000US110010006004019,"Block 4019, Block Group 4, Census Tract 6, District of Columbia, District of Columbia",17,17,0,0,0,0,0,0,17,17,17,0,0,0,0,0,0,0,0,0,0,0,0,0,0,110010006004019,2,203,203,2,psa_50,2D1
1000000US110010073011103,"Block 1103, Block Group 1, Census Tract 73.01, District of Columbia, District of Columbia",0,0,0,0,0,0,0,0,0,0,0,0,0,0,0,0,0,0,0,0,0,0,0,0,0,110010073011103,7,708,708,7,psa_1,7D3
1000000US110010013011010,"Block 1010, Block Group 1, Census Tract 13.01, District of Columbia, District of Columbia",0,0,0,0,0,0,0,0,0,0,0,0,0,0,0,0,0,0,0,0,0,0,0,0,0,110010013011010,2,203,203,2,psa_50,2D1
1000000US110010094002024,"Block 2024, Block Group 2, Census Tract 94, District of Columbia, District of Columbia",0,0,0,0,0,0,0,0,0,0,0,0,0,0,0,0,0,0,0,0,0,0,0,0,0,110010094002024,5,504,504,5,psa_43,5D2
1000000US110010044002003,"Block 2003, Block Group 2, Census Tract 44, District of Columbia, District of Columbia",0,0,0,0,0,0,0,0,0,0,0,0,0,0,0,0,0,0,0,0,0,0,0,0,0,110010044002003,3,305,305,3,psa_32,3D2
1000000US110010095032009,"Block 2009, Block Group 2, Census Tract 95.03, District of Columbia, District of Columbia",27,0,26,0,0,0,0,1,27,27,0,26,0,0,0,0,1,0,0,0,0,0,0,0,0,110010095032009,5,503,503,5,psa_45,5D2
1000000US110010077091000,"Block 1000, Block Group 1, Census Tract 77.09, District of Columbia, District of Columbia",33,0,33,0,0,0,0,0,33,33,0,33,0,0,0,0,0,0,0,0,0,0,0,0,0,110010077091000,6,605,605,6,psa_11,6D2
1000000US110010009022007,"Block 2007, Block Group 2, Census Tract 9.02, District of Columbia, District of Columbia",0,0,0,0,0,0,0,0,0,0,0,0,0,0,0,0,0,0,0,0,0,0,0,0,0,110010009022007,2,205,205,2,psa_46,2D2
1000000US110010015002008,"Block 2008, Block Group 2, Census Tract 15, District of Columbia, District of Columbia",34,28,5,0,0,0,0,1,34,31,25,5,0,0,0,0,1,3,3,0,0,0,0,0,0,110010015002008,2,201,201,2,psa_55,2D1
1000000US110010093011004,"Block 1004, Block Group 1, Census Tract 93.01, District of Columbia, District of Columbia",35,8,27,0,0,0,0,0,35,34,7,27,0,0,0,0,0,1,1,0,0,0,0,0,0,110010093011004,5,504,504,5,psa_43,5D2
1000000US110010082001005,"Block 1005, Block Group 1, Census Tract 82, District of Columbia, District of Columbia",92,82,1,1,3,0,0,5,92,89,79,1,1,3,0,0,5,3,3,0,0,0,0,0,0,110010082001005,1,108,108,1,psa_17,1D2
1000000US110010095011006,"Block 1006, Block Group 1, Census Tract 95.01, District of Columbia, District of Columbia",157,14,135,0,0,0,1,7,157,153,11,135,0,0,0,1,6,4,3,0,0,0,0,0,1,110010095011006,4,405,405,4,psa_49,4D2
1000000US110010011004015,"Block 4015, Block Group 4, Census Tract 11, District of Columbia, District of Columbia",49,43,0,0,3,0,0,3,49,47,41,0,0,3,0,0,3,2,2,0,0,0,0,0,0,110010011004015,2,202,202,2,psa_52,2D1
1000000US110010111001029,"Block 1029, Block Group 1, Census Tract 111, District of Columbia, District of Columbia",1,0,0,0,0,0,0,1,1,1,0,0,0,0,0,0,1,0,0,0,0,0,0,0,0,110010111001029,5,503,503,5,psa_45,5D2
1000000US110010027023011,"Block 3011, Block Group 3, Census Tract 27.02, District of Columbia, District of Columbia",0,0,0,0,0,0,0,0,0,0,0,0,0,0,0,0,0,0,0,0,0,0,0,0,0,110010027023011,3,302,302,3,psa_42,3D1
1000000US110010062021074,"Block 1074, Block Group 1, Census Tract 62.02, District of Columbia, District of Columbia",0,0,0,0,0,0,0,0,0,0,0,0,0,0,0,0,0,0,0,0,0,0,0,0,0,110010062021074,2,207,207,2,psa_24,2D3
1000000US110010095053000,"Block 3000, Block Group 3, Census Tract 95.05, District of Columbia, District of Columbia",0,0,0,0,0,0,0,0,0,0,0,0,0,0,0,0,0,0,0,0,0,0,0,0,0,110010095053000,4,406,406,4,psa_54,4D2
1000000US110010002024006,"Block 4006, Block Group 4, Census Tract 2.02, District of Columbia, District of Columbia",45,45,0,0,0,0,0,0,45,45,45,0,0,0,0,0,0,0,0,0,0,0,0,0,0,110010002024006,2,206,206,2,psa_29,2D2
1000000US110010024004009,"Block 4009, Block Group 4, Census Tract 24, District of Columbia, District of Columbia",86,27,43,0,3,0,8,5,86,76,25,43,0,3,0,0,5,10,2,0,0,0,0,8,0,110010024004009,4,407,407,4,psa_47,4D2
1000000US110010059001031,"Block 1031, Block Group 1, Census Tract 59, District of Columbia, District of Columbia",0,0,0,0,0,0,0,0,0,0,0,0,0,0,0,0,0,0,0,0,0,0,0,0,0,110010059001031,1,102,102,1,psa_18,1D1
1000000US110010095051006,"Block 1006, Block Group 1, Census Tract 95.05, District of Columbia, District of Columbia",50,1,39,0,2,0,8,0,50,40,1,37,0,2,0,0,0,10,0,2,0,0,0,8,0,110010095051006,4,406,406,4,psa_54,4D2
1000000US110010029002000,"Block 2000, Block Group 2, Census Tract 29, District of Columbia, District of Columbia",222,91,90,1,9,0,14,17,222,171,66,89,1,9,0,0,6,51,25,1,0,0,0,14,11,110010029002000,4,408,408,4,psa_39,4D3
1000000US110010033011003,"Block 1003, Block Group 1, Census Tract 33.01, District of Columbia, District of Columbia",297,86,180,0,6,0,9,16,297,282,79,176,0,6,0,6,15,15,7,4,0,0,0,3,1,110010033011003,3,306,306,3,psa_38,3D2
1000000US110010053014003,"Block 4003, Block Group 4, Census Tract 53.01, District of Columbia, District of Columbia",330,285,4,1,27,0,4,9,330,307,263,4,1,27,0,3,9,23,22,0,0,0,0,1,0,110010053014003,3,301,301,3,psa_31,3D3
1000000US110010019011006,"Block 1006, Block Group 1, Census Tract 19.01, District of Columbia, District of Columbia",50,1,41,0,1,0,7,0,50,42,1,41,0,0,0,0,0,8,0,0,0,1,0,7,0,110010019011006,4,402,402,4,psa_53,4D1
1000000US110010020022004,"Block 2004, Block Group 2, Census Tract 20.02, District of Columbia, District of Columbia",156,15,103,0,0,0,32,6,156,108,6,102,0,0,0,0,0,48,9,1,0,0,0,32,6,110010020022004,4,403,403,4,psa_51,4D1
1000000US110010076012005,"Block 2005, Block Group 2, Census Tract 76.01, District of Columbia, District of Columbia",74,4,69,0,1,0,0,0,74,74,4,69,0,1,0,0,0,0,0,0,0,0,0,0,0,110010076012005,6,607,607,6,psa_10,6D2
1000000US110010102002020,"Block 2020, Block Group 2, Census Tract 102, District of Columbia, District of Columbia",0,0,0,0,0,0,0,0,0,0,0,0,0,0,0,0,0,0,0,0,0,0,0,0,0,110010102002020,1,103,103,1,psa_12,1D1
1000000US110010069002001,"Block 2001, Block Group 2, Census Tract 69, District of Columbia, District of Columbia",31,27,4,0,0,0,0,0,31,27,23,4,0,0,0,0,0,4,4,0,0,0,0,0,0,110010069002001,1,107,107,1,psa_16,1D2
1000000US110010074011020,"Block 1020, Block Group 1, Census Tract 74.01, District of Columbia, District of Columbia",0,0,0,0,0,0,0,0,0,0,0,0,0,0,0,0,0,0,0,0,0,0,0,0,0,110010074011020,7,703,703,7,psa_8,7D1
1000000US110010095052007,"Block 2007, Block Group 2, Census Tract 95.05, District of Columbia, District of Columbia",99,12,72,0,3,0,0,12,99,89,9,71,0,3,0,0,6,10,3,1,0,0,0,0,6,110010095052007,4,406,406,4,psa_54,4D2
1000000US110010010013011,"Block 3011, Block Group 3, Census Tract 10.01, District of Columbia, District of Columbia",51,46,2,0,0,0,3,0,51,51,46,2,0,0,0,3,0,0,0,0,0,0,0,0,0,110010010013011,2,202,202,2,psa_52,2D1
1000000US110010072002049,"Block 2049, Block Group 2, Census Tract 72, District of Columbia, District of Columbia",0,0,0,0,0,0,0,0,0,0,0,0,0,0,0,0,0,0,0,0,0,0,0,0,0,110010072002049,1,106,106,1,psa_13,1D3
1000000US110010073042003,"Block 2003, Block Group 2, Census Tract 73.04, District of Columbia, District of Columbia",100,0,93,6,0,0,1,0,100,98,0,92,6,0,0,0,0,2,0,1,0,0,0,1,0,110010073042003,7,705,705,7,psa_3,7D2
1000000US110010025012014,"Block 2014, Block Group 2, Census Tract 25.01, District of Columbia, District of Columbia",0,0,0,0,0,0,0,0,0,0,0,0,0,0,0,0,0,0,0,0,0,0,0,0,0,110010025012014,4,404,404,4,psa_48,4D3
1000000US110010099072003,"Block 2003, Block Group 2, Census Tract 99.07, District of Columbia, District of Columbia",288,1,285,0,0,0,0,2,288,288,1,285,0,0,0,0,2,0,0,0,0,0,0,0,0,110010099072003,6,604,604,6,psa_14,6D3
1000000US110010015001022,"Block 1022, Block Group 1, Census Tract 15, District of Columbia, District of Columbia",0,0,0,0,0,0,0,0,0,0,0,0,0,0,0,0,0,0,0,0,0,0,0,0,0,110010015001022,2,201,201,2,psa_55,2D1
1000000US110010078091000,"Block 1000, Block Group 1, Census Tract 78.09, District of Columbia, District of Columbia",109,0,108,0,0,0,0,1,109,109,0,108,0,0,0,0,1,0,0,0,0,0,0,0,0,110010078091000,6,608,608,6,psa_19,6D1
1000000US110010096022002,"Block 2002, Block Group 2, Census Tract 96.02, District of Columbia, District of Columbia",0,0,0,0,0,0,0,0,0,0,0,0,0,0,0,0,0,0,0,0,0,0,0,0,0,110010096022002,6,601,601,6,psa_30,6D1
1000000US110010002024013,"Block 4013, Block Group 4, Census Tract 2.02, District of Columbia, District of Columbia",0,0,0,0,0,0,0,0,0,0,0,0,0,0,0,0,0,0,0,0,0,0,0,0,0,110010002024013,2,206,206,2,psa_29,2D2
1000000US110010008021012,"Block 1012, Block Group 1, Census Tract 8.02, District of Columbia, District of Columbia",265,213,20,1,20,0,5,6,265,241,195,19,1,20,0,1,5,24,18,1,0,0,0,4,1,110010008021012,2,205,205,2,psa_46,2D2
1000000US110010030002004,"Block 2004, Block Group 2, Census Tract 30, District of Columbia, District of Columbia",242,93,49,2,5,0,73,20,242,139,77,48,0,5,0,0,9,103,16,1,2,0,0,73,11,110010030002004,3,302,302,3,psa_42,3D1
1000000US110010009011010,"Block 1010, Block Group 1, Census Tract 9.01, District of Columbia, District of Columbia",134,127,0,0,5,0,0,2,134,122,115,0,0,5,0,0,2,12,12,0,0,0,0,0,0,110010009011010,2,205,205,2,psa_46,2D2
1000000US110010009013020,"Block 3020, Block Group 3, Census Tract 9.01, District of Columbia, District of Columbia",0,0,0,0,0,0,0,0,0,0,0,0,0,0,0,0,0,0,0,0,0,0,0,0,0,110010009013020,2,205,205,2,psa_46,2D2
1000000US110010025021004,"Block 1004, Block Group 1, Census Tract 25.02, District of Columbia, District of Columbia",286,55,162,0,6,0,49,14,286,208,40,158,0,6,0,0,4,78,15,4,0,0,0,49,10,110010025021004,4,404,404,4,psa_48,4D3
1000000US110010062021252,"Block 1252, Block Group 1, Census Tract 62.02, District of Columbia, District of Columbia",0,0,0,0,0,0,0,0,0,0,0,0,0,0,0,0,0,0,0,0,0,0,0,0,0,110010062021252,2,207,207,2,psa_24,2D3
1000000US110010039004002,"Block 4002, Block Group 4, Census Tract 39, District of Columbia, District of Columbia",64,58,0,0,2,0,4,0,64,56,54,0,0,2,0,0,0,8,4,0,0,0,0,4,0,110010039004002,3,303,303,3,psa_37,3D3
1000000US110010074072000,"Block 2000, Block Group 2, Census Tract 74.07, District of Columbia, District of Columbia",88,0,88,0,0,0,0,0,88,81,0,81,0,0,0,0,0,7,0,7,0,0,0,0,0,110010074072000,7,703,703,7,psa_8,7D1
1000000US110010092041006,"Block 1006, Block Group 1, Census Tract 92.04, District of Columbia, District of Columbia",199,35,148,0,1,0,8,7,199,184,28,148,0,1,0,1,6,15,7,0,0,0,0,7,1,110010092041006,5,502,502,5,psa_40,5D1
1000000US110010048011018,"Block 1018, Block Group 1, Census Tract 48.01, District of Columbia, District of Columbia",218,29,165,1,12,0,3,8,218,212,27,165,0,12,0,0,8,6,2,0,1,0,0,3,0,110010048011018,3,308,308,3,psa_27,3D2
1000000US110010038003001,"Block 3001, Block Group 3, Census Tract 38, District of Columbia, District of Columbia",0,0,0,0,0,0,0,0,0,0,0,0,0,0,0,0,0,0,0,0,0,0,0,0,0,110010038003001,3,303,303,3,psa_37,3D3
1000000US110010098041006,"Block 1006, Block Group 1, Census Tract 98.04, District of Columbia, District of Columbia",0,0,0,0,0,0,0,0,0,0,0,0,0,0,0,0,0,0,0,0,0,0,0,0,0,110010098041006,7,705,705,7,psa_3,7D2
1000000US110010066001017,"Block 1017, Block Group 1, Census Tract 66, District of Columbia, District of Columbia",0,0,0,0,0,0,0,0,0,0,0,0,0,0,0,0,0,0,0,0,0,0,0,0,0,110010066001017,1,107,107,1,psa_16,1D2
1000000US110010093011013,"Block 1013, Block Group 1, Census Tract 93.01, District of Columbia, District of Columbia",39,2,34,0,0,0,0,3,39,36,2,33,0,0,0,0,1,3,0,1,0,0,0,0,2,110010093011013,5,504,504,5,psa_43,5D2
1000000US110010009013025,"Block 3025, Block Group 3, Census Tract 9.01, District of Columbia, District of Columbia",0,0,0,0,0,0,0,0,0,0,0,0,0,0,0,0,0,0,0,0,0,0,0,0,0,110010009013025,2,205,205,2,psa_46,2D2
1000000US110010106002016,"Block 2016, Block Group 2, Census Tract 106, District of Columbia, District of Columbia",58,20,35,0,3,0,0,0,58,57,20,34,0,3,0,0,0,1,0,1,0,0,0,0,0,110010106002016,5,501,501,5,psa_35,5D1
1000000US110010021026001,"Block 6001, Block Group 6, Census Tract 21.02, District of Columbia, District of Columbia",0,0,0,0,0,0,0,0,0,0,0,0,0,0,0,0,0,0,0,0,0,0,0,0,0,110010021026001,4,402,402,4,psa_53,4D1
1000000US110010041003027,"Block 3027, Block Group 3, Census Tract 41, District of Columbia, District of Columbia",0,0,0,0,0,0,0,0,0,0,0,0,0,0,0,0,0,0,0,0,0,0,0,0,0,110010041003027,2,206,206,2,psa_29,2D2
1000000US110010048022006,"Block 2006, Block Group 2, Census Tract 48.02, District of Columbia, District of Columbia",0,0,0,0,0,0,0,0,0,0,0,0,0,0,0,0,0,0,0,0,0,0,0,0,0,110010048022006,3,308,308,3,psa_27,3D2
1000000US110010076013007,"Block 3007, Block Group 3, Census Tract 76.01, District of Columbia, District of Columbia",0,0,0,0,0,0,0,0,0,0,0,0,0,0,0,0,0,0,0,0,0,0,0,0,0,110010076013007,6,607,607,6,psa_10,6D2
1000000US110010034002013,"Block 2013, Block Group 2, Census Tract 34, District of Columbia, District of Columbia",0,0,0,0,0,0,0,0,0,0,0,0,0,0,0,0,0,0,0,0,0,0,0,0,0,110010034002013,3,306,306,3,psa_38,3D2
1000000US110010052011000,"Block 1000, Block Group 1, Census Tract 52.01, District of Columbia, District of Columbia",1113,611,214,10,84,16,134,44,1113,856,529,206,3,84,0,2,32,257,82,8,7,0,16,132,12,110010052011000,2,208,208,2,psa_33,2D3
1000000US110010077091028,"Block 1028, Block Group 1, Census Tract 77.09, District of Columbia, District of Columbia",0,0,0,0,0,0,0,0,0,0,0,0,0,0,0,0,0,0,0,0,0,0,0,0,0,110010077091028,6,605,605,6,psa_11,6D2
1000000US110010089041000,"Block 1000, Block Group 1, Census Tract 89.04, District of Columbia, District of Columbia",326,1,320,0,0,0,0,5,326,323,1,319,0,0,0,0,3,3,0,1,0,0,0,0,2,110010089041000,5,507,507,5,psa_23,5D3
1000000US110010104001002,"Block 1002, Block Group 1, Census Tract 104, District of Columbia, District of Columbia",59,11,46,0,2,0,0,0,59,59,11,46,0,2,0,0,0,0,0,0,0,0,0,0,0,110010104001002,7,705,705,7,psa_3,7D2
1000000US110010047012009,"Block 2009, Block Group 2, Census Tract 47.01, District of Columbia, District of Columbia",11,3,7,0,0,0,0,1,11,9,2,6,0,0,0,0,1,2,1,1,0,0,0,0,0,110010047012009,1,101,101,1,psa_20,1D1
1000000US110010066001016,"Block 1016, Block Group 1, Census Tract 66, District of Columbia, District of Columbia",121,108,0,0,6,0,2,5,121,114,103,0,0,6,0,0,5,7,5,0,0,0,0,2,0,110010066001016,1,107,107,1,psa_16,1D2
1000000US110010075032000,"Block 2000, Block Group 2, Census Tract 75.03, District of Columbia, District of Columbia",488,0,477,1,1,0,0,9,488,486,0,477,1,1,0,0,7,2,0,0,0,0,0,0,2,110010075032000,7,701,701,7,psa_9,7D1
1000000US110010095013006,"Block 3006, Block Group 3, Census Tract 95.01, District of Columbia, District of Columbia",82,4,67,3,4,0,4,0,82,79,3,67,3,4,0,2,0,3,1,0,0,0,0,2,0,110010095013006,4,405,405,4,psa_49,4D2
1000000US110010017022012,"Block 2012, Block Group 2, Census Tract 17.02, District of Columbia, District of Columbia",154,35,115,0,0,0,0,4,154,147,28,115,0,0,0,0,4,7,7,0,0,0,0,0,0,110010017022012,4,406,406,4,psa_54,4D2
1000000US110010062021060,"Block 1060, Block Group 1, Census Tract 62.02, District of Columbia, District of Columbia",0,0,0,0,0,0,0,0,0,0,0,0,0,0,0,0,0,0,0,0,0,0,0,0,0,110010062021060,2,207,207,2,psa_24,2D3
1000000US110010079031006,"Block 1006, Block Group 1, Census Tract 79.03, District of Columbia, District of Columbia",32,1,30,0,1,0,0,0,32,32,1,30,0,1,0,0,0,0,0,0,0,0,0,0,0,110010079031006,5,507,507,5,psa_23,5D3
1000000US110010088041001,"Block 1001, Block Group 1, Census Tract 88.04, District of Columbia, District of Columbia",111,1,92,0,0,0,16,2,111,94,1,91,0,0,0,0,2,17,0,1,0,0,0,16,0,110010088041001,5,506,506,5,psa_26,5D3
1000000US110010055003010,"Block 3010, Block Group 3, Census Tract 55, District of Columbia, District of Columbia",0,0,0,0,0,0,0,0,0,0,0,0,0,0,0,0,0,0,0,0,0,0,0,0,0,110010055003010,2,207,207,2,psa_24,2D3
1000000US110010012004010,"Block 4010, Block Group 4, Census Tract 12, District of Columbia, District of Columbia",2,1,0,1,0,0,0,0,2,2,1,0,1,0,0,0,0,0,0,0,0,0,0,0,0,110010012004010,2,203,203,2,psa_50,2D1
1000000US110010076013001,"Block 3001, Block Group 3, Census Tract 76.01, District of Columbia, District of Columbia",63,7,56,0,0,0,0,0,63,57,1,56,0,0,0,0,0,6,6,0,0,0,0,0,0,110010076013001,6,607,607,6,psa_10,6D2
1000000US110010076015018,"Block 5018, Block Group 5, Census Tract 76.01, District of Columbia, District of Columbia",165,0,164,0,1,0,0,0,165,160,0,159,0,1,0,0,0,5,0,5,0,0,0,0,0,110010076015018,6,607,607,6,psa_10,6D2
1000000US110010093014007,"Block 4007, Block Group 4, Census Tract 93.01, District of Columbia, District of Columbia",75,37,37,0,0,0,0,1,75,72,35,37,0,0,0,0,0,3,2,0,0,0,0,0,1,110010093014007,5,504,504,5,psa_43,5D2
1000000US110010017022004,"Block 2004, Block Group 2, Census Tract 17.02, District of Columbia, District of Columbia",30,14,13,0,0,0,0,3,30,30,14,13,0,0,0,0,3,0,0,0,0,0,0,0,0,110010017022004,4,401,401,4,psa_56,4D1
1000000US110010062021017,"Block 1017, Block Group 1, Census Tract 62.02, District of Columbia, District of Columbia",0,0,0,0,0,0,0,0,0,0,0,0,0,0,0,0,0,0,0,0,0,0,0,0,0,110010062021017,1,102,102,1,psa_18,1D1
1000000US110010062021054,"Block 1054, Block Group 1, Census Tract 62.02, District of Columbia, District of Columbia",0,0,0,0,0,0,0,0,0,0,0,0,0,0,0,0,0,0,0,0,0,0,0,0,0,110010062021054,2,207,207,2,psa_24,2D3
1000000US110010071001028,"Block 1028, Block Group 1, Census Tract 71, District of Columbia, District of Columbia",0,0,0,0,0,0,0,0,0,0,0,0,0,0,0,0,0,0,0,0,0,0,0,0,0,110010071001028,1,106,106,1,psa_13,1D3
1000000US110010099011005,"Block 1005, Block Group 1, Census Tract 99.01, District of Columbia, District of Columbia",129,4,122,0,0,0,2,1,129,125,2,122,0,0,0,0,1,4,2,0,0,0,0,2,0,110010099011005,6,605,605,6,psa_11,6D2
1000000US110010010014027,"Block 4027, Block Group 4, Census Tract 10.01, District of Columbia, District of Columbia",0,0,0,0,0,0,0,0,0,0,0,0,0,0,0,0,0,0,0,0,0,0,0,0,0,110010010014027,2,202,202,2,psa_52,2D1
1000000US110010020023001,"Block 3001, Block Group 3, Census Tract 20.02, District of Columbia, District of Columbia",138,27,98,0,0,0,11,2,138,120,22,98,0,0,0,0,0,18,5,0,0,0,0,11,2,110010020023001,4,403,403,4,psa_51,4D1
1000000US110010073011132,"Block 1132, Block Group 1, Census Tract 73.01, District of Columbia, District of Columbia",201,131,48,3,3,2,8,6,201,181,122,46,3,2,2,0,6,20,9,2,0,1,0,8,0,110010073011132,7,703,703,7,psa_8,7D1
1000000US110010095093005,"Block 3005, Block Group 3, Census Tract 95.09, District of Columbia, District of Columbia",24,2,22,0,0,0,0,0,24,24,2,22,0,0,0,0,0,0,0,0,0,0,0,0,0,110010095093005,4,405,405,4,psa_49,4D2
1000000US110010062021011,"Block 1011, Block Group 1, Census Tract 62.02, District of Columbia, District of Columbia",0,0,0,0,0,0,0,0,0,0,0,0,0,0,0,0,0,0,0,0,0,0,0,0,0,110010062021011,1,102,102,1,psa_18,1D1
1000000US110010017021024,"Block 1024, Block Group 1, Census Tract 17.02, District of Columbia, District of Columbia",57,5,43,0,2,0,0,7,57,57,5,43,0,2,0,0,7,0,0,0,0,0,0,0,0,110010017021024,4,401,401,4,psa_56,4D1
1000000US110010111001008,"Block 1008, Block Group 1, Census Tract 111, District of Columbia, District of Columbia",17,0,17,0,0,0,0,0,17,17,0,17,0,0,0,0,0,0,0,0,0,0,0,0,0,110010111001008,5,503,503,5,psa_45,5D2
1000000US110010041001002,"Block 1002, Block Group 1, Census Tract 41, District of Columbia, District of Columbia",128,84,28,0,4,0,9,3,128,116,82,27,0,4,0,0,3,12,2,1,0,0,0,9,0,110010041001002,2,208,208,2,psa_33,2D3
1000000US110010076043006,"Block 3006, Block Group 3, Census Tract 76.04, District of Columbia, District of Columbia",78,1,75,0,1,0,0,1,78,77,1,74,0,1,0,0,1,1,0,1,0,0,0,0,0,110010076043006,6,607,607,6,psa_10,6D2
1000000US110010011001011,"Block 1011, Block Group 1, Census Tract 11, District of Columbia, District of Columbia",109,95,3,0,6,0,0,5,109,91,77,3,0,6,0,0,5,18,18,0,0,0,0,0,0,110010011001011,2,201,201,2,psa_55,2D1
1000000US110010035001000,"Block 1000, Block Group 1, Census Tract 35, District of Columbia, District of Columbia",245,84,120,0,3,0,26,12,245,199,73,115,0,3,0,1,7,46,11,5,0,0,0,25,5,110010035001000,3,304,304,3,psa_36,3D1
1000000US110010025012002,"Block 2002, Block Group 2, Census Tract 25.01, District of Columbia, District of Columbia",26,12,6,1,0,0,7,0,26,17,9,6,1,0,0,1,0,9,3,0,0,0,0,6,0,110010025012002,4,404,404,4,psa_48,4D3
1000000US110010033021000,"Block 1000, Block Group 1, Census Tract 33.02, District of Columbia, District of Columbia",179,70,89,0,8,0,12,0,179,158,63,87,0,8,0,0,0,21,7,2,0,0,0,12,0,110010033021000,3,308,308,3,psa_27,3D2
1000000US110010099071000,"Block 1000, Block Group 1, Census Tract 99.07, District of Columbia, District of Columbia",374,0,364,0,0,0,0,10,374,372,0,362,0,0,0,0,10,2,0,2,0,0,0,0,0,110010099071000,6,604,604,6,psa_14,6D3
1000000US110010022013002,"Block 3002, Block Group 3, Census Tract 22.01, District of Columbia, District of Columbia",168,17,77,0,10,0,58,6,168,100,9,77,0,10,0,0,4,68,8,0,0,0,0,58,2,110010022013002,4,407,407,4,psa_47,4D2
1000000US110010058001022,"Block 1022, Block Group 1, Census Tract 58, District of Columbia, District of Columbia",0,0,0,0,0,0,0,0,0,0,0,0,0,0,0,0,0,0,0,0,0,0,0,0,0,110010058001022,2,207,207,2,psa_24,2D3
1000000US110010078061003,"Block 1003, Block Group 1, Census Tract 78.06, District of Columbia, District of Columbia",42,0,42,0,0,0,0,0,42,42,0,42,0,0,0,0,0,0,0,0,0,0,0,0,0,110010078061003,6,602,602,6,psa_25,6D1
1000000US110010094002015,"Block 2015, Block Group 2, Census Tract 94, District of Columbia, District of Columbia",0,0,0,0,0,0,0,0,0,0,0,0,0,0,0,0,0,0,0,0,0,0,0,0,0,110010094002015,5,503,503,5,psa_45,5D2
1000000US110010053012000,"Block 2000, Block Group 2, Census Tract 53.01, District of Columbia, District of Columbia",201,167,8,1,18,0,0,7,201,190,160,8,0,18,0,0,4,11,7,0,1,0,0,0,3,110010053012000,2,208,208,2,psa_33,2D3
1000000US110010062021003,"Block 1003, Block Group 1, Census Tract 62.02, District of Columbia, District of Columbia",0,0,0,0,0,0,0,0,0,0,0,0,0,0,0,0,0,0,0,0,0,0,0,0,0,110010062021003,1,102,102,1,psa_18,1D1
1000000US110010080013005,"Block 3005, Block Group 3, Census Tract 80.01, District of Columbia, District of Columbia",83,40,29,0,3,0,8,3,83,69,36,28,0,2,0,0,3,14,4,1,0,1,0,8,0,110010080013005,1,108,108,1,psa_17,1D2
1000000US110010089041006,"Block 1006, Block Group 1, Census Tract 89.04, District of Columbia, District of Columbia",94,0,85,1,3,0,4,1,94,90,0,85,1,3,0,0,1,4,0,0,0,0,0,4,0,110010089041006,5,507,507,5,psa_23,5D3
1000000US110010102002043,"Block 2043, Block Group 2, Census Tract 102, District of Columbia, District of Columbia",230,69,122,1,10,0,11,17,230,205,59,115,1,10,0,5,15,25,10,7,0,0,0,6,2,110010102002043,1,105,105,1,psa_22,1D3
1000000US110010013011014,"Block 1014, Block Group 1, Census Tract 13.01, District of Columbia, District of Columbia",74,70,0,0,4,0,0,0,74,74,70,0,0,4,0,0,0,0,0,0,0,0,0,0,0,110010013011014,2,203,203,2,psa_50,2D1
1000000US110010016004034,"Block 4034, Block Group 4, Census Tract 16, District of Columbia, District of Columbia",56,26,25,0,0,0,0,5,56,54,26,25,0,0,0,0,3,2,0,0,0,0,0,0,2,110010016004034,4,401,401,4,psa_56,4D1
1000000US110010075032006,"Block 2006, Block Group 2, Census Tract 75.03, District of Columbia, District of Columbia",46,0,45,0,0,0,1,0,46,46,0,45,0,0,0,1,0,0,0,0,0,0,0,0,0,110010075032006,7,701,701,7,psa_9,7D1
1000000US110010076032001,"Block 2001, Block Group 2, Census Tract 76.03, District of Columbia, District of Columbia",46,3,43,0,0,0,0,0,46,46,3,43,0,0,0,0,0,0,0,0,0,0,0,0,0,110010076032001,6,606,606,6,psa_7,6D2
1000000US110010012004016,"Block 4016, Block Group 4, Census Tract 12, District of Columbia, District of Columbia",73,64,0,0,0,0,5,4,73,60,58,0,0,0,0,0,2,13,6,0,0,0,0,5,2,110010012004016,2,202,202,2,psa_52,2D1
1000000US110010110002015,"Block 2015, Block Group 2, Census Tract 110, District of Columbia, District of Columbia",0,0,0,0,0,0,0,0,0,0,0,0,0,0,0,0,0,0,0,0,0,0,0,0,0,110010110002015,1,105,105,1,psa_22,1D3
1000000US110010111002021,"Block 2021, Block Group 2, Census Tract 111, District of Columbia, District of Columbia",29,7,18,0,0,0,3,1,29,25,7,15,0,0,0,2,1,4,0,3,0,0,0,1,0,110010111002021,5,503,503,5,psa_45,5D2
1000000US110010011004001,"Block 4001, Block Group 4, Census Tract 11, District of Columbia, District of Columbia",28,25,0,0,1,0,0,2,28,25,23,0,0,1,0,0,1,3,2,0,0,0,0,0,1,110010011004001,2,202,202,2,psa_52,2D1
1000000US110010005011005,"Block 1005, Block Group 1, Census Tract 5.01, District of Columbia, District of Columbia",319,282,6,0,24,0,1,6,319,292,256,6,0,24,0,0,6,27,26,0,0,0,0,1,0,110010005011005,2,204,204,2,psa_44,2D2
1000000US110010017021015,"Block 1015, Block Group 1, Census Tract 17.02, District of Columbia, District of Columbia",53,22,27,0,2,0,0,2,53,52,21,27,0,2,0,0,2,1,1,0,0,0,0,0,0,110010017021015,4,401,401,4,psa_56,4D1
1000000US110010064001008,"Block 1008, Block Group 1, Census Tract 64, District of Columbia, District of Columbia",263,2,244,6,5,0,0,6,263,257,1,239,6,5,0,0,6,6,1,5,0,0,0,0,0,110010064001008,1,105,105,1,psa_22,1D3
1000000US110010108002000,"Block 2000, Block Group 2, Census Tract 108.00, District of Columbia, District of Columbia",17,6,11,0,0,0,0,0,17,14,5,9,0,0,0,0,0,3,1,2,0,0,0,0,0,110010108002000,2,207,207,2,psa_24,2D3
1000000US110010111002023,"Block 2023, Block Group 2, Census Tract 111, District of Columbia, District of Columbia",165,3,154,1,0,0,5,2,165,158,3,152,1,0,0,0,2,7,0,2,0,0,0,5,0,110010111002023,5,503,503,5,psa_45,5D2
1000000US110010001003011,"Block 3011, Block Group 3, Census Tract 1, District of Columbia, District of Columbia",87,80,2,0,4,0,0,1,87,83,76,2,0,4,0,0,1,4,4,0,0,0,0,0,0,110010001003011,2,206,206,2,psa_29,2D2
1000000US110010046002009,"Block 2009, Block Group 2, Census Tract 46, District of Columbia, District of Columbia",118,66,39,0,10,0,0,3,118,111,60,38,0,10,0,0,3,7,6,1,0,0,0,0,0,110010046002009,3,308,308,3,psa_27,3D2
1000000US110010020022001,"Block 2001, Block Group 2, Census Tract 20.02, District of Columbia, District of Columbia",178,25,112,0,1,0,37,3,178,135,22,110,0,1,0,1,1,43,3,2,0,0,0,36,2,110010020022001,4,403,403,4,psa_51,4D1
1000000US110010052012008,"Block 2008, Block Group 2, Census Tract 52.01, District of Columbia, District of Columbia",0,0,0,0,0,0,0,0,0,0,0,0,0,0,0,0,0,0,0,0,0,0,0,0,0,110010052012008,2,208,208,2,psa_33,2D3
1000000US110010058001019,"Block 1019, Block Group 1, Census Tract 58, District of Columbia, District of Columbia",0,0,0,0,0,0,0,0,0,0,0,0,0,0,0,0,0,0,0,0,0,0,0,0,0,110010058001019,2,209,209,2,psa_57,2D3
1000000US110010058001029,"Block 1029, Block Group 1, Census Tract 58, District of Columbia, District of Columbia",0,0,0,0,0,0,0,0,0,0,0,0,0,0,0,0,0,0,0,0,0,0,0,0,0,110010058001029,2,209,209,2,psa_57,2D3
1000000US110010011004020,"Block 4020, Block Group 4, Census Tract 11, District of Columbia, District of Columbia",71,62,3,0,2,0,0,4,71,64,55,3,0,2,0,0,4,7,7,0,0,0,0,0,0,110010011004020,2,202,202,2,psa_52,2D1
1000000US110010095071000,"Block 1000, Block Group 1, Census Tract 95.07, District of Columbia, District of Columbia",237,4,209,0,0,0,22,2,237,214,4,208,0,0,0,0,2,23,0,1,0,0,0,22,0,110010095071000,4,406,406,4,psa_54,4D2
1000000US110010062021188,"Block 1188, Block Group 1, Census Tract 62.02, District of Columbia, District of Columbia",0,0,0,0,0,0,0,0,0,0,0,0,0,0,0,0,0,0,0,0,0,0,0,0,0,110010062021188,1,103,103,1,psa_12,1D1
1000000US110010076014008,"Block 4008, Block Group 4, Census Tract 76.01, District of Columbia, District of Columbia",0,0,0,0,0,0,0,0,0,0,0,0,0,0,0,0,0,0,0,0,0,0,0,0,0,110010076014008,6,607,607,6,psa_10,6D2
1000000US110010094003001,"Block 3001, Block Group 3, Census Tract 94, District of Columbia, District of Columbia",55,6,48,0,0,0,0,1,55,54,5,48,0,0,0,0,1,1,1,0,0,0,0,0,0,110010094003001,5,503,503,5,psa_45,5D2
1000000US110010111003002,"Block 3002, Block Group 3, Census Tract 111, District of Columbia, District of Columbia",81,0,81,0,0,0,0,0,81,81,0,81,0,0,0,0,0,0,0,0,0,0,0,0,0,110010111003002,5,503,503,5,psa_45,5D2
1000000US110010008022012,"Block 2012, Block Group 2, Census Tract 8.02, District of Columbia, District of Columbia",0,0,0,0,0,0,0,0,0,0,0,0,0,0,0,0,0,0,0,0,0,0,0,0,0,110010008022012,2,206,206,2,psa_29,2D2
1000000US110010062021120,"Block 1120, Block Group 1, Census Tract 62.02, District of Columbia, District of Columbia",0,0,0,0,0,0,0,0,0,0,0,0,0,0,0,0,0,0,0,0,0,0,0,0,0,110010062021120,1,102,102,1,psa_18,1D1
1000000US110010069001005,"Block 1005, Block Group 1, Census Tract 69, District of Columbia, District of Columbia",93,77,8,0,5,0,0,3,93,91,76,8,0,5,0,0,2,2,1,0,0,0,0,0,1,110010069001005,1,107,107,1,psa_16,1D2
1000000US110010099032003,"Block 2003, Block Group 2, Census Tract 99.03, District of Columbia, District of Columbia",105,0,105,0,0,0,0,0,105,105,0,105,0,0,0,0,0,0,0,0,0,0,0,0,0,110010099032003,6,604,604,6,psa_14,6D3
1000000US110010001004000,"Block 4000, Block Group 4, Census Tract 1, District of Columbia, District of Columbia",53,46,2,0,5,0,0,0,53,46,41,0,0,5,0,0,0,7,5,2,0,0,0,0,0,110010001004000,2,206,206,2,psa_29,2D2
1000000US110010091021004,"Block 1004, Block Group 1, Census Tract 91.02, District of Columbia, District of Columbia",57,7,48,0,0,0,0,2,57,57,7,48,0,0,0,0,2,0,0,0,0,0,0,0,0,110010091021004,5,505,505,5,psa_34,5D2
1000000US110010055003003,"Block 3003, Block Group 3, Census Tract 55, District of Columbia, District of Columbia",244,200,8,2,26,0,2,6,244,229,186,8,2,26,0,1,6,15,14,0,0,0,0,1,0,110010055003003,2,207,207,2,psa_24,2D3
1000000US110010073011022,"Block 1022, Block Group 1, Census Tract 73.01, District of Columbia, District of Columbia",0,0,0,0,0,0,0,0,0,0,0,0,0,0,0,0,0,0,0,0,0,0,0,0,0,110010073011022,7,703,703,7,psa_8,7D1
1000000US110010105001010,"Block 1010, Block Group 1, Census Tract 105, District of Columbia, District of Columbia",210,0,202,3,0,0,0,5,210,206,0,199,3,0,0,0,4,4,0,3,0,0,0,0,1,110010105001010,1,105,105,1,psa_22,1D3
1000000US110010011002008,"Block 2008, Block Group 2, Census Tract 11, District of Columbia, District of Columbia",0,0,0,0,0,0,0,0,0,0,0,0,0,0,0,0,0,0,0,0,0,0,0,0,0,110010011002008,2,201,201,2,psa_55,2D1
1000000US110010095052003,"Block 2003, Block Group 2, Census Tract 95.05, District of Columbia, District of Columbia",48,0,46,0,0,0,0,2,48,48,0,46,0,0,0,0,2,0,0,0,0,0,0,0,0,110010095052003,4,406,406,4,psa_54,4D2
1000000US110010095091000,"Block 1000, Block Group 1, Census Tract 95.09, District of Columbia, District of Columbia",136,2,134,0,0,0,0,0,136,136,2,134,0,0,0,0,0,0,0,0,0,0,0,0,0,110010095091000,4,405,405,4,psa_49,4D2
1000000US110010098031006,"Block 1006, Block Group 1, Census Tract 98.03, District of Columbia, District of Columbia",0,0,0,0,0,0,0,0,0,0,0,0,0,0,0,0,0,0,0,0,0,0,0,0,0,110010098031006,7,707,707,7,psa_4,7D2
1000000US110010055003008,"Block 3008, Block Group 3, Census Tract 55, District of Columbia, District of Columbia",0,0,0,0,0,0,0,0,0,0,0,0,0,0,0,0,0,0,0,0,0,0,0,0,0,110010055003008,2,207,207,2,psa_24,2D3
1000000US110010077082012,"Block 2012, Block Group 2, Census Tract 77.08, District of Columbia, District of Columbia",105,0,105,0,0,0,0,0,105,105,0,105,0,0,0,0,0,0,0,0,0,0,0,0,0,110010077082012,6,603,603,6,psa_15,6D3
1000000US110010094003011,"Block 3011, Block Group 3, Census Tract 94, District of Columbia, District of Columbia",80,3,77,0,0,0,0,0,80,80,3,77,0,0,0,0,0,0,0,0,0,0,0,0,0,110010094003011,5,503,503,5,psa_45,5D2
1000000US110010009012017,"Block 2017, Block Group 2, Census Tract 9.01, District of Columbia, District of Columbia",77,68,0,0,4,0,0,5,77,74,66,0,0,4,0,0,4,3,2,0,0,0,0,0,1,110010009012017,2,205,205,2,psa_46,2D2
1000000US110010023011013,"Block 1013, Block Group 1, Census Tract 23.01, District of Columbia, District of Columbia",183,43,115,0,3,0,19,3,183,152,32,115,0,3,0,0,2,31,11,0,0,0,0,19,1,110010023011013,4,407,407,4,psa_47,4D2
1000000US110010068022000,"Block 2000, Block Group 2, Census Tract 68.02, District of Columbia, District of Columbia",96,42,52,0,0,0,0,2,96,94,40,52,0,0,0,0,2,2,2,0,0,0,0,0,0,110010068022000,1,107,107,1,psa_16,1D2
1000000US110010074042003,"Block 2003, Block Group 2, Census Tract 74.04, District of Columbia, District of Columbia",0,0,0,0,0,0,0,0,0,0,0,0,0,0,0,0,0,0,0,0,0,0,0,0,0,110010074042003,7,704,704,7,psa_5,7D2
1000000US110010028022006,"Block 2006, Block Group 2, Census Tract 28.02, District of Columbia, District of Columbia",0,0,0,0,0,0,0,0,0,0,0,0,0,0,0,0,0,0,0,0,0,0,0,0,0,110010028022006,3,302,302,3,psa_42,3D1
1000000US110010093011009,"Block 1009, Block Group 1, Census Tract 93.01, District of Columbia, District of Columbia",45,7,35,1,0,0,0,2,45,43,7,34,0,0,0,0,2,2,0,1,1,0,0,0,0,110010093011009,5,504,504,5,psa_43,5D2
1000000US110010108002007,"Block 2007, Block Group 2, Census Tract 108.00, District of Columbia, District of Columbia",0,0,0,0,0,0,0,0,0,0,0,0,0,0,0,0,0,0,0,0,0,0,0,0,0,110010108002007,2,207,207,2,psa_24,2D3
1000000US110010111003044,"Block 3044, Block Group 3, Census Tract 111, District of Columbia, District of Columbia",0,0,0,0,0,0,0,0,0,0,0,0,0,0,0,0,0,0,0,0,0,0,0,0,0,110010111003044,5,503,503,5,psa_45,5D2
1000000US110010011002026,"Block 2026, Block Group 2, Census Tract 11, District of Columbia, District of Columbia",54,48,0,0,1,0,0,5,54,49,44,0,0,0,0,0,5,5,4,0,0,1,0,0,0,110010011002026,2,202,202,2,psa_52,2D1
1000000US110010032001002,"Block 1002, Block Group 1, Census Tract 32, District of Columbia, District of Columbia",330,100,182,3,8,0,31,6,330,264,77,173,3,8,0,0,3,66,23,9,0,0,0,31,3,110010032001002,4,409,409,4,psa_41,4D3
1000000US110010065001008,"Block 1008, Block Group 1, Census Tract 65, District of Columbia, District of Columbia",70,45,21,1,0,0,3,0,70,56,34,20,1,0,0,1,0,14,11,1,0,0,0,2,0,110010065001008,1,106,106,1,psa_13,1D3
1000000US110010066001001,"Block 1001, Block Group 1, Census Tract 66, District of Columbia, District of Columbia",206,172,15,2,11,0,3,3,206,200,171,14,2,11,0,0,2,6,1,1,0,0,0,3,1,110010066001001,1,107,107,1,psa_16,1D2
1000000US110010076043003,"Block 3003, Block Group 3, Census Tract 76.04, District of Columbia, District of Columbia",87,3,80,0,0,0,1,3,87,85,3,79,0,0,0,0,3,2,0,1,0,0,0,1,0,110010076043003,6,607,607,6,psa_10,6D2
1000000US110010077032002,"Block 2002, Block Group 2, Census Tract 77.03, District of Columbia, District of Columbia",193,3,186,0,0,0,0,4,193,189,1,185,0,0,0,0,3,4,2,1,0,0,0,0,1,110010077032002,6,603,603,6,psa_15,6D3
1000000US110010095081006,"Block 1006, Block Group 1, Census Tract 95.08, District of Columbia, District of Columbia",0,0,0,0,0,0,0,0,0,0,0,0,0,0,0,0,0,0,0,0,0,0,0,0,0,110010095081006,4,406,406,4,psa_54,4D2
1000000US110010059001028,"Block 1028, Block Group 1, Census Tract 59, District of Columbia, District of Columbia",0,0,0,0,0,0,0,0,0,0,0,0,0,0,0,0,0,0,0,0,0,0,0,0,0,110010059001028,1,102,102,1,psa_18,1D1
1000000US110010073011037,"Block 1037, Block Group 1, Census Tract 73.01, District of Columbia, District of Columbia",0,0,0,0,0,0,0,0,0,0,0,0,0,0,0,0,0,0,0,0,0,0,0,0,0,110010073011037,7,703,703,7,psa_8,7D1
1000000US110010070002012,"Block 2012, Block Group 2, Census Tract 70, District of Columbia, District of Columbia",57,39,14,0,4,0,0,0,57,57,39,14,0,4,0,0,0,0,0,0,0,0,0,0,0,110010070002012,1,106,106,1,psa_13,1D3
1000000US110010096042003,"Block 2003, Block Group 2, Census Tract 96.04, District of Columbia, District of Columbia",30,0,30,0,0,0,0,0,30,29,0,29,0,0,0,0,0,1,0,1,0,0,0,0,0,110010096042003,6,603,603,6,psa_15,6D3
1000000US110010010012026,"Block 2026, Block Group 2, Census Tract 10.01, District of Columbia, District of Columbia",65,58,4,0,1,0,2,0,65,63,58,4,0,1,0,0,0,2,0,0,0,0,0,2,0,110010010012026,2,202,202,2,psa_52,2D1
1000000US110010019014009,"Block 4009, Block Group 4, Census Tract 19.01, District of Columbia, District of Columbia",91,4,73,0,0,0,11,3,91,74,3,69,0,0,0,0,2,17,1,4,0,0,0,11,1,110010019014009,4,402,402,4,psa_53,4D1
1000000US110010023012008,"Block 2008, Block Group 2, Census Tract 23.01, District of Columbia, District of Columbia",94,10,84,0,0,0,0,0,94,91,9,82,0,0,0,0,0,3,1,2,0,0,0,0,0,110010023012008,4,407,407,4,psa_47,4D2
1000000US110010031001000,"Block 1000, Block Group 1, Census Tract 31, District of Columbia, District of Columbia",6,3,3,0,0,0,0,0,6,6,3,3,0,0,0,0,0,0,0,0,0,0,0,0,0,110010031001000,4,409,409,4,psa_41,4D3
1000000US110010062021234,"Block 1234, Block Group 1, Census Tract 62.02, District of Columbia, District of Columbia",0,0,0,0,0,0,0,0,0,0,0,0,0,0,0,0,0,0,0,0,0,0,0,0,0,110010062021234,2,207,207,2,psa_24,2D3
1000000US110010074091001,"Block 1001, Block Group 1, Census Tract 74.09, District of Columbia, District of Columbia",194,9,183,0,0,0,0,2,194,186,1,183,0,0,0,0,2,8,8,0,0,0,0,0,0,110010074091001,7,704,704,7,psa_5,7D2
1000000US110010088042013,"Block 2013, Block Group 2, Census Tract 88.04, District of Columbia, District of Columbia",152,23,121,0,0,0,5,3,152,125,5,117,0,0,0,0,3,27,18,4,0,0,0,5,0,110010088042013,5,506,506,5,psa_26,5D3
1000000US110010011002025,"Block 2025, Block Group 2, Census Tract 11, District of Columbia, District of Columbia",61,57,0,0,4,0,0,0,61,54,50,0,0,4,0,0,0,7,7,0,0,0,0,0,0,110010011002025,2,202,202,2,psa_52,2D1
1000000US110010005011014,"Block 1014, Block Group 1, Census Tract 5.01, District of Columbia, District of Columbia",0,0,0,0,0,0,0,0,0,0,0,0,0,0,0,0,0,0,0,0,0,0,0,0,0,110010005011014,2,204,204,2,psa_44,2D2
1000000US110010062021025,"Block 1025, Block Group 1, Census Tract 62.02, District of Columbia, District of Columbia",0,0,0,0,0,0,0,0,0,0,0,0,0,0,0,0,0,0,0,0,0,0,0,0,0,110010062021025,2,209,209,2,psa_57,2D3
1000000US110010077091022,"Block 1022, Block Group 1, Census Tract 77.09, District of Columbia, District of Columbia",0,0,0,0,0,0,0,0,0,0,0,0,0,0,0,0,0,0,0,0,0,0,0,0,0,110010077091022,6,605,605,6,psa_11,6D2
1000000US110010047021008,"Block 1008, Block Group 1, Census Tract 47.02, District of Columbia, District of Columbia",371,225,47,0,80,0,5,14,371,359,218,46,0,80,0,4,11,12,7,1,0,0,0,1,3,110010047021008,1,101,101,1,psa_20,1D1
1000000US110010026002013,"Block 2013, Block Group 2, Census Tract 26, District of Columbia, District of Columbia",0,0,0,0,0,0,0,0,0,0,0,0,0,0,0,0,0,0,0,0,0,0,0,0,0,110010026002013,2,203,203,2,psa_50,2D1
1000000US110010075022004,"Block 2004, Block Group 2, Census Tract 75.02, District of Columbia, District of Columbia",69,0,69,0,0,0,0,0,69,69,0,69,0,0,0,0,0,0,0,0,0,0,0,0,0,110010075022004,7,702,702,7,psa_6,7D1
1000000US110010084101008,"Block 1008, Block Group 1, Census Tract 84.10, District of Columbia, District of Columbia",0,0,0,0,0,0,0,0,0,0,0,0,0,0,0,0,0,0,0,0,0,0,0,0,0,110010084101008,1,104,104,1,psa_21,1D2
1000000US110010009022019,"Block 2019, Block Group 2, Census Tract 9.02, District of Columbia, District of Columbia",48,40,2,0,2,0,0,4,48,48,40,2,0,2,0,0,4,0,0,0,0,0,0,0,0,110010009022019,2,205,205,2,psa_46,2D2
1000000US110010046001001,"Block 1001, Block Group 1, Census Tract 46, District of Columbia, District of Columbia",126,40,73,0,0,0,11,2,126,101,26,71,0,0,0,2,2,25,14,2,0,0,0,9,0,110010046001001,3,308,308,3,psa_27,3D2
1000000US110010078091003,"Block 1003, Block Group 1, Census Tract 78.09, District of Columbia, District of Columbia",460,4,440,0,1,0,7,8,460,454,4,440,0,1,0,1,8,6,0,0,0,0,0,6,0,110010078091003,6,608,608,6,psa_19,6D1
1000000US110010099012025,"Block 2025, Block Group 2, Census Tract 99.01, District of Columbia, District of Columbia",89,3,86,0,0,0,0,0,89,87,1,86,0,0,0,0,0,2,2,0,0,0,0,0,0,110010099012025,6,605,605,6,psa_11,6D2
1000000US110010011004019,"Block 4019, Block Group 4, Census Tract 11, District of Columbia, District of Columbia",65,51,3,0,8,0,0,3,65,65,51,3,0,8,0,0,3,0,0,0,0,0,0,0,0,110010011004019,2,202,202,2,psa_52,2D1
1000000US110010021012000,"Block 2000, Block Group 2, Census Tract 21.01, District of Columbia, District of Columbia",327,28,200,0,7,0,69,23,327,221,17,191,0,7,0,0,6,106,11,9,0,0,0,69,17,110010021012000,4,403,403,4,psa_51,4D1
1000000US110010075032004,"Block 2004, Block Group 2, Census Tract 75.03, District of Columbia, District of Columbia",113,2,110,0,0,0,0,1,113,113,2,110,0,0,0,0,1,0,0,0,0,0,0,0,0,110010075032004,7,701,701,7,psa_9,7D1
1000000US110010080012001,"Block 2001, Block Group 2, Census Tract 80.01, District of Columbia, District of Columbia",109,41,68,0,0,0,0,0,109,106,38,68,0,0,0,0,0,3,3,0,0,0,0,0,0,110010080012001,1,104,104,1,psa_21,1D2
1000000US110010094004010,"Block 4010, Block Group 4, Census Tract 94, District of Columbia, District of Columbia",45,0,45,0,0,0,0,0,45,45,0,45,0,0,0,0,0,0,0,0,0,0,0,0,0,110010094004010,5,503,503,5,psa_45,5D2
1000000US110010095041023,"Block 1023, Block Group 1, Census Tract 95.04, District of Columbia, District of Columbia",0,0,0,0,0,0,0,0,0,0,0,0,0,0,0,0,0,0,0,0,0,0,0,0,0,110010095041023,5,504,504,5,psa_43,5D2
1000000US110010103002002,"Block 2002, Block Group 2, Census Tract 103, District of Columbia, District of Columbia",73,4,69,0,0,0,0,0,73,66,4,62,0,0,0,0,0,7,0,7,0,0,0,0,0,110010103002002,4,401,401,4,psa_56,4D1
1000000US110010023021014,"Block 1014, Block Group 1, Census Tract 23.02, District of Columbia, District of Columbia",0,0,0,0,0,0,0,0,0,0,0,0,0,0,0,0,0,0,0,0,0,0,0,0,0,110010023021014,4,405,405,4,psa_49,4D2
1000000US110010078081000,"Block 1000, Block Group 1, Census Tract 78.08, District of Columbia, District of Columbia",30,0,30,0,0,0,0,0,30,30,0,30,0,0,0,0,0,0,0,0,0,0,0,0,0,110010078081000,6,608,608,6,psa_19,6D1
1000000US110010106002008,"Block 2008, Block Group 2, Census Tract 106, District of Columbia, District of Columbia",0,0,0,0,0,0,0,0,0,0,0,0,0,0,0,0,0,0,0,0,0,0,0,0,0,110010106002008,5,501,501,5,psa_35,5D1
1000000US110010001001007,"Block 1007, Block Group 1, Census Tract 1, District of Columbia, District of Columbia",38,37,1,0,0,0,0,0,38,38,37,1,0,0,0,0,0,0,0,0,0,0,0,0,0,110010001001007,2,206,206,2,psa_29,2D2
1000000US110010087022000,"Block 2000, Block Group 2, Census Tract 87.02, District of Columbia, District of Columbia",24,0,23,0,0,0,0,1,24,24,0,23,0,0,0,0,1,0,0,0,0,0,0,0,0,110010087022000,5,502,502,5,psa_40,5D1
1000000US110010083021002,"Block 1002, Block Group 1, Census Tract 83.02, District of Columbia, District of Columbia",0,0,0,0,0,0,0,0,0,0,0,0,0,0,0,0,0,0,0,0,0,0,0,0,0,110010083021002,1,104,104,1,psa_21,1D2
1000000US110010095092006,"Block 2006, Block Group 2, Census Tract 95.09, District of Columbia, District of Columbia",100,8,86,0,1,0,0,5,100,100,8,86,0,1,0,0,5,0,0,0,0,0,0,0,0,110010095092006,4,405,405,4,psa_49,4D2
1000000US110010005021006,"Block 1006, Block Group 1, Census Tract 5.02, District of Columbia, District of Columbia",114,107,0,0,4,0,0,3,114,109,103,0,0,4,0,0,2,5,4,0,0,0,0,0,1,110010005021006,2,204,204,2,psa_44,2D2
1000000US110010021024009,"Block 4009, Block Group 4, Census Tract 21.02, District of Columbia, District of Columbia",281,30,199,0,1,0,42,9,281,209,10,195,0,1,0,0,3,72,20,4,0,0,0,42,6,110010021024009,4,403,403,4,psa_51,4D1
1000000US110010077092003,"Block 2003, Block Group 2, Census Tract 77.09, District of Columbia, District of Columbia",0,0,0,0,0,0,0,0,0,0,0,0,0,0,0,0,0,0,0,0,0,0,0,0,0,110010077092003,6,605,605,6,psa_11,6D2
1000000US110010022022004,"Block 2004, Block Group 2, Census Tract 22.02, District of Columbia, District of Columbia",94,7,64,0,0,0,17,6,94,65,0,62,0,0,0,0,3,29,7,2,0,0,0,17,3,110010022022004,4,407,407,4,psa_47,4D2
1000000US110010098071002,"Block 1002, Block Group 1, Census Tract 98.07, District of Columbia, District of Columbia",0,0,0,0,0,0,0,0,0,0,0,0,0,0,0,0,0,0,0,0,0,0,0,0,0,110010098071002,7,708,708,7,psa_1,7D3
1000000US110010079011001,"Block 1001, Block Group 1, Census Tract 79.01, District of Columbia, District of Columbia",291,0,282,1,0,0,0,8,291,287,0,281,1,0,0,0,5,4,0,1,0,0,0,0,3,110010079011001,5,507,507,5,psa_23,5D3
1000000US110010028021003,"Block 1003, Block Group 1, Census Tract 28.02, District of Columbia, District of Columbia",77,65,3,0,5,0,0,4,77,75,63,3,0,5,0,0,4,2,2,0,0,0,0,0,0,110010028021003,3,302,302,3,psa_42,3D1
1000000US110010098011010,"Block 1010, Block Group 1, Census Tract 98.01, District of Columbia, District of Columbia",0,0,0,0,0,0,0,0,0,0,0,0,0,0,0,0,0,0,0,0,0,0,0,0,0,110010098011010,7,707,707,7,psa_4,7D2
1000000US110010099042008,"Block 2008, Block Group 2, Census Tract 99.04, District of Columbia, District of Columbia",151,2,149,0,0,0,0,0,151,151,2,149,0,0,0,0,0,0,0,0,0,0,0,0,0,110010099042008,6,604,604,6,psa_14,6D3
1000000US110010055001004,"Block 1004, Block Group 1, Census Tract 55, District of Columbia, District of Columbia",70,56,6,0,6,0,0,2,70,69,56,6,0,6,0,0,1,1,0,0,0,0,0,0,1,110010055001004,2,208,208,2,psa_33,2D3
1000000US110010082001004,"Block 1004, Block Group 1, Census Tract 82, District of Columbia, District of Columbia",298,262,4,0,15,0,5,12,298,282,253,3,0,15,0,0,11,16,9,1,0,0,0,5,1,110010082001004,1,108,108,1,psa_17,1D2
1000000US110010011004030,"Block 4030, Block Group 4, Census Tract 11, District of Columbia, District of Columbia",0,0,0,0,0,0,0,0,0,0,0,0,0,0,0,0,0,0,0,0,0,0,0,0,0,110010011004030,2,203,203,2,psa_50,2D1
1000000US110010025022007,"Block 2007, Block Group 2, Census Tract 25.02, District of Columbia, District of Columbia",172,21,130,0,7,0,5,9,172,146,9,128,0,7,0,0,2,26,12,2,0,0,0,5,7,110010025022007,4,404,404,4,psa_48,4D3
1000000US110010074072001,"Block 2001, Block Group 2, Census Tract 74.07, District of Columbia, District of Columbia",257,16,234,0,0,0,0,7,257,254,16,231,0,0,0,0,7,3,0,3,0,0,0,0,0,110010074072001,7,703,703,7,psa_8,7D1
1000000US110010078082002,"Block 2002, Block Group 2, Census Tract 78.08, District of Columbia, District of Columbia",29,0,29,0,0,0,0,0,29,29,0,29,0,0,0,0,0,0,0,0,0,0,0,0,0,110010078082002,6,608,608,6,psa_19,6D1
1000000US110010004002000,"Block 2000, Block Group 2, Census Tract 4, District of Columbia, District of Columbia",17,15,0,0,2,0,0,0,17,17,15,0,0,2,0,0,0,0,0,0,0,0,0,0,0,110010004002000,2,204,204,2,psa_44,2D2
1000000US110010072001002,"Block 1002, Block Group 1, Census Tract 72, District of Columbia, District of Columbia",0,0,0,0,0,0,0,0,0,0,0,0,0,0,0,0,0,0,0,0,0,0,0,0,0,110010072001002,1,106,106,1,psa_13,1D3
1000000US110010078043006,"Block 3006, Block Group 3, Census Tract 78.04, District of Columbia, District of Columbia",2,0,2,0,0,0,0,0,2,2,0,2,0,0,0,0,0,0,0,0,0,0,0,0,0,110010078043006,6,602,602,6,psa_25,6D1
1000000US110010073041010,"Block 1010, Block Group 1, Census Tract 73.04, District of Columbia, District of Columbia",0,0,0,0,0,0,0,0,0,0,0,0,0,0,0,0,0,0,0,0,0,0,0,0,0,110010073041010,7,705,705,7,psa_3,7D2
1000000US110010096042005,"Block 2005, Block Group 2, Census Tract 96.04, District of Columbia, District of Columbia",161,1,152,0,0,0,2,6,161,151,1,150,0,0,0,0,0,10,0,2,0,0,0,2,6,110010096042005,6,603,603,6,psa_15,6D3
1000000US110010013022004,"Block 2004, Block Group 2, Census Tract 13.02, District of Columbia, District of Columbia",2,2,0,0,0,0,0,0,2,2,2,0,0,0,0,0,0,0,0,0,0,0,0,0,0,110010013022004,2,203,203,2,psa_50,2D1
1000000US110010080011000,"Block 1000, Block Group 1, Census Tract 80.01, District of Columbia, District of Columbia",96,10,70,2,2,0,12,0,96,80,8,69,2,1,0,0,0,16,2,1,0,1,0,12,0,110010080011000,1,104,104,1,psa_21,1D2
1000000US110010012001014,"Block 1014, Block Group 1, Census Tract 12, District of Columbia, District of Columbia",19,18,0,0,0,0,0,1,19,17,16,0,0,0,0,0,1,2,2,0,0,0,0,0,0,110010012001014,2,202,202,2,psa_52,2D1
1000000US110010074011017,"Block 1017, Block Group 1, Census Tract 74.01, District of Columbia, District of Columbia",0,0,0,0,0,0,0,0,0,0,0,0,0,0,0,0,0,0,0,0,0,0,0,0,0,110010074011017,7,703,703,7,psa_8,7D1
1000000US110010106002021,"Block 2021, Block Group 2, Census Tract 106, District of Columbia, District of Columbia",0,0,0,0,0,0,0,0,0,0,0,0,0,0,0,0,0,0,0,0,0,0,0,0,0,110010106002021,5,501,501,5,psa_35,5D1
1000000US110010019012008,"Block 2008, Block Group 2, Census Tract 19.01, District of Columbia, District of Columbia",146,17,113,1,0,0,10,5,146,122,7,113,1,0,0,0,1,24,10,0,0,0,0,10,4,110010019012008,4,402,402,4,psa_53,4D1
1000000US110010065002021,"Block 2021, Block Group 2, Census Tract 65, District of Columbia, District of Columbia",0,0,0,0,0,0,0,0,0,0,0,0,0,0,0,0,0,0,0,0,0,0,0,0,0,110010065002021,1,106,106,1,psa_13,1D3
1000000US110010108002022,"Block 2022, Block Group 2, Census Tract 108.00, District of Columbia, District of Columbia",0,0,0,0,0,0,0,0,0,0,0,0,0,0,0,0,0,0,0,0,0,0,0,0,0,110010108002022,2,207,207,2,psa_24,2D3
1000000US110010072001003,"Block 1003, Block Group 1, Census Tract 72, District of Columbia, District of Columbia",0,0,0,0,0,0,0,0,0,0,0,0,0,0,0,0,0,0,0,0,0,0,0,0,0,110010072001003,1,106,106,1,psa_13,1D3
1000000US110010075041003,"Block 1003, Block Group 1, Census Tract 75.04, District of Columbia, District of Columbia",39,0,38,0,1,0,0,0,39,39,0,38,0,1,0,0,0,0,0,0,0,0,0,0,0,110010075041003,7,701,701,7,psa_9,7D1
1000000US110010010014023,"Block 4023, Block Group 4, Census Tract 10.01, District of Columbia, District of Columbia",93,69,11,0,6,0,0,7,93,85,62,10,0,6,0,0,7,8,7,1,0,0,0,0,0,110010010014023,2,202,202,2,psa_52,2D1
1000000US110010077092004,"Block 2004, Block Group 2, Census Tract 77.09, District of Columbia, District of Columbia",92,6,80,0,0,0,0,6,92,89,3,80,0,0,0,0,6,3,3,0,0,0,0,0,0,110010077092004,6,605,605,6,psa_11,6D2
1000000US110010062021115,"Block 1115, Block Group 1, Census Tract 62.02, District of Columbia, District of Columbia",0,0,0,0,0,0,0,0,0,0,0,0,0,0,0,0,0,0,0,0,0,0,0,0,0,110010062021115,1,102,102,1,psa_18,1D1
1000000US110010102002044,"Block 2044, Block Group 2, Census Tract 102, District of Columbia, District of Columbia",0,0,0,0,0,0,0,0,0,0,0,0,0,0,0,0,0,0,0,0,0,0,0,0,0,110010102002044,1,105,105,1,psa_22,1D3
1000000US110010111001012,"Block 1012, Block Group 1, Census Tract 111, District of Columbia, District of Columbia",2,1,1,0,0,0,0,0,2,2,1,1,0,0,0,0,0,0,0,0,0,0,0,0,0,110010111001012,5,503,503,5,psa_45,5D2
1000000US110010080022008,"Block 2008, Block Group 2, Census Tract 80.02, District of Columbia, District of Columbia",202,105,82,0,3,0,12,0,202,188,103,82,0,3,0,0,0,14,2,0,0,0,0,12,0,110010080022008,1,108,108,1,psa_17,1D2
1000000US110010096042001,"Block 2001, Block Group 2, Census Tract 96.04, District of Columbia, District of Columbia",48,0,48,0,0,0,0,0,48,48,0,48,0,0,0,0,0,0,0,0,0,0,0,0,0,110010096042001,6,603,603,6,psa_15,6D3
1000000US110010070001001,"Block 1001, Block Group 1, Census Tract 70, District of Columbia, District of Columbia",110,94,9,0,0,0,2,5,110,103,88,9,0,0,0,2,4,7,6,0,0,0,0,0,1,110010070001001,1,106,106,1,psa_13,1D3
1000000US110010087011003,"Block 1003, Block Group 1, Census Tract 87.01, District of Columbia, District of Columbia",77,16,37,1,7,0,16,0,77,53,9,37,0,7,0,0,0,24,7,0,1,0,0,16,0,110010087011003,5,502,502,5,psa_40,5D1
1000000US110010095081001,"Block 1001, Block Group 1, Census Tract 95.08, District of Columbia, District of Columbia",0,0,0,0,0,0,0,0,0,0,0,0,0,0,0,0,0,0,0,0,0,0,0,0,0,110010095081001,4,406,406,4,psa_54,4D2
1000000US110010098071013,"Block 1013, Block Group 1, Census Tract 98.07, District of Columbia, District of Columbia",32,0,32,0,0,0,0,0,32,32,0,32,0,0,0,0,0,0,0,0,0,0,0,0,0,110010098071013,7,708,708,7,psa_1,7D3
1000000US110010010011000,"Block 1000, Block Group 1, Census Tract 10.01, District of Columbia, District of Columbia",0,0,0,0,0,0,0,0,0,0,0,0,0,0,0,0,0,0,0,0,0,0,0,0,0,110010010011000,2,202,202,2,psa_52,2D1
1000000US110010013012006,"Block 2006, Block Group 2, Census Tract 13.01, District of Columbia, District of Columbia",34,26,3,0,3,0,0,2,34,34,26,3,0,3,0,0,2,0,0,0,0,0,0,0,0,110010013012006,2,203,203,2,psa_50,2D1
1000000US110010106003003,"Block 3003, Block Group 3, Census Tract 106, District of Columbia, District of Columbia",180,53,118,0,4,0,0,5,180,176,52,115,0,4,0,0,5,4,1,3,0,0,0,0,0,110010106003003,5,501,501,5,psa_35,5D1
1000000US110010009011005,"Block 1005, Block Group 1, Census Tract 9.01, District of Columbia, District of Columbia",24,21,2,0,1,0,0,0,24,24,21,2,0,1,0,0,0,0,0,0,0,0,0,0,0,110010009011005,2,205,205,2,psa_46,2D2
1000000US110010014023005,"Block 3005, Block Group 3, Census Tract 14.02, District of Columbia, District of Columbia",409,154,145,3,50,0,44,13,409,313,108,143,3,50,0,1,8,96,46,2,0,0,0,43,5,110010014023005,2,201,201,2,psa_55,2D1
1000000US110010062021238,"Block 1238, Block Group 1, Census Tract 62.02, District of Columbia, District of Columbia",0,0,0,0,0,0,0,0,0,0,0,0,0,0,0,0,0,0,0,0,0,0,0,0,0,110010062021238,2,207,207,2,psa_24,2D3
1000000US110010074011018,"Block 1018, Block Group 1, Census Tract 74.01, District of Columbia, District of Columbia",0,0,0,0,0,0,0,0,0,0,0,0,0,0,0,0,0,0,0,0,0,0,0,0,0,110010074011018,7,703,703,7,psa_8,7D1
1000000US110010077092014,"Block 2014, Block Group 2, Census Tract 77.09, District of Columbia, District of Columbia",0,0,0,0,0,0,0,0,0,0,0,0,0,0,0,0,0,0,0,0,0,0,0,0,0,110010077092014,6,605,605,6,psa_11,6D2
1000000US110010094003025,"Block 3025, Block Group 3, Census Tract 94, District of Columbia, District of Columbia",53,3,49,0,0,0,0,1,53,53,3,49,0,0,0,0,1,0,0,0,0,0,0,0,0,110010094003025,5,503,503,5,psa_45,5D2
1000000US110010096011007,"Block 1007, Block Group 1, Census Tract 96.01, District of Columbia, District of Columbia",0,0,0,0,0,0,0,0,0,0,0,0,0,0,0,0,0,0,0,0,0,0,0,0,0,110010096011007,6,601,601,6,psa_30,6D1
1000000US110010104001007,"Block 1007, Block Group 1, Census Tract 104, District of Columbia, District of Columbia",19,0,19,0,0,0,0,0,19,19,0,19,0,0,0,0,0,0,0,0,0,0,0,0,0,110010104001007,7,705,705,7,psa_3,7D2
1000000US110010012004022,"Block 4022, Block Group 4, Census Tract 12, District of Columbia, District of Columbia",63,58,0,0,5,0,0,0,63,62,57,0,0,5,0,0,0,1,1,0,0,0,0,0,0,110010012004022,2,202,202,2,psa_52,2D1
1000000US110010062021076,"Block 1076, Block Group 1, Census Tract 62.02, District of Columbia, District of Columbia",0,0,0,0,0,0,0,0,0,0,0,0,0,0,0,0,0,0,0,0,0,0,0,0,0,110010062021076,2,207,207,2,psa_24,2D3
1000000US110010078081015,"Block 1015, Block Group 1, Census Tract 78.08, District of Columbia, District of Columbia",140,2,128,0,0,0,5,5,140,134,2,128,0,0,0,1,3,6,0,0,0,0,0,4,2,110010078081015,6,608,608,6,psa_19,6D1
1000000US110010013011012,"Block 1012, Block Group 1, Census Tract 13.01, District of Columbia, District of Columbia",0,0,0,0,0,0,0,0,0,0,0,0,0,0,0,0,0,0,0,0,0,0,0,0,0,110010013011012,2,203,203,2,psa_50,2D1
1000000US110010076032004,"Block 2004, Block Group 2, Census Tract 76.03, District of Columbia, District of Columbia",156,4,145,1,1,0,0,5,156,156,4,145,1,1,0,0,5,0,0,0,0,0,0,0,0,110010076032004,6,606,606,6,psa_7,6D2
1000000US110010073011109,"Block 1109, Block Group 1, Census Tract 73.01, District of Columbia, District of Columbia",340,175,100,1,15,6,20,23,340,280,148,95,1,15,6,4,11,60,27,5,0,0,0,16,12,110010073011109,7,708,708,7,psa_1,7D3
1000000US110010073011114,"Block 1114, Block Group 1, Census Tract 73.01, District of Columbia, District of Columbia",0,0,0,0,0,0,0,0,0,0,0,0,0,0,0,0,0,0,0,0,0,0,0,0,0,110010073011114,7,708,708,7,psa_1,7D3
1000000US110010017022001,"Block 2001, Block Group 2, Census Tract 17.02, District of Columbia, District of Columbia",117,86,6,0,8,0,11,6,117,99,77,6,0,8,0,3,5,18,9,0,0,0,0,8,1,110010017022001,4,401,401,4,psa_56,4D1
1000000US110010022011005,"Block 1005, Block Group 1, Census Tract 22.01, District of Columbia, District of Columbia",0,0,0,0,0,0,0,0,0,0,0,0,0,0,0,0,0,0,0,0,0,0,0,0,0,110010022011005,4,407,407,4,psa_47,4D2
1000000US110010064002031,"Block 2031, Block Group 2, Census Tract 64, District of Columbia, District of Columbia",0,0,0,0,0,0,0,0,0,0,0,0,0,0,0,0,0,0,0,0,0,0,0,0,0,110010064002031,1,105,105,1,psa_22,1D3
1000000US110010076014005,"Block 4005, Block Group 4, Census Tract 76.01, District of Columbia, District of Columbia",58,0,55,0,0,0,0,3,58,58,0,55,0,0,0,0,3,0,0,0,0,0,0,0,0,110010076014005,6,607,607,6,psa_10,6D2
1000000US110010104002030,"Block 2030, Block Group 2, Census Tract 104, District of Columbia, District of Columbia",0,0,0,0,0,0,0,0,0,0,0,0,0,0,0,0,0,0,0,0,0,0,0,0,0,110010104002030,7,703,703,7,psa_8,7D1
1000000US110010077091003,"Block 1003, Block Group 1, Census Tract 77.09, District of Columbia, District of Columbia",0,0,0,0,0,0,0,0,0,0,0,0,0,0,0,0,0,0,0,0,0,0,0,0,0,110010077091003,6,605,605,6,psa_11,6D2
1000000US110010096021010,"Block 1010, Block Group 1, Census Tract 96.02, District of Columbia, District of Columbia",0,0,0,0,0,0,0,0,0,0,0,0,0,0,0,0,0,0,0,0,0,0,0,0,0,110010096021010,6,601,601,6,psa_30,6D1
1000000US110010105002012,"Block 2012, Block Group 2, Census Tract 105, District of Columbia, District of Columbia",0,0,0,0,0,0,0,0,0,0,0,0,0,0,0,0,0,0,0,0,0,0,0,0,0,110010105002012,1,103,103,1,psa_12,1D1
1000000US110010095041026,"Block 1026, Block Group 1, Census Tract 95.04, District of Columbia, District of Columbia",0,0,0,0,0,0,0,0,0,0,0,0,0,0,0,0,0,0,0,0,0,0,0,0,0,110010095041026,5,504,504,5,psa_43,5D2
1000000US110010006004013,"Block 4013, Block Group 4, Census Tract 6, District of Columbia, District of Columbia",0,0,0,0,0,0,0,0,0,0,0,0,0,0,0,0,0,0,0,0,0,0,0,0,0,110010006004013,2,203,203,2,psa_50,2D1
1000000US110010011002024,"Block 2024, Block Group 2, Census Tract 11, District of Columbia, District of Columbia",31,31,0,0,0,0,0,0,31,31,31,0,0,0,0,0,0,0,0,0,0,0,0,0,0,110010011002024,2,202,202,2,psa_52,2D1
1000000US110010104002036,"Block 2036, Block Group 2, Census Tract 104, District of Columbia, District of Columbia",0,0,0,0,0,0,0,0,0,0,0,0,0,0,0,0,0,0,0,0,0,0,0,0,0,110010104002036,7,703,703,7,psa_8,7D1
1000000US110010062021207,"Block 1207, Block Group 1, Census Tract 62.02, District of Columbia, District of Columbia",0,0,0,0,0,0,0,0,0,0,0,0,0,0,0,0,0,0,0,0,0,0,0,0,0,110010062021207,1,103,103,1,psa_12,1D1
1000000US110010003003001,"Block 3001, Block Group 3, Census Tract 3, District of Columbia, District of Columbia",159,140,6,0,6,0,3,4,159,141,126,6,0,6,0,0,3,18,14,0,0,0,0,3,1,110010003003001,2,204,204,2,psa_44,2D2
1000000US110010078081008,"Block 1008, Block Group 1, Census Tract 78.08, District of Columbia, District of Columbia",121,0,121,0,0,0,0,0,121,120,0,120,0,0,0,0,0,1,0,1,0,0,0,0,0,110010078081008,6,608,608,6,psa_19,6D1
1000000US110010011002000,"Block 2000, Block Group 2, Census Tract 11, District of Columbia, District of Columbia",0,0,0,0,0,0,0,0,0,0,0,0,0,0,0,0,0,0,0,0,0,0,0,0,0,110010011002000,2,202,202,2,psa_52,2D1
1000000US110010055002003,"Block 2003, Block Group 2, Census Tract 55, District of Columbia, District of Columbia",0,0,0,0,0,0,0,0,0,0,0,0,0,0,0,0,0,0,0,0,0,0,0,0,0,110010055002003,2,206,206,2,psa_29,2D2
1000000US110010065001003,"Block 1003, Block Group 1, Census Tract 65, District of Columbia, District of Columbia",0,0,0,0,0,0,0,0,0,0,0,0,0,0,0,0,0,0,0,0,0,0,0,0,0,110010065001003,1,107,107,1,psa_16,1D2
1000000US110010095091002,"Block 1002, Block Group 1, Census Tract 95.09, District of Columbia, District of Columbia",133,1,130,0,0,0,1,1,133,131,1,130,0,0,0,0,0,2,0,0,0,0,0,1,1,110010095091002,4,405,405,4,psa_49,4D2
1000000US110010098032003,"Block 2003, Block Group 2, Census Tract 98.03, District of Columbia, District of Columbia",133,0,131,0,0,0,1,1,133,132,0,131,0,0,0,0,1,1,0,0,0,0,0,1,0,110010098032003,7,707,707,7,psa_4,7D2
1000000US110010072001013,"Block 1013, Block Group 1, Census Tract 72, District of Columbia, District of Columbia",0,0,0,0,0,0,0,0,0,0,0,0,0,0,0,0,0,0,0,0,0,0,0,0,0,110010072001013,1,106,106,1,psa_13,1D3
1000000US110010010015004,"Block 5004, Block Group 5, Census Tract 10.01, District of Columbia, District of Columbia",59,59,0,0,0,0,0,0,59,57,57,0,0,0,0,0,0,2,2,0,0,0,0,0,0,110010010015004,2,202,202,2,psa_52,2D1
1000000US110010088031010,"Block 1010, Block Group 1, Census Tract 88.03, District of Columbia, District of Columbia",0,0,0,0,0,0,0,0,0,0,0,0,0,0,0,0,0,0,0,0,0,0,0,0,0,110010088031010,5,506,506,5,psa_26,5D3
1000000US110010081003009,"Block 3009, Block Group 3, Census Tract 81, District of Columbia, District of Columbia",133,112,15,0,3,0,1,2,133,129,109,15,0,3,0,0,2,4,3,0,0,0,0,1,0,110010081003009,1,108,108,1,psa_17,1D2
1000000US110010016002003,"Block 2003, Block Group 2, Census Tract 16, District of Columbia, District of Columbia",63,26,19,0,1,0,4,13,63,60,26,19,0,1,0,4,10,3,0,0,0,0,0,0,3,110010016002003,4,401,401,4,psa_56,4D1
1000000US110010077071009,"Block 1009, Block Group 1, Census Tract 77.07, District of Columbia, District of Columbia",120,1,119,0,0,0,0,0,120,120,1,119,0,0,0,0,0,0,0,0,0,0,0,0,0,110010077071009,6,604,604,6,psa_14,6D3
1000000US110010099072005,"Block 2005, Block Group 2, Census Tract 99.07, District of Columbia, District of Columbia",451,0,430,0,4,1,0,16,451,446,0,430,0,4,1,0,11,5,0,0,0,0,0,0,5,110010099072005,6,604,604,6,psa_14,6D3
1000000US110010016001002,"Block 1002, Block Group 1, Census Tract 16, District of Columbia, District of Columbia",67,17,48,1,0,0,1,0,67,59,11,46,1,0,0,1,0,8,6,2,0,0,0,0,0,110010016001002,4,401,401,4,psa_56,4D1
1000000US110010103001006,"Block 1006, Block Group 1, Census Tract 103, District of Columbia, District of Columbia",0,0,0,0,0,0,0,0,0,0,0,0,0,0,0,0,0,0,0,0,0,0,0,0,0,110010103001006,4,401,401,4,psa_56,4D1
1000000US110010062021018,"Block 1018, Block Group 1, Census Tract 62.02, District of Columbia, District of Columbia",0,0,0,0,0,0,0,0,0,0,0,0,0,0,0,0,0,0,0,0,0,0,0,0,0,110010062021018,1,102,102,1,psa_18,1D1
1000000US110010074011023,"Block 1023, Block Group 1, Census Tract 74.01, District of Columbia, District of Columbia",0,0,0,0,0,0,0,0,0,0,0,0,0,0,0,0,0,0,0,0,0,0,0,0,0,110010074011023,7,703,703,7,psa_8,7D1
1000000US110010110002014,"Block 2014, Block Group 2, Census Tract 110, District of Columbia, District of Columbia",0,0,0,0,0,0,0,0,0,0,0,0,0,0,0,0,0,0,0,0,0,0,0,0,0,110010110002014,1,105,105,1,psa_22,1D3
1000000US110010069002007,"Block 2007, Block Group 2, Census Tract 69, District of Columbia, District of Columbia",13,12,0,0,1,0,0,0,13,13,12,0,0,1,0,0,0,0,0,0,0,0,0,0,0,110010069002007,1,106,106,1,psa_13,1D3
1000000US110010052014001,"Block 4001, Block Group 4, Census Tract 52.01, District of Columbia, District of Columbia",182,144,14,0,11,0,5,8,182,176,140,14,0,11,0,3,8,6,4,0,0,0,0,2,0,110010052014001,3,301,301,3,psa_31,3D3
1000000US110010098071010,"Block 1010, Block Group 1, Census Tract 98.07, District of Columbia, District of Columbia",0,0,0,0,0,0,0,0,0,0,0,0,0,0,0,0,0,0,0,0,0,0,0,0,0,110010098071010,7,708,708,7,psa_1,7D3
1000000US110010021022001,"Block 2001, Block Group 2, Census Tract 21.02, District of Columbia, District of Columbia",0,0,0,0,0,0,0,0,0,0,0,0,0,0,0,0,0,0,0,0,0,0,0,0,0,110010021022001,4,406,406,4,psa_54,4D2
1000000US110010078043011,"Block 3011, Block Group 3, Census Tract 78.04, District of Columbia, District of Columbia",26,0,26,0,0,0,0,0,26,26,0,26,0,0,0,0,0,0,0,0,0,0,0,0,0,110010078043011,6,608,608,6,psa_19,6D1
1000000US110010026002018,"Block 2018, Block Group 2, Census Tract 26, District of Columbia, District of Columbia",48,21,23,0,1,0,0,3,48,48,21,23,0,1,0,0,3,0,0,0,0,0,0,0,0,110010026002018,4,404,404,4,psa_48,4D3
1000000US110010091021007,"Block 1007, Block Group 1, Census Tract 91.02, District of Columbia, District of Columbia",91,4,81,1,3,0,0,2,91,85,1,78,1,3,0,0,2,6,3,3,0,0,0,0,0,110010091021007,5,505,505,5,psa_34,5D2
1000000US110010021025003,"Block 5003, Block Group 5, Census Tract 21.02, District of Columbia, District of Columbia",128,8,87,0,0,0,33,0,128,97,7,85,0,0,0,5,0,31,1,2,0,0,0,28,0,110010021025003,4,403,403,4,psa_51,4D1
1000000US110010075031007,"Block 1007, Block Group 1, Census Tract 75.03, District of Columbia, District of Columbia",13,0,13,0,0,0,0,0,13,13,0,13,0,0,0,0,0,0,0,0,0,0,0,0,0,110010075031007,7,701,701,7,psa_9,7D1
1000000US110010093013023,"Block 3023, Block Group 3, Census Tract 93.01, District of Columbia, District of Columbia",0,0,0,0,0,0,0,0,0,0,0,0,0,0,0,0,0,0,0,0,0,0,0,0,0,110010093013023,5,504,504,5,psa_43,5D2
1000000US110010004002007,"Block 2007, Block Group 2, Census Tract 4, District of Columbia, District of Columbia",32,29,0,0,1,0,0,2,32,21,20,0,0,1,0,0,0,11,9,0,0,0,0,0,2,110010004002007,2,204,204,2,psa_44,2D2
1000000US110010070001007,"Block 1007, Block Group 1, Census Tract 70, District of Columbia, District of Columbia",108,89,14,0,2,0,0,3,108,105,86,14,0,2,0,0,3,3,3,0,0,0,0,0,0,110010070001007,1,106,106,1,psa_13,1D3
1000000US110010068041023,"Block 1023, Block Group 1, Census Tract 68.04, District of Columbia, District of Columbia",0,0,0,0,0,0,0,0,0,0,0,0,0,0,0,0,0,0,0,0,0,0,0,0,0,110010068041023,1,108,108,1,psa_17,1D2
1000000US110010098101005,"Block 1005, Block Group 1, Census Tract 98.10, District of Columbia, District of Columbia",98,5,93,0,0,0,0,0,98,98,5,93,0,0,0,0,0,0,0,0,0,0,0,0,0,110010098101005,7,708,708,7,psa_1,7D3
1000000US110010009022003,"Block 2003, Block Group 2, Census Tract 9.02, District of Columbia, District of Columbia",0,0,0,0,0,0,0,0,0,0,0,0,0,0,0,0,0,0,0,0,0,0,0,0,0,110010009022003,2,205,205,2,psa_46,2D2
1000000US110010025011009,"Block 1009, Block Group 1, Census Tract 25.01, District of Columbia, District of Columbia",0,0,0,0,0,0,0,0,0,0,0,0,0,0,0,0,0,0,0,0,0,0,0,0,0,110010025011009,4,404,404,4,psa_48,4D3
1000000US110010076014006,"Block 4006, Block Group 4, Census Tract 76.01, District of Columbia, District of Columbia",59,0,59,0,0,0,0,0,59,59,0,59,0,0,0,0,0,0,0,0,0,0,0,0,0,110010076014006,6,607,607,6,psa_10,6D2
1000000US110010077091017,"Block 1017, Block Group 1, Census Tract 77.09, District of Columbia, District of Columbia",11,0,11,0,0,0,0,0,11,11,0,11,0,0,0,0,0,0,0,0,0,0,0,0,0,110010077091017,6,605,605,6,psa_11,6D2
1000000US110010097001013,"Block 1013, Block Group 1, Census Tract 97, District of Columbia, District of Columbia",106,0,106,0,0,0,0,0,106,106,0,106,0,0,0,0,0,0,0,0,0,0,0,0,0,110010097001013,7,706,706,7,psa_2,7D3
1000000US110010062021151,"Block 1151, Block Group 1, Census Tract 62.02, District of Columbia, District of Columbia",0,0,0,0,0,0,0,0,0,0,0,0,0,0,0,0,0,0,0,0,0,0,0,0,0,110010062021151,2,207,207,2,psa_24,2D3
1000000US110010077091013,"Block 1013, Block Group 1, Census Tract 77.09, District of Columbia, District of Columbia",66,0,65,1,0,0,0,0,66,64,0,63,1,0,0,0,0,2,0,2,0,0,0,0,0,110010077091013,6,605,605,6,psa_11,6D2
1000000US110010098033001,"Block 3001, Block Group 3, Census Tract 98.03, District of Columbia, District of Columbia",359,3,349,2,1,0,0,4,359,358,3,349,2,1,0,0,3,1,0,0,0,0,0,0,1,110010098033001,7,707,707,7,psa_4,7D2
1000000US110010040023002,"Block 3002, Block Group 3, Census Tract 40.02, District of Columbia, District of Columbia",0,0,0,0,0,0,0,0,0,0,0,0,0,0,0,0,0,0,0,0,0,0,0,0,0,110010040023002,3,303,303,3,psa_37,3D3
1000000US110010044001003,"Block 1003, Block Group 1, Census Tract 44, District of Columbia, District of Columbia",131,83,35,1,5,0,5,2,131,121,78,35,1,5,0,0,2,10,5,0,0,0,0,5,0,110010044001003,3,305,305,3,psa_32,3D2
1000000US110010002024017,"Block 4017, Block Group 4, Census Tract 2.02, District of Columbia, District of Columbia",0,0,0,0,0,0,0,0,0,0,0,0,0,0,0,0,0,0,0,0,0,0,0,0,0,110010002024017,2,206,206,2,psa_29,2D2
1000000US110010062021007,"Block 1007, Block Group 1, Census Tract 62.02, District of Columbia, District of Columbia",0,0,0,0,0,0,0,0,0,0,0,0,0,0,0,0,0,0,0,0,0,0,0,0,0,110010062021007,1,102,102,1,psa_18,1D1
1000000US110010019022015,"Block 2015, Block Group 2, Census Tract 19.02, District of Columbia, District of Columbia",65,10,47,0,3,0,1,4,65,64,10,47,0,3,0,1,3,1,0,0,0,0,0,0,1,110010019022015,4,402,402,4,psa_53,4D1
1000000US110010109002011,"Block 2011, Block Group 2, Census Tract 109, District of Columbia, District of Columbia",0,0,0,0,0,0,0,0,0,0,0,0,0,0,0,0,0,0,0,0,0,0,0,0,0,110010109002011,7,708,708,7,psa_1,7D3
1000000US110010011001005,"Block 1005, Block Group 1, Census Tract 11, District of Columbia, District of Columbia",34,28,4,1,1,0,0,0,34,33,28,4,0,1,0,0,0,1,0,0,1,0,0,0,0,110010011001005,2,201,201,2,psa_55,2D1
1000000US110010026002015,"Block 2015, Block Group 2, Census Tract 26, District of Columbia, District of Columbia",0,0,0,0,0,0,0,0,0,0,0,0,0,0,0,0,0,0,0,0,0,0,0,0,0,110010026002015,4,403,403,4,psa_51,4D1
1000000US110010095011005,"Block 1005, Block Group 1, Census Tract 95.01, District of Columbia, District of Columbia",185,9,155,0,0,0,19,2,185,162,5,155,0,0,0,0,2,23,4,0,0,0,0,19,0,110010095011005,4,405,405,4,psa_49,4D2
1000000US110010016004035,"Block 4035, Block Group 4, Census Tract 16, District of Columbia, District of Columbia",0,0,0,0,0,0,0,0,0,0,0,0,0,0,0,0,0,0,0,0,0,0,0,0,0,110010016004035,4,401,401,4,psa_56,4D1
1000000US110010048022001,"Block 2001, Block Group 2, Census Tract 48.02, District of Columbia, District of Columbia",707,52,386,8,210,0,37,14,707,652,41,385,2,210,0,1,13,55,11,1,6,0,0,36,1,110010048022001,3,308,308,3,psa_27,3D2
1000000US110010095033010,"Block 3010, Block Group 3, Census Tract 95.03, District of Columbia, District of Columbia",54,5,46,0,0,0,0,3,54,52,5,45,0,0,0,0,2,2,0,1,0,0,0,0,1,110010095033010,5,504,504,5,psa_43,5D2
1000000US110010098011011,"Block 1011, Block Group 1, Census Tract 98.01, District of Columbia, District of Columbia",0,0,0,0,0,0,0,0,0,0,0,0,0,0,0,0,0,0,0,0,0,0,0,0,0,110010098011011,7,707,707,7,psa_4,7D2
1000000US110010059001035,"Block 1035, Block Group 1, Census Tract 59, District of Columbia, District of Columbia",0,0,0,0,0,0,0,0,0,0,0,0,0,0,0,0,0,0,0,0,0,0,0,0,0,110010059001035,1,102,102,1,psa_18,1D1
1000000US110010082002019,"Block 2019, Block Group 2, Census Tract 82, District of Columbia, District of Columbia",46,38,0,0,2,0,0,6,46,41,36,0,0,2,0,0,3,5,2,0,0,0,0,0,3,110010082002019,1,108,108,1,psa_17,1D2
1000000US110010090001004,"Block 1004, Block Group 1, Census Tract 90, District of Columbia, District of Columbia",0,0,0,0,0,0,0,0,0,0,0,0,0,0,0,0,0,0,0,0,0,0,0,0,0,110010090001004,5,503,503,5,psa_45,5D2
1000000US110010094004009,"Block 4009, Block Group 4, Census Tract 94, District of Columbia, District of Columbia",37,3,32,0,1,0,0,1,37,34,2,30,0,1,0,0,1,3,1,2,0,0,0,0,0,110010094004009,5,503,503,5,psa_45,5D2
1000000US110010030002002,"Block 2002, Block Group 2, Census Tract 30, District of Columbia, District of Columbia",408,78,302,0,8,0,15,5,408,367,67,288,0,8,0,0,4,41,11,14,0,0,0,15,1,110010030002002,3,302,302,3,psa_42,3D1
1000000US110010036002002,"Block 2002, Block Group 2, Census Tract 36, District of Columbia, District of Columbia",528,138,250,4,37,0,86,13,528,371,87,238,1,37,0,1,7,157,51,12,3,0,0,85,6,110010036002002,3,304,304,3,psa_36,3D1
1000000US110010065002002,"Block 2002, Block Group 2, Census Tract 65, District of Columbia, District of Columbia",120,78,22,4,5,0,4,7,120,109,75,21,4,5,0,0,4,11,3,1,0,0,0,4,3,110010065002002,1,107,107,1,psa_16,1D2
1000000US110010018032001,"Block 2001, Block Group 2, Census Tract 18.03, District of Columbia, District of Columbia",530,56,322,0,1,0,138,13,530,341,17,318,0,1,0,2,3,189,39,4,0,0,0,136,10,110010018032001,4,402,402,4,psa_53,4D1
1000000US110010069002010,"Block 2010, Block Group 2, Census Tract 69, District of Columbia, District of Columbia",0,0,0,0,0,0,0,0,0,0,0,0,0,0,0,0,0,0,0,0,0,0,0,0,0,110010069002010,1,106,106,1,psa_13,1D3
1000000US110010080021004,"Block 1004, Block Group 1, Census Tract 80.02, District of Columbia, District of Columbia",112,31,75,0,0,0,2,4,112,110,31,75,0,0,0,0,4,2,0,0,0,0,0,2,0,110010080021004,1,108,108,1,psa_17,1D2
1000000US110010095051000,"Block 1000, Block Group 1, Census Tract 95.05, District of Columbia, District of Columbia",0,0,0,0,0,0,0,0,0,0,0,0,0,0,0,0,0,0,0,0,0,0,0,0,0,110010095051000,4,406,406,4,psa_54,4D2
1000000US110010023011014,"Block 1014, Block Group 1, Census Tract 23.01, District of Columbia, District of Columbia",0,0,0,0,0,0,0,0,0,0,0,0,0,0,0,0,0,0,0,0,0,0,0,0,0,110010023011014,4,407,407,4,psa_47,4D2
1000000US110010073011082,"Block 1082, Block Group 1, Census Tract 73.01, District of Columbia, District of Columbia",151,94,40,3,2,0,5,7,151,133,84,40,2,2,0,0,5,18,10,0,1,0,0,5,2,110010073011082,7,707,707,7,psa_4,7D2
1000000US110010010012030,"Block 2030, Block Group 2, Census Tract 10.01, District of Columbia, District of Columbia",183,137,34,1,2,0,0,9,183,176,130,34,1,2,0,0,9,7,7,0,0,0,0,0,0,110010010012030,2,202,202,2,psa_52,2D1
1000000US110010080022013,"Block 2013, Block Group 2, Census Tract 80.02, District of Columbia, District of Columbia",117,91,18,0,2,0,2,4,117,111,88,18,0,2,0,0,3,6,3,0,0,0,0,2,1,110010080022013,1,108,108,1,psa_17,1D2
1000000US110010078062010,"Block 2010, Block Group 2, Census Tract 78.06, District of Columbia, District of Columbia",31,1,30,0,0,0,0,0,31,30,0,30,0,0,0,0,0,1,1,0,0,0,0,0,0,110010078062010,6,602,602,6,psa_25,6D1
1000000US110010088023004,"Block 3004, Block Group 3, Census Tract 88.02, District of Columbia, District of Columbia",219,44,163,0,3,0,4,5,219,211,41,163,0,3,0,0,4,8,3,0,0,0,0,4,1,110010088023004,5,506,506,5,psa_26,5D3
1000000US110010111001020,"Block 1020, Block Group 1, Census Tract 111, District of Columbia, District of Columbia",40,2,38,0,0,0,0,0,40,40,2,38,0,0,0,0,0,0,0,0,0,0,0,0,0,110010111001020,5,503,503,5,psa_45,5D2
1000000US110010002021006,"Block 1006, Block Group 1, Census Tract 2.02, District of Columbia, District of Columbia",126,110,5,2,2,0,3,4,126,114,103,5,0,2,0,2,2,12,7,0,2,0,0,1,2,110010002021006,2,206,206,2,psa_29,2D2
1000000US110010027021001,"Block 1001, Block Group 1, Census Tract 27.02, District of Columbia, District of Columbia",0,0,0,0,0,0,0,0,0,0,0,0,0,0,0,0,0,0,0,0,0,0,0,0,0,110010027021001,3,302,302,3,psa_42,3D1
1000000US110010065002001,"Block 2001, Block Group 2, Census Tract 65, District of Columbia, District of Columbia",85,69,13,0,3,0,0,0,85,84,68,13,0,3,0,0,0,1,1,0,0,0,0,0,0,110010065002001,1,107,107,1,psa_16,1D2
1000000US110010065002017,"Block 2017, Block Group 2, Census Tract 65, District of Columbia, District of Columbia",0,0,0,0,0,0,0,0,0,0,0,0,0,0,0,0,0,0,0,0,0,0,0,0,0,110010065002017,1,107,107,1,psa_16,1D2
1000000US110010016004016,"Block 4016, Block Group 4, Census Tract 16, District of Columbia, District of Columbia",74,23,47,0,1,0,0,3,74,72,22,46,0,1,0,0,3,2,1,1,0,0,0,0,0,110010016004016,4,401,401,4,psa_56,4D1
1000000US110010107002017,"Block 2017, Block Group 2, Census Tract 107, District of Columbia, District of Columbia",0,0,0,0,0,0,0,0,0,0,0,0,0,0,0,0,0,0,0,0,0,0,0,0,0,110010107002017,2,208,208,2,psa_33,2D3
1000000US110010002022000,"Block 2000, Block Group 2, Census Tract 2.02, District of Columbia, District of Columbia",91,90,0,0,0,0,0,1,91,88,87,0,0,0,0,0,1,3,3,0,0,0,0,0,0,110010002022000,2,206,206,2,psa_29,2D2
1000000US110010072001008,"Block 1008, Block Group 1, Census Tract 72, District of Columbia, District of Columbia",0,0,0,0,0,0,0,0,0,0,0,0,0,0,0,0,0,0,0,0,0,0,0,0,0,110010072001008,1,106,106,1,psa_13,1D3
1000000US110010067003006,"Block 3006, Block Group 3, Census Tract 67, District of Columbia, District of Columbia",123,115,2,1,3,0,0,2,123,115,107,2,1,3,0,0,2,8,8,0,0,0,0,0,0,110010067003006,1,107,107,1,psa_16,1D2
1000000US110010048021005,"Block 1005, Block Group 1, Census Tract 48.02, District of Columbia, District of Columbia",46,12,17,0,12,0,5,0,46,39,10,17,0,12,0,0,0,7,2,0,0,0,0,5,0,110010048021005,3,308,308,3,psa_27,3D2
1000000US110010002024007,"Block 4007, Block Group 4, Census Tract 2.02, District of Columbia, District of Columbia",0,0,0,0,0,0,0,0,0,0,0,0,0,0,0,0,0,0,0,0,0,0,0,0,0,110010002024007,2,206,206,2,psa_29,2D2
1000000US110010022012012,"Block 2012, Block Group 2, Census Tract 22.01, District of Columbia, District of Columbia",0,0,0,0,0,0,0,0,0,0,0,0,0,0,0,0,0,0,0,0,0,0,0,0,0,110010022012012,4,407,407,4,psa_47,4D2
1000000US110010067002005,"Block 2005, Block Group 2, Census Tract 67, District of Columbia, District of Columbia",110,106,2,0,1,0,0,1,110,105,101,2,0,1,0,0,1,5,5,0,0,0,0,0,0,110010067002005,1,107,107,1,psa_16,1D2
1000000US110010078072006,"Block 2006, Block Group 2, Census Tract 78.07, District of Columbia, District of Columbia",74,1,66,0,1,0,2,4,74,72,1,66,0,1,0,0,4,2,0,0,0,0,0,2,0,110010078072006,6,608,608,6,psa_19,6D1
1000000US110010080022011,"Block 2011, Block Group 2, Census Tract 80.02, District of Columbia, District of Columbia",166,103,38,1,9,0,7,8,166,154,98,38,1,9,0,2,6,12,5,0,0,0,0,5,2,110010080022011,1,108,108,1,psa_17,1D2
1000000US110010020012010,"Block 2010, Block Group 2, Census Tract 20.01, District of Columbia, District of Columbia",266,114,121,0,12,0,1,18,266,255,109,118,0,12,0,0,16,11,5,3,0,0,0,1,2,110010020012010,4,403,403,4,psa_51,4D1
1000000US110010072001019,"Block 1019, Block Group 1, Census Tract 72, District of Columbia, District of Columbia",0,0,0,0,0,0,0,0,0,0,0,0,0,0,0,0,0,0,0,0,0,0,0,0,0,110010072001019,1,106,106,1,psa_13,1D3
1000000US110010046002005,"Block 2005, Block Group 2, Census Tract 46, District of Columbia, District of Columbia",0,0,0,0,0,0,0,0,0,0,0,0,0,0,0,0,0,0,0,0,0,0,0,0,0,110010046002005,3,306,306,3,psa_38,3D2
1000000US110010062021198,"Block 1198, Block Group 1, Census Tract 62.02, District of Columbia, District of Columbia",0,0,0,0,0,0,0,0,0,0,0,0,0,0,0,0,0,0,0,0,0,0,0,0,0,110010062021198,1,103,103,1,psa_12,1D1
1000000US110010006003005,"Block 3005, Block Group 3, Census Tract 6, District of Columbia, District of Columbia",68,60,2,0,1,0,2,3,68,62,54,2,0,1,0,2,3,6,6,0,0,0,0,0,0,110010006003005,2,204,204,2,psa_44,2D2
1000000US110010106002020,"Block 2020, Block Group 2, Census Tract 106, District of Columbia, District of Columbia",0,0,0,0,0,0,0,0,0,0,0,0,0,0,0,0,0,0,0,0,0,0,0,0,0,110010106002020,5,501,501,5,psa_35,5D1
1000000US110010095091001,"Block 1001, Block Group 1, Census Tract 95.09, District of Columbia, District of Columbia",123,13,110,0,0,0,0,0,123,111,5,106,0,0,0,0,0,12,8,4,0,0,0,0,0,110010095091001,4,405,405,4,psa_49,4D2
1000000US110010001002000,"Block 2000, Block Group 2, Census Tract 1, District of Columbia, District of Columbia",609,553,13,0,27,1,4,11,609,582,531,13,0,25,1,2,10,27,22,0,0,2,0,2,1,110010001002000,2,206,206,2,psa_29,2D2
1000000US110010008022003,"Block 2003, Block Group 2, Census Tract 8.02, District of Columbia, District of Columbia",1,0,1,0,0,0,0,0,1,1,0,1,0,0,0,0,0,0,0,0,0,0,0,0,0,110010008022003,2,205,205,2,psa_46,2D2
1000000US110010077072000,"Block 2000, Block Group 2, Census Tract 77.07, District of Columbia, District of Columbia",92,0,86,0,0,0,6,0,92,83,0,82,0,0,0,1,0,9,0,4,0,0,0,5,0,110010077072000,6,604,604,6,psa_14,6D3
1000000US110010079011000,"Block 1000, Block Group 1, Census Tract 79.01, District of Columbia, District of Columbia",51,5,45,0,1,0,0,0,51,51,5,45,0,1,0,0,0,0,0,0,0,0,0,0,0,110010079011000,5,507,507,5,psa_23,5D3
1000000US110010080022009,"Block 2009, Block Group 2, Census Tract 80.02, District of Columbia, District of Columbia",69,34,29,0,4,0,0,2,69,66,33,28,0,4,0,0,1,3,1,1,0,0,0,0,1,110010080022009,1,108,108,1,psa_17,1D2
1000000US110010104001017,"Block 1017, Block Group 1, Census Tract 104, District of Columbia, District of Columbia",142,4,136,0,0,0,1,1,142,141,4,136,0,0,0,0,1,1,0,0,0,0,0,1,0,110010104001017,7,707,707,7,psa_4,7D2
1000000US110010008013018,"Block 3018, Block Group 3, Census Tract 8.01, District of Columbia, District of Columbia",26,23,0,0,3,0,0,0,26,26,23,0,0,3,0,0,0,0,0,0,0,0,0,0,0,110010008013018,2,205,205,2,psa_46,2D2
1000000US110010072002003,"Block 2003, Block Group 2, Census Tract 72, District of Columbia, District of Columbia",0,0,0,0,0,0,0,0,0,0,0,0,0,0,0,0,0,0,0,0,0,0,0,0,0,110010072002003,1,106,106,1,psa_13,1D3
1000000US110010013023008,"Block 3008, Block Group 3, Census Tract 13.02, District of Columbia, District of Columbia",282,235,11,0,25,0,2,9,282,273,228,11,0,25,0,1,8,9,7,0,0,0,0,1,1,110010013023008,2,203,203,2,psa_50,2D1
1000000US110010073011140,"Block 1140, Block Group 1, Census Tract 73.01, District of Columbia, District of Columbia",33,12,15,0,0,0,0,6,33,32,11,15,0,0,0,0,6,1,1,0,0,0,0,0,0,110010073011140,7,707,707,7,psa_4,7D2
1000000US110010006004012,"Block 4012, Block Group 4, Census Tract 6, District of Columbia, District of Columbia",255,228,4,0,6,0,7,10,255,239,218,4,0,6,0,3,8,16,10,0,0,0,0,4,2,110010006004012,2,203,203,2,psa_50,2D1
1000000US110010102001020,"Block 1020, Block Group 1, Census Tract 102, District of Columbia, District of Columbia",89,52,33,0,4,0,0,0,89,81,44,33,0,4,0,0,0,8,8,0,0,0,0,0,0,110010102001020,1,103,103,1,psa_12,1D1
1000000US110010076015010,"Block 5010, Block Group 5, Census Tract 76.01, District of Columbia, District of Columbia",0,0,0,0,0,0,0,0,0,0,0,0,0,0,0,0,0,0,0,0,0,0,0,0,0,110010076015010,6,607,607,6,psa_10,6D2
1000000US110010056001011,"Block 1011, Block Group 1, Census Tract 56, District of Columbia, District of Columbia",0,0,0,0,0,0,0,0,0,0,0,0,0,0,0,0,0,0,0,0,0,0,0,0,0,110010056001011,2,206,206,2,psa_29,2D2
1000000US110010073042000,"Block 2000, Block Group 2, Census Tract 73.04, District of Columbia, District of Columbia",130,3,126,0,1,0,0,0,130,126,3,122,0,1,0,0,0,4,0,4,0,0,0,0,0,110010073042000,7,705,705,7,psa_3,7D2
1000000US110010023011009,"Block 1009, Block Group 1, Census Tract 23.01, District of Columbia, District of Columbia",52,12,28,0,4,0,5,3,52,46,11,28,0,4,0,0,3,6,1,0,0,0,0,5,0,110010023011009,4,407,407,4,psa_47,4D2
1000000US110010105001001,"Block 1001, Block Group 1, Census Tract 105, District of Columbia, District of Columbia",639,201,342,2,51,0,12,31,639,592,185,332,2,51,0,4,18,47,16,10,0,0,0,8,13,110010105001001,1,103,103,1,psa_12,1D1
1000000US110010099041008,"Block 1008, Block Group 1, Census Tract 99.04, District of Columbia, District of Columbia",31,0,19,0,0,0,12,0,31,15,0,15,0,0,0,0,0,16,0,4,0,0,0,12,0,110010099041008,6,604,604,6,psa_14,6D3
1000000US110010110002000,"Block 2000, Block Group 2, Census Tract 110, District of Columbia, District of Columbia",832,550,219,2,36,0,7,18,832,804,532,218,2,36,0,2,14,28,18,1,0,0,0,5,4,110010110002000,1,103,103,1,psa_12,1D1
1000000US110010017021022,"Block 1022, Block Group 1, Census Tract 17.02, District of Columbia, District of Columbia",0,0,0,0,0,0,0,0,0,0,0,0,0,0,0,0,0,0,0,0,0,0,0,0,0,110010017021022,4,401,401,4,psa_56,4D1
1000000US110010040013010,"Block 3010, Block Group 3, Census Tract 40.01, District of Columbia, District of Columbia",0,0,0,0,0,0,0,0,0,0,0,0,0,0,0,0,0,0,0,0,0,0,0,0,0,110010040013010,2,204,204,2,psa_44,2D2
1000000US110010091022017,"Block 2017, Block Group 2, Census Tract 91.02, District of Columbia, District of Columbia",0,0,0,0,0,0,0,0,0,0,0,0,0,0,0,0,0,0,0,0,0,0,0,0,0,110010091022017,5,505,505,5,psa_34,5D2
1000000US110010021026000,"Block 6000, Block Group 6, Census Tract 21.02, District of Columbia, District of Columbia",19,0,15,0,0,0,0,4,19,19,0,15,0,0,0,0,4,0,0,0,0,0,0,0,0,110010021026000,4,402,402,4,psa_53,4D1
1000000US110010025012009,"Block 2009, Block Group 2, Census Tract 25.01, District of Columbia, District of Columbia",144,39,72,0,1,0,32,0,144,104,36,65,0,1,0,2,0,40,3,7,0,0,0,30,0,110010025012009,4,404,404,4,psa_48,4D3
1000000US110010083021014,"Block 1014, Block Group 1, Census Tract 83.02, District of Columbia, District of Columbia",171,138,18,4,7,0,0,4,171,164,135,18,2,7,0,0,2,7,3,0,2,0,0,0,2,110010083021014,1,108,108,1,psa_17,1D2
1000000US110010062021005,"Block 1005, Block Group 1, Census Tract 62.02, District of Columbia, District of Columbia",0,0,0,0,0,0,0,0,0,0,0,0,0,0,0,0,0,0,0,0,0,0,0,0,0,110010062021005,1,102,102,1,psa_18,1D1
1000000US110010095013000,"Block 3000, Block Group 3, Census Tract 95.01, District of Columbia, District of Columbia",137,8,119,0,0,0,1,9,137,130,8,119,0,0,0,0,3,7,0,0,0,0,0,1,6,110010095013000,4,405,405,4,psa_49,4D2
1000000US110010012003010,"Block 3010, Block Group 3, Census Tract 12, District of Columbia, District of Columbia",67,58,4,0,1,0,2,2,67,63,55,4,0,1,0,1,2,4,3,0,0,0,0,1,0,110010012003010,2,203,203,2,psa_50,2D1
1000000US110010071001024,"Block 1024, Block Group 1, Census Tract 71, District of Columbia, District of Columbia",0,0,0,0,0,0,0,0,0,0,0,0,0,0,0,0,0,0,0,0,0,0,0,0,0,110010071001024,1,106,106,1,psa_13,1D3
1000000US110010095052014,"Block 2014, Block Group 2, Census Tract 95.05, District of Columbia, District of Columbia",0,0,0,0,0,0,0,0,0,0,0,0,0,0,0,0,0,0,0,0,0,0,0,0,0,110010095052014,4,406,406,4,psa_54,4D2
1000000US110010006004016,"Block 4016, Block Group 4, Census Tract 6, District of Columbia, District of Columbia",47,33,2,0,9,0,0,3,47,46,32,2,0,9,0,0,3,1,1,0,0,0,0,0,0,110010006004016,2,203,203,2,psa_50,2D1
1000000US110010012004015,"Block 4015, Block Group 4, Census Tract 12, District of Columbia, District of Columbia",54,50,0,0,2,0,0,2,54,50,46,0,0,2,0,0,2,4,4,0,0,0,0,0,0,110010012004015,2,202,202,2,psa_52,2D1
1000000US110010013013004,"Block 3004, Block Group 3, Census Tract 13.01, District of Columbia, District of Columbia",28,28,0,0,0,0,0,0,28,28,28,0,0,0,0,0,0,0,0,0,0,0,0,0,0,110010013013004,2,203,203,2,psa_50,2D1
1000000US110010091022014,"Block 2014, Block Group 2, Census Tract 91.02, District of Columbia, District of Columbia",0,0,0,0,0,0,0,0,0,0,0,0,0,0,0,0,0,0,0,0,0,0,0,0,0,110010091022014,5,505,505,5,psa_34,5D2
1000000US110010079031008,"Block 1008, Block Group 1, Census Tract 79.03, District of Columbia, District of Columbia",109,6,99,0,2,0,2,0,109,108,6,99,0,2,0,1,0,1,0,0,0,0,0,1,0,110010079031008,5,507,507,5,psa_23,5D3
1000000US110010053013000,"Block 3000, Block Group 3, Census Tract 53.01, District of Columbia, District of Columbia",230,178,5,2,31,0,7,7,230,203,162,5,1,31,0,1,3,27,16,0,1,0,0,6,4,110010053013000,2,208,208,2,psa_33,2D3
1000000US110010096011022,"Block 1022, Block Group 1, Census Tract 96.01, District of Columbia, District of Columbia",42,0,42,0,0,0,0,0,42,42,0,42,0,0,0,0,0,0,0,0,0,0,0,0,0,110010096011022,6,601,601,6,psa_30,6D1
1000000US110010004001010,"Block 1010, Block Group 1, Census Tract 4, District of Columbia, District of Columbia",0,0,0,0,0,0,0,0,0,0,0,0,0,0,0,0,0,0,0,0,0,0,0,0,0,110010004001010,2,204,204,2,psa_44,2D2
1000000US110010047021010,"Block 1010, Block Group 1, Census Tract 47.02, District of Columbia, District of Columbia",0,0,0,0,0,0,0,0,0,0,0,0,0,0,0,0,0,0,0,0,0,0,0,0,0,110010047021010,1,101,101,1,psa_20,1D1
1000000US110010058002001,"Block 2001, Block Group 2, Census Tract 58, District of Columbia, District of Columbia",16,0,0,0,16,0,0,0,16,16,0,0,0,16,0,0,0,0,0,0,0,0,0,0,0,110010058002001,1,101,101,1,psa_20,1D1
1000000US110010078061012,"Block 1012, Block Group 1, Census Tract 78.06, District of Columbia, District of Columbia",81,0,79,0,0,0,1,1,81,80,0,79,0,0,0,0,1,1,0,0,0,0,0,1,0,110010078061012,6,602,602,6,psa_25,6D1
1000000US110010015001034,"Block 1034, Block Group 1, Census Tract 15, District of Columbia, District of Columbia",0,0,0,0,0,0,0,0,0,0,0,0,0,0,0,0,0,0,0,0,0,0,0,0,0,110010015001034,2,201,201,2,psa_55,2D1
1000000US110010013013007,"Block 3007, Block Group 3, Census Tract 13.01, District of Columbia, District of Columbia",489,377,44,1,44,0,10,13,489,442,340,43,0,44,0,3,12,47,37,1,1,0,0,7,1,110010013013007,2,203,203,2,psa_50,2D1
1000000US110010095041010,"Block 1010, Block Group 1, Census Tract 95.04, District of Columbia, District of Columbia",26,9,17,0,0,0,0,0,26,23,6,17,0,0,0,0,0,3,3,0,0,0,0,0,0,110010095041010,4,405,405,4,psa_49,4D2
1000000US110010010022006,"Block 2006, Block Group 2, Census Tract 10.02, District of Columbia, District of Columbia",141,87,7,1,28,0,9,9,141,113,72,6,1,28,0,0,6,28,15,1,0,0,0,9,3,110010010022006,2,204,204,2,psa_44,2D2
1000000US110010016002007,"Block 2007, Block Group 2, Census Tract 16, District of Columbia, District of Columbia",172,27,102,0,3,0,28,12,172,129,18,98,0,3,0,1,9,43,9,4,0,0,0,27,3,110010016002007,4,401,401,4,psa_56,4D1
1000000US110010078092002,"Block 2002, Block Group 2, Census Tract 78.09, District of Columbia, District of Columbia",48,0,42,2,0,0,0,4,48,47,0,41,2,0,0,0,4,1,0,1,0,0,0,0,0,110010078092002,6,602,602,6,psa_25,6D1
1000000US110010010023006,"Block 3006, Block Group 3, Census Tract 10.02, District of Columbia, District of Columbia",637,550,31,2,29,0,6,19,637,596,514,31,1,29,0,2,19,41,36,0,1,0,0,4,0,110010010023006,2,204,204,2,psa_44,2D2
1000000US110010109002021,"Block 2021, Block Group 2, Census Tract 109, District of Columbia, District of Columbia",0,0,0,0,0,0,0,0,0,0,0,0,0,0,0,0,0,0,0,0,0,0,0,0,0,110010109002021,7,708,708,7,psa_1,7D3
1000000US110010062021088,"Block 1088, Block Group 1, Census Tract 62.02, District of Columbia, District of Columbia",0,0,0,0,0,0,0,0,0,0,0,0,0,0,0,0,0,0,0,0,0,0,0,0,0,110010062021088,2,207,207,2,psa_24,2D3
1000000US110010078043012,"Block 3012, Block Group 3, Census Tract 78.04, District of Columbia, District of Columbia",49,0,39,2,1,0,0,7,49,43,0,39,2,1,0,0,1,6,0,0,0,0,0,0,6,110010078043012,6,608,608,6,psa_19,6D1
1000000US110010106002053,"Block 2053, Block Group 2, Census Tract 106, District of Columbia, District of Columbia",0,0,0,0,0,0,0,0,0,0,0,0,0,0,0,0,0,0,0,0,0,0,0,0,0,110010106002053,1,102,102,1,psa_18,1D1
1000000US110010095032011,"Block 2011, Block Group 2, Census Tract 95.03, District of Columbia, District of Columbia",62,37,23,0,2,0,0,0,62,53,32,19,0,2,0,0,0,9,5,4,0,0,0,0,0,110010095032011,5,504,504,5,psa_43,5D2
1000000US110010074011012,"Block 1012, Block Group 1, Census Tract 74.01, District of Columbia, District of Columbia",0,0,0,0,0,0,0,0,0,0,0,0,0,0,0,0,0,0,0,0,0,0,0,0,0,110010074011012,7,701,701,7,psa_9,7D1
1000000US110010078033002,"Block 3002, Block Group 3, Census Tract 78.03, District of Columbia, District of Columbia",25,0,25,0,0,0,0,0,25,22,0,22,0,0,0,0,0,3,0,3,0,0,0,0,0,110010078033002,6,602,602,6,psa_25,6D1
1000000US110010096032007,"Block 2007, Block Group 2, Census Tract 96.03, District of Columbia, District of Columbia",167,0,160,0,0,0,1,6,167,166,0,160,0,0,0,0,6,1,0,0,0,0,0,1,0,110010096032007,6,603,603,6,psa_15,6D3
1000000US110010010014024,"Block 4024, Block Group 4, Census Tract 10.01, District of Columbia, District of Columbia",66,60,0,0,6,0,0,0,66,61,55,0,0,6,0,0,0,5,5,0,0,0,0,0,0,110010010014024,2,202,202,2,psa_52,2D1
1000000US110010017022003,"Block 2003, Block Group 2, Census Tract 17.02, District of Columbia, District of Columbia",0,0,0,0,0,0,0,0,0,0,0,0,0,0,0,0,0,0,0,0,0,0,0,0,0,110010017022003,4,401,401,4,psa_56,4D1
1000000US110010019011010,"Block 1010, Block Group 1, Census Tract 19.01, District of Columbia, District of Columbia",0,0,0,0,0,0,0,0,0,0,0,0,0,0,0,0,0,0,0,0,0,0,0,0,0,110010019011010,4,402,402,4,psa_53,4D1
1000000US110010072002062,"Block 2062, Block Group 2, Census Tract 72, District of Columbia, District of Columbia",0,0,0,0,0,0,0,0,0,0,0,0,0,0,0,0,0,0,0,0,0,0,0,0,0,110010072002062,1,106,106,1,psa_13,1D3
1000000US110010099011010,"Block 1010, Block Group 1, Census Tract 99.01, District of Columbia, District of Columbia",9,0,9,0,0,0,0,0,9,9,0,9,0,0,0,0,0,0,0,0,0,0,0,0,0,110010099011010,6,605,605,6,psa_11,6D2
1000000US110010020011004,"Block 1004, Block Group 1, Census Tract 20.01, District of Columbia, District of Columbia",227,32,120,4,4,0,56,11,227,155,24,119,4,4,0,0,4,72,8,1,0,0,0,56,7,110010020011004,4,403,403,4,psa_51,4D1
1000000US110010076042012,"Block 2012, Block Group 2, Census Tract 76.04, District of Columbia, District of Columbia",21,1,20,0,0,0,0,0,21,21,1,20,0,0,0,0,0,0,0,0,0,0,0,0,0,110010076042012,6,606,606,6,psa_7,6D2
1000000US110010109002014,"Block 2014, Block Group 2, Census Tract 109, District of Columbia, District of Columbia",0,0,0,0,0,0,0,0,0,0,0,0,0,0,0,0,0,0,0,0,0,0,0,0,0,110010109002014,7,708,708,7,psa_1,7D3
1000000US110010041003030,"Block 3030, Block Group 3, Census Tract 41, District of Columbia, District of Columbia",2,2,0,0,0,0,0,0,2,2,2,0,0,0,0,0,0,0,0,0,0,0,0,0,0,110010041003030,2,208,208,2,psa_33,2D3
1000000US110010059001007,"Block 1007, Block Group 1, Census Tract 59, District of Columbia, District of Columbia",0,0,0,0,0,0,0,0,0,0,0,0,0,0,0,0,0,0,0,0,0,0,0,0,0,110010059001007,1,101,101,1,psa_20,1D1
1000000US110010076015013,"Block 5013, Block Group 5, Census Tract 76.01, District of Columbia, District of Columbia",0,0,0,0,0,0,0,0,0,0,0,0,0,0,0,0,0,0,0,0,0,0,0,0,0,110010076015013,6,607,607,6,psa_10,6D2
1000000US110010089032003,"Block 2003, Block Group 2, Census Tract 89.03, District of Columbia, District of Columbia",39,0,38,0,0,0,0,1,39,37,0,37,0,0,0,0,0,2,0,1,0,0,0,0,1,110010089032003,5,507,507,5,psa_23,5D3
1000000US110010078071007,"Block 1007, Block Group 1, Census Tract 78.07, District of Columbia, District of Columbia",197,0,186,0,1,0,9,1,197,192,0,186,0,1,0,4,1,5,0,0,0,0,0,5,0,110010078071007,6,608,608,6,psa_19,6D1
1000000US110010014012020,"Block 2020, Block Group 2, Census Tract 14.01, District of Columbia, District of Columbia",69,59,0,0,0,0,10,0,69,59,58,0,0,0,0,1,0,10,1,0,0,0,0,9,0,110010014012020,2,201,201,2,psa_55,2D1
1000000US110010096042011,"Block 2011, Block Group 2, Census Tract 96.04, District of Columbia, District of Columbia",0,0,0,0,0,0,0,0,0,0,0,0,0,0,0,0,0,0,0,0,0,0,0,0,0,110010096042011,6,603,603,6,psa_15,6D3
1000000US110010078071005,"Block 1005, Block Group 1, Census Tract 78.07, District of Columbia, District of Columbia",16,0,16,0,0,0,0,0,16,16,0,16,0,0,0,0,0,0,0,0,0,0,0,0,0,110010078071005,6,608,608,6,psa_19,6D1
1000000US110010022023002,"Block 3002, Block Group 3, Census Tract 22.02, District of Columbia, District of Columbia",57,1,51,0,0,0,5,0,57,52,1,51,0,0,0,0,0,5,0,0,0,0,0,5,0,110010022023002,4,407,407,4,psa_47,4D2
1000000US110010062021200,"Block 1200, Block Group 1, Census Tract 62.02, District of Columbia, District of Columbia",0,0,0,0,0,0,0,0,0,0,0,0,0,0,0,0,0,0,0,0,0,0,0,0,0,110010062021200,1,103,103,1,psa_12,1D1
1000000US110010074081003,"Block 1003, Block Group 1, Census Tract 74.08, District of Columbia, District of Columbia",284,1,276,2,0,0,0,5,284,284,1,276,2,0,0,0,5,0,0,0,0,0,0,0,0,110010074081003,7,702,702,7,psa_6,7D1
1000000US110010077033000,"Block 3000, Block Group 3, Census Tract 77.03, District of Columbia, District of Columbia",112,1,110,1,0,0,0,0,112,107,1,105,1,0,0,0,0,5,0,5,0,0,0,0,0,110010077033000,6,603,603,6,psa_15,6D3
1000000US110010096042010,"Block 2010, Block Group 2, Census Tract 96.04, District of Columbia, District of Columbia",0,0,0,0,0,0,0,0,0,0,0,0,0,0,0,0,0,0,0,0,0,0,0,0,0,110010096042010,6,603,603,6,psa_15,6D3
1000000US110010011004018,"Block 4018, Block Group 4, Census Tract 11, District of Columbia, District of Columbia",0,0,0,0,0,0,0,0,0,0,0,0,0,0,0,0,0,0,0,0,0,0,0,0,0,110010011004018,2,202,202,2,psa_52,2D1
1000000US110010073011056,"Block 1056, Block Group 1, Census Tract 73.01, District of Columbia, District of Columbia",0,0,0,0,0,0,0,0,0,0,0,0,0,0,0,0,0,0,0,0,0,0,0,0,0,110010073011056,7,708,708,7,psa_1,7D3
1000000US110010030001004,"Block 1004, Block Group 1, Census Tract 30, District of Columbia, District of Columbia",0,0,0,0,0,0,0,0,0,0,0,0,0,0,0,0,0,0,0,0,0,0,0,0,0,110010030001004,3,302,302,3,psa_42,3D1
1000000US110010053013005,"Block 3005, Block Group 3, Census Tract 53.01, District of Columbia, District of Columbia",0,0,0,0,0,0,0,0,0,0,0,0,0,0,0,0,0,0,0,0,0,0,0,0,0,110010053013005,2,208,208,2,psa_33,2D3
1000000US110010003003009,"Block 3009, Block Group 3, Census Tract 3, District of Columbia, District of Columbia",0,0,0,0,0,0,0,0,0,0,0,0,0,0,0,0,0,0,0,0,0,0,0,0,0,110010003003009,2,206,206,2,psa_29,2D2
1000000US110010012001012,"Block 1012, Block Group 1, Census Tract 12, District of Columbia, District of Columbia",51,47,0,0,3,0,1,0,51,48,44,0,0,3,0,1,0,3,3,0,0,0,0,0,0,110010012001012,2,203,203,2,psa_50,2D1
1000000US110010018042011,"Block 2011, Block Group 2, Census Tract 18.04, District of Columbia, District of Columbia",37,0,36,0,1,0,0,0,37,37,0,36,0,1,0,0,0,0,0,0,0,0,0,0,0,110010018042011,4,402,402,4,psa_53,4D1
1000000US110010111003051,"Block 3051, Block Group 3, Census Tract 111, District of Columbia, District of Columbia",0,0,0,0,0,0,0,0,0,0,0,0,0,0,0,0,0,0,0,0,0,0,0,0,0,110010111003051,5,507,507,5,psa_23,5D3
1000000US110010018031003,"Block 1003, Block Group 1, Census Tract 18.03, District of Columbia, District of Columbia",130,13,112,1,0,0,2,2,130,125,13,110,0,0,0,0,2,5,0,2,1,0,0,2,0,110010018031003,4,402,402,4,psa_53,4D1
1000000US110010094003002,"Block 3002, Block Group 3, Census Tract 94, District of Columbia, District of Columbia",71,3,67,0,0,0,1,0,71,71,3,67,0,0,0,1,0,0,0,0,0,0,0,0,0,110010094003002,5,503,503,5,psa_45,5D2
1000000US110010095081000,"Block 1000, Block Group 1, Census Tract 95.08, District of Columbia, District of Columbia",0,0,0,0,0,0,0,0,0,0,0,0,0,0,0,0,0,0,0,0,0,0,0,0,0,110010095081000,4,406,406,4,psa_54,4D2
1000000US110010096021008,"Block 1008, Block Group 1, Census Tract 96.02, District of Columbia, District of Columbia",0,0,0,0,0,0,0,0,0,0,0,0,0,0,0,0,0,0,0,0,0,0,0,0,0,110010096021008,6,601,601,6,psa_30,6D1
1000000US110010062021197,"Block 1197, Block Group 1, Census Tract 62.02, District of Columbia, District of Columbia",0,0,0,0,0,0,0,0,0,0,0,0,0,0,0,0,0,0,0,0,0,0,0,0,0,110010062021197,1,103,103,1,psa_12,1D1
1000000US110010099042005,"Block 2005, Block Group 2, Census Tract 99.04, District of Columbia, District of Columbia",180,0,176,1,0,0,0,3,180,174,0,171,1,0,0,0,2,6,0,5,0,0,0,0,1,110010099042005,6,604,604,6,psa_14,6D3
1000000US110010109002033,"Block 2033, Block Group 2, Census Tract 109, District of Columbia, District of Columbia",0,0,0,0,0,0,0,0,0,0,0,0,0,0,0,0,0,0,0,0,0,0,0,0,0,110010109002033,7,708,708,7,psa_1,7D3
1000000US110010024002003,"Block 2003, Block Group 2, Census Tract 24, District of Columbia, District of Columbia",0,0,0,0,0,0,0,0,0,0,0,0,0,0,0,0,0,0,0,0,0,0,0,0,0,110010024002003,4,407,407,4,psa_47,4D2
1000000US110010008014012,"Block 4012, Block Group 4, Census Tract 8.01, District of Columbia, District of Columbia",0,0,0,0,0,0,0,0,0,0,0,0,0,0,0,0,0,0,0,0,0,0,0,0,0,110010008014012,2,205,205,2,psa_46,2D2
1000000US110010073011033,"Block 1033, Block Group 1, Census Tract 73.01, District of Columbia, District of Columbia",0,0,0,0,0,0,0,0,0,0,0,0,0,0,0,0,0,0,0,0,0,0,0,0,0,110010073011033,7,708,708,7,psa_1,7D3
1000000US110010026002008,"Block 2008, Block Group 2, Census Tract 26, District of Columbia, District of Columbia",101,23,70,0,0,0,0,8,101,91,17,70,0,0,0,0,4,10,6,0,0,0,0,0,4,110010026002008,4,404,404,4,psa_48,4D3
1000000US110010095033013,"Block 3013, Block Group 3, Census Tract 95.03, District of Columbia, District of Columbia",65,9,55,1,0,0,0,0,65,62,9,53,0,0,0,0,0,3,0,2,1,0,0,0,0,110010095033013,5,504,504,5,psa_43,5D2
1000000US110010093021010,"Block 1010, Block Group 1, Census Tract 93.02, District of Columbia, District of Columbia",40,4,34,0,0,0,0,2,40,40,4,34,0,0,0,0,2,0,0,0,0,0,0,0,0,110010093021010,5,504,504,5,psa_43,5D2
1000000US110010064001002,"Block 1002, Block Group 1, Census Tract 64, District of Columbia, District of Columbia",56,0,56,0,0,0,0,0,56,56,0,56,0,0,0,0,0,0,0,0,0,0,0,0,0,110010064001002,1,105,105,1,psa_22,1D3
1000000US110010056002014,"Block 2014, Block Group 2, Census Tract 56, District of Columbia, District of Columbia",0,0,0,0,0,0,0,0,0,0,0,0,0,0,0,0,0,0,0,0,0,0,0,0,0,110010056002014,2,207,207,2,psa_24,2D3
1000000US110010108002001,"Block 2001, Block Group 2, Census Tract 108.00, District of Columbia, District of Columbia",0,0,0,0,0,0,0,0,0,0,0,0,0,0,0,0,0,0,0,0,0,0,0,0,0,110010108002001,2,207,207,2,psa_24,2D3
1000000US110010010011005,"Block 1005, Block Group 1, Census Tract 10.01, District of Columbia, District of Columbia",40,37,1,0,0,0,0,2,40,40,37,1,0,0,0,0,2,0,0,0,0,0,0,0,0,110010010011005,2,202,202,2,psa_52,2D1
1000000US110010010012025,"Block 2025, Block Group 2, Census Tract 10.01, District of Columbia, District of Columbia",71,68,0,0,3,0,0,0,71,70,67,0,0,3,0,0,0,1,1,0,0,0,0,0,0,110010010012025,2,202,202,2,psa_52,2D1
1000000US110010011003003,"Block 3003, Block Group 3, Census Tract 11, District of Columbia, District of Columbia",71,62,0,0,8,0,1,0,71,64,56,0,0,7,0,1,0,7,6,0,0,1,0,0,0,110010011003003,2,201,201,2,psa_55,2D1
1000000US110010088031004,"Block 1004, Block Group 1, Census Tract 88.03, District of Columbia, District of Columbia",0,0,0,0,0,0,0,0,0,0,0,0,0,0,0,0,0,0,0,0,0,0,0,0,0,110010088031004,5,506,506,5,psa_26,5D3
1000000US110010089041002,"Block 1002, Block Group 1, Census Tract 89.04, District of Columbia, District of Columbia",232,1,208,0,1,0,9,13,232,221,1,206,0,1,0,0,13,11,0,2,0,0,0,9,0,110010089041002,5,507,507,5,psa_23,5D3
1000000US110010006004008,"Block 4008, Block Group 4, Census Tract 6, District of Columbia, District of Columbia",52,51,0,0,0,0,0,1,52,48,47,0,0,0,0,0,1,4,4,0,0,0,0,0,0,110010006004008,2,203,203,2,psa_50,2D1
1000000US110010012004019,"Block 4019, Block Group 4, Census Tract 12, District of Columbia, District of Columbia",23,22,0,0,1,0,0,0,23,22,21,0,0,1,0,0,0,1,1,0,0,0,0,0,0,110010012004019,2,202,202,2,psa_52,2D1
1000000US110010006002003,"Block 2003, Block Group 2, Census Tract 6, District of Columbia, District of Columbia",51,49,0,0,1,0,1,0,51,49,48,0,0,1,0,0,0,2,1,0,0,0,0,1,0,110010006002003,2,203,203,2,psa_50,2D1
1000000US110010065001000,"Block 1000, Block Group 1, Census Tract 65, District of Columbia, District of Columbia",62,50,6,0,5,0,0,1,62,61,49,6,0,5,0,0,1,1,1,0,0,0,0,0,0,110010065001000,1,107,107,1,psa_16,1D2
1000000US110010073011085,"Block 1085, Block Group 1, Census Tract 73.01, District of Columbia, District of Columbia",0,0,0,0,0,0,0,0,0,0,0,0,0,0,0,0,0,0,0,0,0,0,0,0,0,110010073011085,7,707,707,7,psa_4,7D2
1000000US110010036003005,"Block 3005, Block Group 3, Census Tract 36, District of Columbia, District of Columbia",0,0,0,0,0,0,0,0,0,0,0,0,0,0,0,0,0,0,0,0,0,0,0,0,0,110010036003005,3,304,304,3,psa_36,3D1
1000000US110010058001038,"Block 1038, Block Group 1, Census Tract 58, District of Columbia, District of Columbia",8,0,7,1,0,0,0,0,8,8,0,7,1,0,0,0,0,0,0,0,0,0,0,0,0,110010058001038,2,209,209,2,psa_57,2D3
1000000US110010056004000,"Block 4000, Block Group 4, Census Tract 56, District of Columbia, District of Columbia",0,0,0,0,0,0,0,0,0,0,0,0,0,0,0,0,0,0,0,0,0,0,0,0,0,110010056004000,2,207,207,2,psa_24,2D3
1000000US110010074042002,"Block 2002, Block Group 2, Census Tract 74.04, District of Columbia, District of Columbia",77,0,73,0,0,0,0,4,77,77,0,73,0,0,0,0,4,0,0,0,0,0,0,0,0,110010074042002,7,704,704,7,psa_5,7D2
1000000US110010105002001,"Block 2001, Block Group 2, Census Tract 105, District of Columbia, District of Columbia",0,0,0,0,0,0,0,0,0,0,0,0,0,0,0,0,0,0,0,0,0,0,0,0,0,110010105002001,1,103,103,1,psa_12,1D1
1000000US110010005021003,"Block 1003, Block Group 1, Census Tract 5.02, District of Columbia, District of Columbia",145,135,0,1,7,0,0,2,145,140,131,0,0,7,0,0,2,5,4,0,1,0,0,0,0,110010005021003,2,204,204,2,psa_44,2D2
1000000US110010008021018,"Block 1018, Block Group 1, Census Tract 8.02, District of Columbia, District of Columbia",0,0,0,0,0,0,0,0,0,0,0,0,0,0,0,0,0,0,0,0,0,0,0,0,0,110010008021018,2,205,205,2,psa_46,2D2
1000000US110010020021009,"Block 1009, Block Group 1, Census Tract 20.02, District of Columbia, District of Columbia",28,2,23,0,0,0,0,3,28,28,2,23,0,0,0,0,3,0,0,0,0,0,0,0,0,110010020021009,4,404,404,4,psa_48,4D3
1000000US110010062021083,"Block 1083, Block Group 1, Census Tract 62.02, District of Columbia, District of Columbia",0,0,0,0,0,0,0,0,0,0,0,0,0,0,0,0,0,0,0,0,0,0,0,0,0,110010062021083,2,207,207,2,psa_24,2D3
1000000US110010109002039,"Block 2039, Block Group 2, Census Tract 109, District of Columbia, District of Columbia",0,0,0,0,0,0,0,0,0,0,0,0,0,0,0,0,0,0,0,0,0,0,0,0,0,110010109002039,7,708,708,7,psa_1,7D3
1000000US110010091022015,"Block 2015, Block Group 2, Census Tract 91.02, District of Columbia, District of Columbia",0,0,0,0,0,0,0,0,0,0,0,0,0,0,0,0,0,0,0,0,0,0,0,0,0,110010091022015,5,505,505,5,psa_34,5D2
1000000US110010011001016,"Block 1016, Block Group 1, Census Tract 11, District of Columbia, District of Columbia",43,39,0,0,4,0,0,0,43,41,37,0,0,4,0,0,0,2,2,0,0,0,0,0,0,110010011001016,2,201,201,2,psa_55,2D1
1000000US110010098032001,"Block 2001, Block Group 2, Census Tract 98.03, District of Columbia, District of Columbia",212,1,211,0,0,0,0,0,212,212,1,211,0,0,0,0,0,0,0,0,0,0,0,0,0,110010098032001,7,707,707,7,psa_4,7D2
1000000US110010011001021,"Block 1021, Block Group 1, Census Tract 11, District of Columbia, District of Columbia",40,40,0,0,0,0,0,0,40,39,39,0,0,0,0,0,0,1,1,0,0,0,0,0,0,110010011001021,2,201,201,2,psa_55,2D1
1000000US110010056001004,"Block 1004, Block Group 1, Census Tract 56, District of Columbia, District of Columbia",49,43,3,0,3,0,0,0,49,45,39,3,0,3,0,0,0,4,4,0,0,0,0,0,0,110010056001004,2,207,207,2,psa_24,2D3
1000000US110010011002001,"Block 2001, Block Group 2, Census Tract 11, District of Columbia, District of Columbia",32,31,0,0,0,0,0,1,32,32,31,0,0,0,0,0,1,0,0,0,0,0,0,0,0,110010011002001,2,202,202,2,psa_52,2D1
1000000US110010041003012,"Block 3012, Block Group 3, Census Tract 41, District of Columbia, District of Columbia",0,0,0,0,0,0,0,0,0,0,0,0,0,0,0,0,0,0,0,0,0,0,0,0,0,110010041003012,2,208,208,2,psa_33,2D3
1000000US110010062021099,"Block 1099, Block Group 1, Census Tract 62.02, District of Columbia, District of Columbia",0,0,0,0,0,0,0,0,0,0,0,0,0,0,0,0,0,0,0,0,0,0,0,0,0,110010062021099,2,207,207,2,psa_24,2D3
1000000US110010092011015,"Block 1015, Block Group 1, Census Tract 92.01, District of Columbia, District of Columbia",141,18,104,1,0,0,8,10,141,128,17,104,1,0,0,1,5,13,1,0,0,0,0,7,5,110010092011015,5,502,502,5,psa_40,5D1
1000000US110010002023002,"Block 3002, Block Group 3, Census Tract 2.02, District of Columbia, District of Columbia",78,71,2,0,5,0,0,0,78,73,66,2,0,5,0,0,0,5,5,0,0,0,0,0,0,110010002023002,2,206,206,2,psa_29,2D2
1000000US110010015004010,"Block 4010, Block Group 4, Census Tract 15, District of Columbia, District of Columbia",268,183,72,1,8,0,1,3,268,258,174,72,1,8,0,1,2,10,9,0,0,0,0,0,1,110010015004010,2,201,201,2,psa_55,2D1
1000000US110010074041004,"Block 1004, Block Group 1, Census Tract 74.04, District of Columbia, District of Columbia",87,8,79,0,0,0,0,0,87,87,8,79,0,0,0,0,0,0,0,0,0,0,0,0,0,110010074041004,7,704,704,7,psa_5,7D2
1000000US110010110003004,"Block 3004, Block Group 3, Census Tract 110, District of Columbia, District of Columbia",0,0,0,0,0,0,0,0,0,0,0,0,0,0,0,0,0,0,0,0,0,0,0,0,0,110010110003004,1,103,103,1,psa_12,1D1
1000000US110010096042006,"Block 2006, Block Group 2, Census Tract 96.04, District of Columbia, District of Columbia",100,1,97,0,0,0,0,2,100,100,1,97,0,0,0,0,2,0,0,0,0,0,0,0,0,110010096042006,6,603,603,6,psa_15,6D3
1000000US110010041003006,"Block 3006, Block Group 3, Census Tract 41, District of Columbia, District of Columbia",0,0,0,0,0,0,0,0,0,0,0,0,0,0,0,0,0,0,0,0,0,0,0,0,0,110010041003006,2,208,208,2,psa_33,2D3
1000000US110010096022008,"Block 2008, Block Group 2, Census Tract 96.02, District of Columbia, District of Columbia",0,0,0,0,0,0,0,0,0,0,0,0,0,0,0,0,0,0,0,0,0,0,0,0,0,110010096022008,6,601,601,6,psa_30,6D1
1000000US110010004002010,"Block 2010, Block Group 2, Census Tract 4, District of Columbia, District of Columbia",2,2,0,0,0,0,0,0,2,2,2,0,0,0,0,0,0,0,0,0,0,0,0,0,0,110010004002010,2,204,204,2,psa_44,2D2
1000000US110010076015019,"Block 5019, Block Group 5, Census Tract 76.01, District of Columbia, District of Columbia",158,1,157,0,0,0,0,0,158,154,1,153,0,0,0,0,0,4,0,4,0,0,0,0,0,110010076015019,6,607,607,6,psa_10,6D2
1000000US110010014022007,"Block 2007, Block Group 2, Census Tract 14.02, District of Columbia, District of Columbia",0,0,0,0,0,0,0,0,0,0,0,0,0,0,0,0,0,0,0,0,0,0,0,0,0,110010014022007,2,201,201,2,psa_55,2D1
1000000US110010068011002,"Block 1002, Block Group 1, Census Tract 68.01, District of Columbia, District of Columbia",153,25,117,1,0,0,4,6,153,144,22,116,1,0,0,0,5,9,3,1,0,0,0,4,1,110010068011002,1,107,107,1,psa_16,1D2
1000000US110010021024003,"Block 4003, Block Group 4, Census Tract 21.02, District of Columbia, District of Columbia",114,8,99,0,2,0,5,0,114,110,8,99,0,2,0,1,0,4,0,0,0,0,0,4,0,110010021024003,4,403,403,4,psa_51,4D1
1000000US110010077072007,"Block 2007, Block Group 2, Census Tract 77.07, District of Columbia, District of Columbia",90,0,90,0,0,0,0,0,90,89,0,89,0,0,0,0,0,1,0,1,0,0,0,0,0,110010077072007,6,605,605,6,psa_11,6D2
1000000US110010021021005,"Block 1005, Block Group 1, Census Tract 21.02, District of Columbia, District of Columbia",84,13,64,0,0,0,3,4,84,80,13,64,0,0,0,0,3,4,0,0,0,0,0,3,1,110010021021005,4,406,406,4,psa_54,4D2
1000000US110010095082002,"Block 2002, Block Group 2, Census Tract 95.08, District of Columbia, District of Columbia",34,0,32,0,1,0,0,1,34,34,0,32,0,1,0,0,1,0,0,0,0,0,0,0,0,110010095082002,4,406,406,4,psa_54,4D2
1000000US110010101001029,"Block 1029, Block Group 1, Census Tract 101, District of Columbia, District of Columbia",0,0,0,0,0,0,0,0,0,0,0,0,0,0,0,0,0,0,0,0,0,0,0,0,0,110010101001029,2,207,207,2,psa_24,2D3
1000000US110010072002064,"Block 2064, Block Group 2, Census Tract 72, District of Columbia, District of Columbia",0,0,0,0,0,0,0,0,0,0,0,0,0,0,0,0,0,0,0,0,0,0,0,0,0,110010072002064,1,106,106,1,psa_13,1D3
1000000US110010075041005,"Block 1005, Block Group 1, Census Tract 75.04, District of Columbia, District of Columbia",278,1,276,0,0,0,0,1,278,276,0,276,0,0,0,0,0,2,1,0,0,0,0,0,1,110010075041005,7,701,701,7,psa_9,7D1
1000000US110010111003043,"Block 3043, Block Group 3, Census Tract 111, District of Columbia, District of Columbia",0,0,0,0,0,0,0,0,0,0,0,0,0,0,0,0,0,0,0,0,0,0,0,0,0,110010111003043,5,503,503,5,psa_45,5D2
1000000US110010007021003,"Block 1003, Block Group 1, Census Tract 7.02, District of Columbia, District of Columbia",308,276,15,0,4,0,4,9,308,277,251,15,0,4,0,0,7,31,25,0,0,0,0,4,2,110010007021003,2,204,204,2,psa_44,2D2
1000000US110010025021001,"Block 1001, Block Group 1, Census Tract 25.02, District of Columbia, District of Columbia",0,0,0,0,0,0,0,0,0,0,0,0,0,0,0,0,0,0,0,0,0,0,0,0,0,110010025021001,4,404,404,4,psa_48,4D3
1000000US110010009022008,"Block 2008, Block Group 2, Census Tract 9.02, District of Columbia, District of Columbia",0,0,0,0,0,0,0,0,0,0,0,0,0,0,0,0,0,0,0,0,0,0,0,0,0,110010009022008,2,205,205,2,psa_46,2D2
1000000US110010068022007,"Block 2007, Block Group 2, Census Tract 68.02, District of Columbia, District of Columbia",78,31,45,0,1,0,0,1,78,77,30,45,0,1,0,0,1,1,1,0,0,0,0,0,0,110010068022007,1,107,107,1,psa_16,1D2
1000000US110010072002051,"Block 2051, Block Group 2, Census Tract 72, District of Columbia, District of Columbia",0,0,0,0,0,0,0,0,0,0,0,0,0,0,0,0,0,0,0,0,0,0,0,0,0,110010072002051,1,106,106,1,psa_13,1D3
1000000US110010077092006,"Block 2006, Block Group 2, Census Tract 77.09, District of Columbia, District of Columbia",93,1,90,2,0,0,0,0,93,93,1,90,2,0,0,0,0,0,0,0,0,0,0,0,0,110010077092006,6,605,605,6,psa_11,6D2
1000000US110010007014007,"Block 4007, Block Group 4, Census Tract 7.01, District of Columbia, District of Columbia",81,68,10,1,2,0,0,0,81,80,67,10,1,2,0,0,0,1,1,0,0,0,0,0,0,110010007014007,2,204,204,2,psa_44,2D2
1000000US110010077071005,"Block 1005, Block Group 1, Census Tract 77.07, District of Columbia, District of Columbia",194,3,181,0,1,0,6,3,194,185,3,181,0,1,0,0,0,9,0,0,0,0,0,6,3,110010077071005,6,604,604,6,psa_14,6D3
1000000US110010070002001,"Block 2001, Block Group 2, Census Tract 70, District of Columbia, District of Columbia",0,0,0,0,0,0,0,0,0,0,0,0,0,0,0,0,0,0,0,0,0,0,0,0,0,110010070002001,1,107,107,1,psa_16,1D2
1000000US110010079013000,"Block 3000, Block Group 3, Census Tract 79.01, District of Columbia, District of Columbia",114,1,105,2,0,0,0,6,114,113,1,104,2,0,0,0,6,1,0,1,0,0,0,0,0,110010079013000,5,507,507,5,psa_23,5D3
1000000US110010014021008,"Block 1008, Block Group 1, Census Tract 14.02, District of Columbia, District of Columbia",102,91,10,0,0,0,0,1,102,97,86,10,0,0,0,0,1,5,5,0,0,0,0,0,0,110010014021008,2,201,201,2,psa_55,2D1
1000000US110010024003006,"Block 3006, Block Group 3, Census Tract 24, District of Columbia, District of Columbia",20,0,20,0,0,0,0,0,20,20,0,20,0,0,0,0,0,0,0,0,0,0,0,0,0,110010024003006,4,407,407,4,psa_47,4D2
1000000US110010062021016,"Block 1016, Block Group 1, Census Tract 62.02, District of Columbia, District of Columbia",0,0,0,0,0,0,0,0,0,0,0,0,0,0,0,0,0,0,0,0,0,0,0,0,0,110010062021016,1,102,102,1,psa_18,1D1
1000000US110010094004006,"Block 4006, Block Group 4, Census Tract 94, District of Columbia, District of Columbia",39,1,35,0,1,0,0,2,39,39,1,35,0,1,0,0,2,0,0,0,0,0,0,0,0,110010094004006,5,503,503,5,psa_45,5D2
1000000US110010087012004,"Block 2004, Block Group 2, Census Tract 87.01, District of Columbia, District of Columbia",238,25,193,1,1,0,4,14,238,220,19,186,1,1,0,0,13,18,6,7,0,0,0,4,1,110010087012004,5,502,502,5,psa_40,5D1
1000000US110010111003015,"Block 3015, Block Group 3, Census Tract 111, District of Columbia, District of Columbia",0,0,0,0,0,0,0,0,0,0,0,0,0,0,0,0,0,0,0,0,0,0,0,0,0,110010111003015,5,505,505,5,psa_34,5D2
1000000US110010062021070,"Block 1070, Block Group 1, Census Tract 62.02, District of Columbia, District of Columbia",0,0,0,0,0,0,0,0,0,0,0,0,0,0,0,0,0,0,0,0,0,0,0,0,0,110010062021070,2,207,207,2,psa_24,2D3
1000000US110010107001023,"Block 1023, Block Group 1, Census Tract 107, District of Columbia, District of Columbia",2,2,0,0,0,0,0,0,2,2,2,0,0,0,0,0,0,0,0,0,0,0,0,0,0,110010107001023,2,207,207,2,psa_24,2D3
1000000US110010026002023,"Block 2023, Block Group 2, Census Tract 26, District of Columbia, District of Columbia",32,8,22,0,0,0,0,2,32,32,8,22,0,0,0,0,2,0,0,0,0,0,0,0,0,110010026002023,4,404,404,4,psa_48,4D3
1000000US110010032004001,"Block 4001, Block Group 4, Census Tract 32, District of Columbia, District of Columbia",435,78,228,2,4,0,115,8,435,290,61,222,1,4,0,0,2,145,17,6,1,0,0,115,6,110010032004001,4,409,409,4,psa_41,4D3
1000000US110010055003011,"Block 3011, Block Group 3, Census Tract 55, District of Columbia, District of Columbia",0,0,0,0,0,0,0,0,0,0,0,0,0,0,0,0,0,0,0,0,0,0,0,0,0,110010055003011,2,207,207,2,psa_24,2D3
1000000US110010072002037,"Block 2037, Block Group 2, Census Tract 72, District of Columbia, District of Columbia",4,3,1,0,0,0,0,0,4,4,3,1,0,0,0,0,0,0,0,0,0,0,0,0,0,110010072002037,1,106,106,1,psa_13,1D3
1000000US110010024002006,"Block 2006, Block Group 2, Census Tract 24, District of Columbia, District of Columbia",73,7,54,0,0,0,12,0,73,60,6,54,0,0,0,0,0,13,1,0,0,0,0,12,0,110010024002006,4,407,407,4,psa_47,4D2
1000000US110010010014012,"Block 4012, Block Group 4, Census Tract 10.01, District of Columbia, District of Columbia",0,0,0,0,0,0,0,0,0,0,0,0,0,0,0,0,0,0,0,0,0,0,0,0,0,110010010014012,2,202,202,2,psa_52,2D1
1000000US110010099061005,"Block 1005, Block Group 1, Census Tract 99.06, District of Columbia, District of Columbia",161,0,149,2,1,0,0,9,161,156,0,147,0,1,0,0,8,5,0,2,2,0,0,0,1,110010099061005,6,604,604,6,psa_14,6D3
1000000US110010080021000,"Block 1000, Block Group 1, Census Tract 80.02, District of Columbia, District of Columbia",106,9,84,0,6,0,7,0,106,98,8,84,0,6,0,0,0,8,1,0,0,0,0,7,0,110010080021000,1,108,108,1,psa_17,1D2
1000000US110010014012016,"Block 2016, Block Group 2, Census Tract 14.01, District of Columbia, District of Columbia",48,44,0,0,2,0,0,2,48,47,43,0,0,2,0,0,2,1,1,0,0,0,0,0,0,110010014012016,2,201,201,2,psa_55,2D1
1000000US110010022012005,"Block 2005, Block Group 2, Census Tract 22.01, District of Columbia, District of Columbia",143,15,100,0,7,0,18,3,143,105,3,94,0,7,0,0,1,38,12,6,0,0,0,18,2,110010022012005,4,407,407,4,psa_47,4D2
1000000US110010091022026,"Block 2026, Block Group 2, Census Tract 91.02, District of Columbia, District of Columbia",0,0,0,0,0,0,0,0,0,0,0,0,0,0,0,0,0,0,0,0,0,0,0,0,0,110010091022026,5,505,505,5,psa_34,5D2
1000000US110010081002006,"Block 2006, Block Group 2, Census Tract 81, District of Columbia, District of Columbia",168,133,20,0,9,0,0,6,168,164,129,20,0,9,0,0,6,4,4,0,0,0,0,0,0,110010081002006,1,108,108,1,psa_17,1D2
1000000US110010022011000,"Block 1000, Block Group 1, Census Tract 22.01, District of Columbia, District of Columbia",227,35,151,0,2,0,33,6,227,162,12,144,0,2,0,2,2,65,23,7,0,0,0,31,4,110010022011000,4,407,407,4,psa_47,4D2
1000000US110010026002026,"Block 2026, Block Group 2, Census Tract 26, District of Columbia, District of Columbia",108,54,45,0,4,0,2,3,108,104,52,44,0,4,0,1,3,4,2,1,0,0,0,1,0,110010026002026,4,404,404,4,psa_48,4D3
1000000US110010095053004,"Block 3004, Block Group 3, Census Tract 95.05, District of Columbia, District of Columbia",114,0,97,0,0,2,15,0,114,99,0,97,0,0,2,0,0,15,0,0,0,0,0,15,0,110010095053004,4,406,406,4,psa_54,4D2
1000000US110010099051001,"Block 1001, Block Group 1, Census Tract 99.05, District of Columbia, District of Columbia",108,0,105,0,0,0,0,3,108,108,0,105,0,0,0,0,3,0,0,0,0,0,0,0,0,110010099051001,6,604,604,6,psa_14,6D3
1000000US110010018042010,"Block 2010, Block Group 2, Census Tract 18.04, District of Columbia, District of Columbia",12,0,12,0,0,0,0,0,12,12,0,12,0,0,0,0,0,0,0,0,0,0,0,0,0,110010018042010,4,402,402,4,psa_53,4D1
1000000US110010027023014,"Block 3014, Block Group 3, Census Tract 27.02, District of Columbia, District of Columbia",0,0,0,0,0,0,0,0,0,0,0,0,0,0,0,0,0,0,0,0,0,0,0,0,0,110010027023014,3,302,302,3,psa_42,3D1
1000000US110010070002022,"Block 2022, Block Group 2, Census Tract 70, District of Columbia, District of Columbia",0,0,0,0,0,0,0,0,0,0,0,0,0,0,0,0,0,0,0,0,0,0,0,0,0,110010070002022,1,106,106,1,psa_13,1D3
1000000US110010093012009,"Block 2009, Block Group 2, Census Tract 93.01, District of Columbia, District of Columbia",99,55,38,1,4,0,0,1,99,89,46,37,1,4,0,0,1,10,9,1,0,0,0,0,0,110010093012009,5,504,504,5,psa_43,5D2
1000000US110010094002008,"Block 2008, Block Group 2, Census Tract 94, District of Columbia, District of Columbia",3,0,3,0,0,0,0,0,3,3,0,3,0,0,0,0,0,0,0,0,0,0,0,0,0,110010094002008,5,503,503,5,psa_45,5D2
1000000US110010095093001,"Block 3001, Block Group 3, Census Tract 95.09, District of Columbia, District of Columbia",53,0,46,0,0,0,7,0,53,47,0,46,0,0,0,1,0,6,0,0,0,0,0,6,0,110010095093001,4,405,405,4,psa_49,4D2
1000000US110010099072000,"Block 2000, Block Group 2, Census Tract 99.07, District of Columbia, District of Columbia",616,5,600,0,0,0,2,9,616,601,3,591,0,0,0,0,7,15,2,9,0,0,0,2,2,110010099072000,6,604,604,6,psa_14,6D3
1000000US110010102002024,"Block 2024, Block Group 2, Census Tract 102, District of Columbia, District of Columbia",0,0,0,0,0,0,0,0,0,0,0,0,0,0,0,0,0,0,0,0,0,0,0,0,0,110010102002024,1,103,103,1,psa_12,1D1
1000000US110010008014009,"Block 4009, Block Group 4, Census Tract 8.01, District of Columbia, District of Columbia",0,0,0,0,0,0,0,0,0,0,0,0,0,0,0,0,0,0,0,0,0,0,0,0,0,110010008014009,2,205,205,2,psa_46,2D2
1000000US110010014021011,"Block 1011, Block Group 1, Census Tract 14.02, District of Columbia, District of Columbia",88,74,7,0,2,0,0,5,88,81,69,7,0,1,0,0,4,7,5,0,0,1,0,0,1,110010014021011,2,201,201,2,psa_55,2D1
1000000US110010017021020,"Block 1020, Block Group 1, Census Tract 17.02, District of Columbia, District of Columbia",0,0,0,0,0,0,0,0,0,0,0,0,0,0,0,0,0,0,0,0,0,0,0,0,0,110010017021020,4,401,401,4,psa_56,4D1
1000000US110010055001013,"Block 1013, Block Group 1, Census Tract 55, District of Columbia, District of Columbia",311,49,248,0,3,0,2,9,311,299,42,246,0,3,0,0,8,12,7,2,0,0,0,2,1,110010055001013,2,208,208,2,psa_33,2D3
1000000US110010069001014,"Block 1014, Block Group 1, Census Tract 69, District of Columbia, District of Columbia",111,61,39,1,3,0,1,6,111,107,57,39,1,3,0,1,6,4,4,0,0,0,0,0,0,110010069001014,1,107,107,1,psa_16,1D2
1000000US110010095033012,"Block 3012, Block Group 3, Census Tract 95.03, District of Columbia, District of Columbia",59,24,29,1,1,0,0,4,59,58,24,29,1,1,0,0,3,1,0,0,0,0,0,0,1,110010095033012,5,504,504,5,psa_43,5D2
1000000US110010073011083,"Block 1083, Block Group 1, Census Tract 73.01, District of Columbia, District of Columbia",0,0,0,0,0,0,0,0,0,0,0,0,0,0,0,0,0,0,0,0,0,0,0,0,0,110010073011083,7,707,707,7,psa_4,7D2
1000000US110010111003026,"Block 3026, Block Group 3, Census Tract 111, District of Columbia, District of Columbia",0,0,0,0,0,0,0,0,0,0,0,0,0,0,0,0,0,0,0,0,0,0,0,0,0,110010111003026,5,503,503,5,psa_45,5D2
1000000US110010019013002,"Block 3002, Block Group 3, Census Tract 19.01, District of Columbia, District of Columbia",81,0,76,3,0,0,0,2,81,73,0,71,0,0,0,0,2,8,0,5,3,0,0,0,0,110010019013002,4,402,402,4,psa_53,4D1
1000000US110010038003007,"Block 3007, Block Group 3, Census Tract 38, District of Columbia, District of Columbia",188,104,49,0,8,0,18,9,188,153,87,45,0,8,0,5,8,35,17,4,0,0,0,13,1,110010038003007,3,303,303,3,psa_37,3D3
1000000US110010062021140,"Block 1140, Block Group 1, Census Tract 62.02, District of Columbia, District of Columbia",0,0,0,0,0,0,0,0,0,0,0,0,0,0,0,0,0,0,0,0,0,0,0,0,0,110010062021140,1,103,103,1,psa_12,1D1
1000000US110010076032007,"Block 2007, Block Group 2, Census Tract 76.03, District of Columbia, District of Columbia",19,7,8,4,0,0,0,0,19,19,7,8,4,0,0,0,0,0,0,0,0,0,0,0,0,110010076032007,6,606,606,6,psa_7,6D2
1000000US110010004002020,"Block 2020, Block Group 2, Census Tract 4, District of Columbia, District of Columbia",0,0,0,0,0,0,0,0,0,0,0,0,0,0,0,0,0,0,0,0,0,0,0,0,0,110010004002020,2,204,204,2,psa_44,2D2
1000000US110010074041009,"Block 1009, Block Group 1, Census Tract 74.04, District of Columbia, District of Columbia",179,4,172,0,0,0,0,3,179,179,4,172,0,0,0,0,3,0,0,0,0,0,0,0,0,110010074041009,7,704,704,7,psa_5,7D2
1000000US110010068011008,"Block 1008, Block Group 1, Census Tract 68.01, District of Columbia, District of Columbia",129,34,88,0,2,0,3,2,129,121,31,86,0,2,0,0,2,8,3,2,0,0,0,3,0,110010068011008,1,107,107,1,psa_16,1D2
1000000US110010069001001,"Block 1001, Block Group 1, Census Tract 69, District of Columbia, District of Columbia",152,76,71,0,2,0,0,3,152,146,74,67,0,2,0,0,3,6,2,4,0,0,0,0,0,110010069001001,1,107,107,1,psa_16,1D2
1000000US110010093013017,"Block 3017, Block Group 3, Census Tract 93.01, District of Columbia, District of Columbia",30,15,15,0,0,0,0,0,30,27,12,15,0,0,0,0,0,3,3,0,0,0,0,0,0,110010093013017,5,504,504,5,psa_43,5D2
1000000US110010018041002,"Block 1002, Block Group 1, Census Tract 18.04, District of Columbia, District of Columbia",389,37,282,2,5,0,58,5,389,302,12,281,1,5,0,0,3,87,25,1,1,0,0,58,2,110010018041002,4,401,401,4,psa_56,4D1
1000000US110010093021017,"Block 1017, Block Group 1, Census Tract 93.02, District of Columbia, District of Columbia",63,9,42,0,0,0,12,0,63,51,9,42,0,0,0,0,0,12,0,0,0,0,0,12,0,110010093021017,5,504,504,5,psa_43,5D2
1000000US110010094003018,"Block 3018, Block Group 3, Census Tract 94, District of Columbia, District of Columbia",61,4,51,1,1,0,1,3,61,60,4,51,1,1,0,0,3,1,0,0,0,0,0,1,0,110010094003018,5,503,503,5,psa_45,5D2
1000000US110010013011006,"Block 1006, Block Group 1, Census Tract 13.01, District of Columbia, District of Columbia",15,13,0,0,0,0,1,1,15,12,11,0,0,0,0,0,1,3,2,0,0,0,0,1,0,110010013011006,2,203,203,2,psa_50,2D1
1000000US110010073011063,"Block 1063, Block Group 1, Census Tract 73.01, District of Columbia, District of Columbia",228,147,46,1,10,0,8,16,228,195,127,44,1,9,0,0,14,33,20,2,0,1,0,8,2,110010073011063,7,707,707,7,psa_4,7D2
1000000US110010107002011,"Block 2011, Block Group 2, Census Tract 107, District of Columbia, District of Columbia",0,0,0,0,0,0,0,0,0,0,0,0,0,0,0,0,0,0,0,0,0,0,0,0,0,110010107002011,2,208,208,2,psa_33,2D3
1000000US110010001004048,"Block 4048, Block Group 4, Census Tract 1, District of Columbia, District of Columbia",0,0,0,0,0,0,0,0,0,0,0,0,0,0,0,0,0,0,0,0,0,0,0,0,0,110010001004048,2,207,207,2,psa_24,2D3
1000000US110010091022028,"Block 2028, Block Group 2, Census Tract 91.02, District of Columbia, District of Columbia",0,0,0,0,0,0,0,0,0,0,0,0,0,0,0,0,0,0,0,0,0,0,0,0,0,110010091022028,5,505,505,5,psa_34,5D2
1000000US110010010014008,"Block 4008, Block Group 4, Census Tract 10.01, District of Columbia, District of Columbia",63,49,3,0,4,1,0,6,63,54,43,3,0,3,1,0,4,9,6,0,0,1,0,0,2,110010010014008,2,202,202,2,psa_52,2D1
1000000US110010079014003,"Block 4003, Block Group 4, Census Tract 79.01, District of Columbia, District of Columbia",90,14,72,0,1,0,1,2,90,88,14,71,0,1,0,0,2,2,0,1,0,0,0,1,0,110010079014003,5,507,507,5,psa_23,5D3
1000000US110010094003016,"Block 3016, Block Group 3, Census Tract 94, District of Columbia, District of Columbia",60,6,45,0,0,0,0,9,60,56,6,45,0,0,0,0,5,4,0,0,0,0,0,0,4,110010094003016,5,503,503,5,psa_45,5D2
1000000US110010029002004,"Block 2004, Block Group 2, Census Tract 29, District of Columbia, District of Columbia",130,55,43,0,10,0,19,3,130,101,44,42,0,10,0,2,3,29,11,1,0,0,0,17,0,110010029002004,4,408,408,4,psa_39,4D3
1000000US110010017021021,"Block 1021, Block Group 1, Census Tract 17.02, District of Columbia, District of Columbia",43,0,43,0,0,0,0,0,43,43,0,43,0,0,0,0,0,0,0,0,0,0,0,0,0,110010017021021,4,401,401,4,psa_56,4D1
1000000US110010062021169,"Block 1169, Block Group 1, Census Tract 62.02, District of Columbia, District of Columbia",0,0,0,0,0,0,0,0,0,0,0,0,0,0,0,0,0,0,0,0,0,0,0,0,0,110010062021169,2,207,207,2,psa_24,2D3
1000000US110010062021086,"Block 1086, Block Group 1, Census Tract 62.02, District of Columbia, District of Columbia",0,0,0,0,0,0,0,0,0,0,0,0,0,0,0,0,0,0,0,0,0,0,0,0,0,110010062021086,2,207,207,2,psa_24,2D3
1000000US110010065002025,"Block 2025, Block Group 2, Census Tract 65, District of Columbia, District of Columbia",0,0,0,0,0,0,0,0,0,0,0,0,0,0,0,0,0,0,0,0,0,0,0,0,0,110010065002025,1,106,106,1,psa_13,1D3
1000000US110010089031006,"Block 1006, Block Group 1, Census Tract 89.03, District of Columbia, District of Columbia",197,2,187,0,0,0,8,0,197,190,2,187,0,0,0,1,0,7,0,0,0,0,0,7,0,110010089031006,5,507,507,5,psa_23,5D3
1000000US110010062021069,"Block 1069, Block Group 1, Census Tract 62.02, District of Columbia, District of Columbia",0,0,0,0,0,0,0,0,0,0,0,0,0,0,0,0,0,0,0,0,0,0,0,0,0,110010062021069,2,207,207,2,psa_24,2D3
1000000US110010075022005,"Block 2005, Block Group 2, Census Tract 75.02, District of Columbia, District of Columbia",370,0,361,0,0,0,0,9,370,367,0,361,0,0,0,0,6,3,0,0,0,0,0,0,3,110010075022005,7,702,702,7,psa_6,7D1
1000000US110010002023010,"Block 3010, Block Group 3, Census Tract 2.02, District of Columbia, District of Columbia",58,49,0,0,4,0,0,5,58,54,45,0,0,4,0,0,5,4,4,0,0,0,0,0,0,110010002023010,2,206,206,2,psa_29,2D2
1000000US110010095042009,"Block 2009, Block Group 2, Census Tract 95.04, District of Columbia, District of Columbia",0,0,0,0,0,0,0,0,0,0,0,0,0,0,0,0,0,0,0,0,0,0,0,0,0,110010095042009,4,405,405,4,psa_49,4D2
1000000US110010068041009,"Block 1009, Block Group 1, Census Tract 68.04, District of Columbia, District of Columbia",0,0,0,0,0,0,0,0,0,0,0,0,0,0,0,0,0,0,0,0,0,0,0,0,0,110010068041009,1,108,108,1,psa_17,1D2
1000000US110010073011020,"Block 1020, Block Group 1, Census Tract 73.01, District of Columbia, District of Columbia",143,82,50,0,4,0,5,2,143,133,81,46,0,4,0,0,2,10,1,4,0,0,0,5,0,110010073011020,7,703,703,7,psa_8,7D1
1000000US110010069002003,"Block 2003, Block Group 2, Census Tract 69, District of Columbia, District of Columbia",13,10,3,0,0,0,0,0,13,13,10,3,0,0,0,0,0,0,0,0,0,0,0,0,0,110010069002003,1,107,107,1,psa_16,1D2
1000000US110010062021116,"Block 1116, Block Group 1, Census Tract 62.02, District of Columbia, District of Columbia",0,0,0,0,0,0,0,0,0,0,0,0,0,0,0,0,0,0,0,0,0,0,0,0,0,110010062021116,1,102,102,1,psa_18,1D1
1000000US110010062021055,"Block 1055, Block Group 1, Census Tract 62.02, District of Columbia, District of Columbia",2,1,0,0,1,0,0,0,2,2,1,0,0,1,0,0,0,0,0,0,0,0,0,0,0,110010062021055,2,207,207,2,psa_24,2D3
1000000US110010080022012,"Block 2012, Block Group 2, Census Tract 80.02, District of Columbia, District of Columbia",239,205,20,1,4,3,1,5,239,232,203,18,1,4,3,1,2,7,2,2,0,0,0,0,3,110010080022012,1,108,108,1,psa_17,1D2
1000000US110010058002016,"Block 2016, Block Group 2, Census Tract 58, District of Columbia, District of Columbia",153,119,13,0,14,3,0,4,153,151,117,13,0,14,3,0,4,2,2,0,0,0,0,0,0,110010058002016,1,102,102,1,psa_18,1D1
1000000US110010069001002,"Block 1002, Block Group 1, Census Tract 69, District of Columbia, District of Columbia",86,72,12,0,0,0,0,2,86,80,67,12,0,0,0,0,1,6,5,0,0,0,0,0,1,110010069001002,1,107,107,1,psa_16,1D2
1000000US110010005021000,"Block 1000, Block Group 1, Census Tract 5.02, District of Columbia, District of Columbia",377,279,17,8,34,0,26,13,377,308,247,16,1,34,0,0,10,69,32,1,7,0,0,26,3,110010005021000,2,204,204,2,psa_44,2D2
1000000US110010017022011,"Block 2011, Block Group 2, Census Tract 17.02, District of Columbia, District of Columbia",0,0,0,0,0,0,0,0,0,0,0,0,0,0,0,0,0,0,0,0,0,0,0,0,0,110010017022011,4,406,406,4,psa_54,4D2
1000000US110010074011021,"Block 1021, Block Group 1, Census Tract 74.01, District of Columbia, District of Columbia",0,0,0,0,0,0,0,0,0,0,0,0,0,0,0,0,0,0,0,0,0,0,0,0,0,110010074011021,7,703,703,7,psa_8,7D1
1000000US110010084101004,"Block 1004, Block Group 1, Census Tract 84.10, District of Columbia, District of Columbia",0,0,0,0,0,0,0,0,0,0,0,0,0,0,0,0,0,0,0,0,0,0,0,0,0,110010084101004,1,104,104,1,psa_21,1D2
1000000US110010041003023,"Block 3023, Block Group 3, Census Tract 41, District of Columbia, District of Columbia",0,0,0,0,0,0,0,0,0,0,0,0,0,0,0,0,0,0,0,0,0,0,0,0,0,110010041003023,2,208,208,2,psa_33,2D3
1000000US110010077091010,"Block 1010, Block Group 1, Census Tract 77.09, District of Columbia, District of Columbia",43,2,41,0,0,0,0,0,43,41,1,40,0,0,0,0,0,2,1,1,0,0,0,0,0,110010077091010,6,605,605,6,psa_11,6D2
1000000US110010099051012,"Block 1012, Block Group 1, Census Tract 99.05, District of Columbia, District of Columbia",124,0,120,0,0,0,3,1,124,121,0,120,0,0,0,0,1,3,0,0,0,0,0,3,0,110010099051012,6,604,604,6,psa_14,6D3
1000000US110010076051006,"Block 1006, Block Group 1, Census Tract 76.05, District of Columbia, District of Columbia",151,5,141,0,1,0,0,4,151,149,5,139,0,1,0,0,4,2,0,2,0,0,0,0,0,110010076051006,6,607,607,6,psa_10,6D2
1000000US110010076032000,"Block 2000, Block Group 2, Census Tract 76.03, District of Columbia, District of Columbia",27,0,27,0,0,0,0,0,27,22,0,22,0,0,0,0,0,5,0,5,0,0,0,0,0,110010076032000,6,606,606,6,psa_7,6D2
1000000US110010083021011,"Block 1011, Block Group 1, Census Tract 83.02, District of Columbia, District of Columbia",174,137,31,2,0,0,0,4,174,164,130,31,2,0,0,0,1,10,7,0,0,0,0,0,3,110010083021011,1,108,108,1,psa_17,1D2
1000000US110010093013013,"Block 3013, Block Group 3, Census Tract 93.01, District of Columbia, District of Columbia",37,5,23,0,4,0,5,0,37,27,4,23,0,0,0,0,0,10,1,0,0,4,0,5,0,110010093013013,5,504,504,5,psa_43,5D2
1000000US110010099012018,"Block 2018, Block Group 2, Census Tract 99.01, District of Columbia, District of Columbia",50,0,50,0,0,0,0,0,50,50,0,50,0,0,0,0,0,0,0,0,0,0,0,0,0,110010099012018,6,605,605,6,psa_11,6D2
1000000US110010015004016,"Block 4016, Block Group 4, Census Tract 15, District of Columbia, District of Columbia",54,40,12,0,0,0,0,2,54,52,38,12,0,0,0,0,2,2,2,0,0,0,0,0,0,110010015004016,2,201,201,2,psa_55,2D1
1000000US110010016003008,"Block 3008, Block Group 3, Census Tract 16, District of Columbia, District of Columbia",93,20,71,0,2,0,0,0,93,92,19,71,0,2,0,0,0,1,1,0,0,0,0,0,0,110010016003008,4,401,401,4,psa_56,4D1
1000000US110010058002013,"Block 2013, Block Group 2, Census Tract 58, District of Columbia, District of Columbia",1,1,0,0,0,0,0,0,1,1,1,0,0,0,0,0,0,0,0,0,0,0,0,0,0,110010058002013,1,102,102,1,psa_18,1D1
1000000US110010004001015,"Block 1015, Block Group 1, Census Tract 4, District of Columbia, District of Columbia",43,42,0,0,0,0,0,1,43,43,42,0,0,0,0,0,1,0,0,0,0,0,0,0,0,110010004001015,2,204,204,2,psa_44,2D2
1000000US110010070002016,"Block 2016, Block Group 2, Census Tract 70, District of Columbia, District of Columbia",203,177,17,1,3,0,2,3,203,190,171,14,1,3,0,1,0,13,6,3,0,0,0,1,3,110010070002016,1,106,106,1,psa_13,1D3
1000000US110010042011003,"Block 1003, Block Group 1, Census Tract 42.01, District of Columbia, District of Columbia",100,88,1,0,5,0,0,6,100,84,73,1,0,5,0,0,5,16,15,0,0,0,0,0,1,110010042011003,3,301,301,3,psa_31,3D3
1000000US110010062021058,"Block 1058, Block Group 1, Census Tract 62.02, District of Columbia, District of Columbia",0,0,0,0,0,0,0,0,0,0,0,0,0,0,0,0,0,0,0,0,0,0,0,0,0,110010062021058,2,207,207,2,psa_24,2D3
1000000US110010077082019,"Block 2019, Block Group 2, Census Tract 77.08, District of Columbia, District of Columbia",0,0,0,0,0,0,0,0,0,0,0,0,0,0,0,0,0,0,0,0,0,0,0,0,0,110010077082019,6,605,605,6,psa_11,6D2
1000000US110010106002004,"Block 2004, Block Group 2, Census Tract 106, District of Columbia, District of Columbia",0,0,0,0,0,0,0,0,0,0,0,0,0,0,0,0,0,0,0,0,0,0,0,0,0,110010106002004,5,501,501,5,psa_35,5D1
1000000US110010014012006,"Block 2006, Block Group 2, Census Tract 14.01, District of Columbia, District of Columbia",93,90,3,0,0,0,0,0,93,91,88,3,0,0,0,0,0,2,2,0,0,0,0,0,0,110010014012006,2,201,201,2,psa_55,2D1
1000000US110010087021011,"Block 1011, Block Group 1, Census Tract 87.02, District of Columbia, District of Columbia",59,20,33,1,2,0,3,0,59,49,13,33,1,1,0,1,0,10,7,0,0,1,0,2,0,110010087021011,5,502,502,5,psa_40,5D1
1000000US110010096033002,"Block 3002, Block Group 3, Census Tract 96.03, District of Columbia, District of Columbia",37,0,37,0,0,0,0,0,37,37,0,37,0,0,0,0,0,0,0,0,0,0,0,0,0,110010096033002,6,603,603,6,psa_15,6D3
1000000US110010014021014,"Block 1014, Block Group 1, Census Tract 14.02, District of Columbia, District of Columbia",42,27,13,0,2,0,0,0,42,39,26,11,0,2,0,0,0,3,1,2,0,0,0,0,0,110010014021014,2,201,201,2,psa_55,2D1
1000000US110010078083008,"Block 3008, Block Group 3, Census Tract 78.08, District of Columbia, District of Columbia",113,1,107,0,0,0,5,0,113,108,1,107,0,0,0,0,0,5,0,0,0,0,0,5,0,110010078083008,6,608,608,6,psa_19,6D1
1000000US110010095051001,"Block 1001, Block Group 1, Census Tract 95.05, District of Columbia, District of Columbia",14,0,13,0,0,0,0,1,14,14,0,13,0,0,0,0,1,0,0,0,0,0,0,0,0,110010095051001,4,406,406,4,psa_54,4D2
1000000US110010073011019,"Block 1019, Block Group 1, Census Tract 73.01, District of Columbia, District of Columbia",33,26,7,0,0,0,0,0,33,33,26,7,0,0,0,0,0,0,0,0,0,0,0,0,0,110010073011019,7,707,707,7,psa_4,7D2
1000000US110010102002000,"Block 2000, Block Group 2, Census Tract 102, District of Columbia, District of Columbia",0,0,0,0,0,0,0,0,0,0,0,0,0,0,0,0,0,0,0,0,0,0,0,0,0,110010102002000,1,103,103,1,psa_12,1D1
1000000US110010059001006,"Block 1006, Block Group 1, Census Tract 59, District of Columbia, District of Columbia",0,0,0,0,0,0,0,0,0,0,0,0,0,0,0,0,0,0,0,0,0,0,0,0,0,110010059001006,1,101,101,1,psa_20,1D1
1000000US110010076015023,"Block 5023, Block Group 5, Census Tract 76.01, District of Columbia, District of Columbia",0,0,0,0,0,0,0,0,0,0,0,0,0,0,0,0,0,0,0,0,0,0,0,0,0,110010076015023,7,701,701,7,psa_9,7D1
1000000US110010005011009,"Block 1009, Block Group 1, Census Tract 5.01, District of Columbia, District of Columbia",0,0,0,0,0,0,0,0,0,0,0,0,0,0,0,0,0,0,0,0,0,0,0,0,0,110010005011009,2,204,204,2,psa_44,2D2
1000000US110010087022005,"Block 2005, Block Group 2, Census Tract 87.02, District of Columbia, District of Columbia",150,9,131,2,1,0,1,6,150,147,9,129,2,1,0,0,6,3,0,2,0,0,0,1,0,110010087022005,5,502,502,5,psa_40,5D1
1000000US110010088031023,"Block 1023, Block Group 1, Census Tract 88.03, District of Columbia, District of Columbia",0,0,0,0,0,0,0,0,0,0,0,0,0,0,0,0,0,0,0,0,0,0,0,0,0,110010088031023,5,501,501,5,psa_35,5D1
1000000US110010098112003,"Block 2003, Block Group 2, Census Tract 98.11, District of Columbia, District of Columbia",64,0,64,0,0,0,0,0,64,64,0,64,0,0,0,0,0,0,0,0,0,0,0,0,0,110010098112003,7,706,706,7,psa_2,7D3
1000000US110010023021012,"Block 1012, Block Group 1, Census Tract 23.02, District of Columbia, District of Columbia",0,0,0,0,0,0,0,0,0,0,0,0,0,0,0,0,0,0,0,0,0,0,0,0,0,110010023021012,4,405,405,4,psa_49,4D2
1000000US110010098021000,"Block 1000, Block Group 1, Census Tract 98.02, District of Columbia, District of Columbia",358,1,353,1,0,0,0,3,358,357,1,352,1,0,0,0,3,1,0,1,0,0,0,0,0,110010098021000,7,706,706,7,psa_2,7D3
1000000US110010001001009,"Block 1009, Block Group 1, Census Tract 1, District of Columbia, District of Columbia",114,103,2,0,6,0,1,2,114,106,95,2,0,6,0,1,2,8,8,0,0,0,0,0,0,110010001001009,2,206,206,2,psa_29,2D2
1000000US110010078033007,"Block 3007, Block Group 3, Census Tract 78.03, District of Columbia, District of Columbia",23,0,23,0,0,0,0,0,23,22,0,22,0,0,0,0,0,1,0,1,0,0,0,0,0,110010078033007,6,608,608,6,psa_19,6D1
1000000US110010035001001,"Block 1001, Block Group 1, Census Tract 35, District of Columbia, District of Columbia",91,38,47,4,0,0,2,0,91,84,38,42,4,0,0,0,0,7,0,5,0,0,0,2,0,110010035001001,3,304,304,3,psa_36,3D1
1000000US110010098042002,"Block 2002, Block Group 2, Census Tract 98.04, District of Columbia, District of Columbia",136,0,130,0,0,0,0,6,136,131,0,129,0,0,0,0,2,5,0,1,0,0,0,0,4,110010098042002,7,707,707,7,psa_4,7D2
1000000US110010098072005,"Block 2005, Block Group 2, Census Tract 98.07, District of Columbia, District of Columbia",230,0,226,0,0,0,0,4,230,230,0,226,0,0,0,0,4,0,0,0,0,0,0,0,0,110010098072005,7,708,708,7,psa_1,7D3
1000000US110010092032001,"Block 2001, Block Group 2, Census Tract 92.03, District of Columbia, District of Columbia",97,14,79,0,0,0,0,4,97,97,14,79,0,0,0,0,4,0,0,0,0,0,0,0,0,110010092032001,5,502,502,5,psa_40,5D1
1000000US110010078031001,"Block 1001, Block Group 1, Census Tract 78.03, District of Columbia, District of Columbia",0,0,0,0,0,0,0,0,0,0,0,0,0,0,0,0,0,0,0,0,0,0,0,0,0,110010078031001,6,602,602,6,psa_25,6D1
1000000US110010019022013,"Block 2013, Block Group 2, Census Tract 19.02, District of Columbia, District of Columbia",69,10,57,0,1,0,1,0,69,65,7,57,0,1,0,0,0,4,3,0,0,0,0,1,0,110010019022013,4,406,406,4,psa_54,4D2
1000000US110010065002028,"Block 2028, Block Group 2, Census Tract 65, District of Columbia, District of Columbia",0,0,0,0,0,0,0,0,0,0,0,0,0,0,0,0,0,0,0,0,0,0,0,0,0,110010065002028,1,106,106,1,psa_13,1D3
1000000US110010074092002,"Block 2002, Block Group 2, Census Tract 74.09, District of Columbia, District of Columbia",183,0,167,0,5,0,1,10,183,182,0,167,0,5,0,0,10,1,0,0,0,0,0,1,0,110010074092002,7,704,704,7,psa_5,7D2
1000000US110010001001011,"Block 1011, Block Group 1, Census Tract 1, District of Columbia, District of Columbia",174,159,6,0,8,0,1,0,174,162,148,6,0,8,0,0,0,12,11,0,0,0,0,1,0,110010001001011,2,206,206,2,psa_29,2D2
1000000US110010065002027,"Block 2027, Block Group 2, Census Tract 65, District of Columbia, District of Columbia",0,0,0,0,0,0,0,0,0,0,0,0,0,0,0,0,0,0,0,0,0,0,0,0,0,110010065002027,1,106,106,1,psa_13,1D3
1000000US110010062021162,"Block 1162, Block Group 1, Census Tract 62.02, District of Columbia, District of Columbia",0,0,0,0,0,0,0,0,0,0,0,0,0,0,0,0,0,0,0,0,0,0,0,0,0,110010062021162,2,207,207,2,psa_24,2D3
1000000US110010097001017,"Block 1017, Block Group 1, Census Tract 97, District of Columbia, District of Columbia",169,2,165,1,0,0,0,1,169,168,2,164,1,0,0,0,1,1,0,1,0,0,0,0,0,110010097001017,7,706,706,7,psa_2,7D3
1000000US110010005011007,"Block 1007, Block Group 1, Census Tract 5.01, District of Columbia, District of Columbia",215,181,3,0,16,0,4,11,215,204,174,3,0,16,0,0,11,11,7,0,0,0,0,4,0,110010005011007,2,204,204,2,psa_44,2D2
1000000US110010055001014,"Block 1014, Block Group 1, Census Tract 55, District of Columbia, District of Columbia",0,0,0,0,0,0,0,0,0,0,0,0,0,0,0,0,0,0,0,0,0,0,0,0,0,110010055001014,2,208,208,2,psa_33,2D3
1000000US110010056002001,"Block 2001, Block Group 2, Census Tract 56, District of Columbia, District of Columbia",0,0,0,0,0,0,0,0,0,0,0,0,0,0,0,0,0,0,0,0,0,0,0,0,0,110010056002001,2,207,207,2,psa_24,2D3
1000000US110010010015014,"Block 5014, Block Group 5, Census Tract 10.01, District of Columbia, District of Columbia",40,31,2,0,6,0,1,0,40,35,27,2,0,6,0,0,0,5,4,0,0,0,0,1,0,110010010015014,2,202,202,2,psa_52,2D1
1000000US110010078082012,"Block 2012, Block Group 2, Census Tract 78.08, District of Columbia, District of Columbia",63,0,63,0,0,0,0,0,63,63,0,63,0,0,0,0,0,0,0,0,0,0,0,0,0,110010078082012,6,608,608,6,psa_19,6D1
1000000US110010004001008,"Block 1008, Block Group 1, Census Tract 4, District of Columbia, District of Columbia",41,34,7,0,0,0,0,0,41,38,31,7,0,0,0,0,0,3,3,0,0,0,0,0,0,110010004001008,2,204,204,2,psa_44,2D2
1000000US110010014011009,"Block 1009, Block Group 1, Census Tract 14.01, District of Columbia, District of Columbia",49,48,0,0,0,0,0,1,49,49,48,0,0,0,0,0,1,0,0,0,0,0,0,0,0,110010014011009,2,201,201,2,psa_55,2D1
1000000US110010020023010,"Block 3010, Block Group 3, Census Tract 20.02, District of Columbia, District of Columbia",134,24,100,0,0,0,5,5,134,125,20,99,0,0,0,3,3,9,4,1,0,0,0,2,2,110010020023010,4,404,404,4,psa_48,4D3
1000000US110010088022008,"Block 2008, Block Group 2, Census Tract 88.02, District of Columbia, District of Columbia",200,8,187,1,1,0,0,3,200,198,8,185,1,1,0,0,3,2,0,2,0,0,0,0,0,110010088022008,5,506,506,5,psa_26,5D3
1000000US110010017021017,"Block 1017, Block Group 1, Census Tract 17.02, District of Columbia, District of Columbia",28,14,10,0,0,0,0,4,28,27,13,10,0,0,0,0,4,1,1,0,0,0,0,0,0,110010017021017,4,401,401,4,psa_56,4D1
1000000US110010041001001,"Block 1001, Block Group 1, Census Tract 41, District of Columbia, District of Columbia",342,282,13,0,28,0,13,6,342,292,244,13,0,28,0,3,4,50,38,0,0,0,0,10,2,110010041001001,2,208,208,2,psa_33,2D3
1000000US110010069001013,"Block 1013, Block Group 1, Census Tract 69, District of Columbia, District of Columbia",0,0,0,0,0,0,0,0,0,0,0,0,0,0,0,0,0,0,0,0,0,0,0,0,0,110010069001013,1,106,106,1,psa_13,1D3
1000000US110010096011028,"Block 1028, Block Group 1, Census Tract 96.01, District of Columbia, District of Columbia",14,0,14,0,0,0,0,0,14,14,0,14,0,0,0,0,0,0,0,0,0,0,0,0,0,110010096011028,6,601,601,6,psa_30,6D1
1000000US110010012004025,"Block 4025, Block Group 4, Census Tract 12, District of Columbia, District of Columbia",57,48,0,0,9,0,0,0,57,56,47,0,0,9,0,0,0,1,1,0,0,0,0,0,0,110010012004025,2,202,202,2,psa_52,2D1
1000000US110010011001020,"Block 1020, Block Group 1, Census Tract 11, District of Columbia, District of Columbia",38,38,0,0,0,0,0,0,38,38,38,0,0,0,0,0,0,0,0,0,0,0,0,0,0,110010011001020,2,201,201,2,psa_55,2D1
1000000US110010012002002,"Block 2002, Block Group 2, Census Tract 12, District of Columbia, District of Columbia",74,60,6,1,3,1,1,2,74,70,57,6,1,3,1,0,2,4,3,0,0,0,0,1,0,110010012002002,2,202,202,2,psa_52,2D1
1000000US110010048011003,"Block 1003, Block Group 1, Census Tract 48.01, District of Columbia, District of Columbia",30,11,9,2,0,0,6,2,30,22,11,9,2,0,0,0,0,8,0,0,0,0,0,6,2,110010048011003,3,306,306,3,psa_38,3D2
1000000US110010071001012,"Block 1012, Block Group 1, Census Tract 71, District of Columbia, District of Columbia",0,0,0,0,0,0,0,0,0,0,0,0,0,0,0,0,0,0,0,0,0,0,0,0,0,110010071001012,1,106,106,1,psa_13,1D3
1000000US110010009012010,"Block 2010, Block Group 2, Census Tract 9.01, District of Columbia, District of Columbia",26,25,0,0,1,0,0,0,26,20,19,0,0,1,0,0,0,6,6,0,0,0,0,0,0,110010009012010,2,205,205,2,psa_46,2D2
1000000US110010074043002,"Block 3002, Block Group 3, Census Tract 74.04, District of Columbia, District of Columbia",0,0,0,0,0,0,0,0,0,0,0,0,0,0,0,0,0,0,0,0,0,0,0,0,0,110010074043002,7,703,703,7,psa_8,7D1
1000000US110010079031017,"Block 1017, Block Group 1, Census Tract 79.03, District of Columbia, District of Columbia",43,4,38,0,0,0,0,1,43,42,4,37,0,0,0,0,1,1,0,1,0,0,0,0,0,110010079031017,5,507,507,5,psa_23,5D3
1000000US110010076015012,"Block 5012, Block Group 5, Census Tract 76.01, District of Columbia, District of Columbia",0,0,0,0,0,0,0,0,0,0,0,0,0,0,0,0,0,0,0,0,0,0,0,0,0,110010076015012,6,607,607,6,psa_10,6D2
1000000US110010055001008,"Block 1008, Block Group 1, Census Tract 55, District of Columbia, District of Columbia",2,2,0,0,0,0,0,0,2,2,2,0,0,0,0,0,0,0,0,0,0,0,0,0,0,110010055001008,2,208,208,2,psa_33,2D3
1000000US110010076013010,"Block 3010, Block Group 3, Census Tract 76.01, District of Columbia, District of Columbia",73,4,66,0,0,0,0,3,73,71,2,66,0,0,0,0,3,2,2,0,0,0,0,0,0,110010076013010,6,607,607,6,psa_10,6D2
1000000US110010018042006,"Block 2006, Block Group 2, Census Tract 18.04, District of Columbia, District of Columbia",0,0,0,0,0,0,0,0,0,0,0,0,0,0,0,0,0,0,0,0,0,0,0,0,0,110010018042006,4,402,402,4,psa_53,4D1
1000000US110010072002001,"Block 2001, Block Group 2, Census Tract 72, District of Columbia, District of Columbia",0,0,0,0,0,0,0,0,0,0,0,0,0,0,0,0,0,0,0,0,0,0,0,0,0,110010072002001,1,106,106,1,psa_13,1D3
1000000US110010004002004,"Block 2004, Block Group 2, Census Tract 4, District of Columbia, District of Columbia",53,45,0,0,3,0,1,4,53,44,38,0,0,3,0,0,3,9,7,0,0,0,0,1,1,110010004002004,2,204,204,2,psa_44,2D2
1000000US110010034002006,"Block 2006, Block Group 2, Census Tract 34, District of Columbia, District of Columbia",0,0,0,0,0,0,0,0,0,0,0,0,0,0,0,0,0,0,0,0,0,0,0,0,0,110010034002006,3,306,306,3,psa_38,3D2
1000000US110010107001001,"Block 1001, Block Group 1, Census Tract 107, District of Columbia, District of Columbia",0,0,0,0,0,0,0,0,0,0,0,0,0,0,0,0,0,0,0,0,0,0,0,0,0,110010107001001,2,207,207,2,psa_24,2D3
1000000US110010039003004,"Block 3004, Block Group 3, Census Tract 39, District of Columbia, District of Columbia",0,0,0,0,0,0,0,0,0,0,0,0,0,0,0,0,0,0,0,0,0,0,0,0,0,110010039003004,3,303,303,3,psa_37,3D3
1000000US110010076011002,"Block 1002, Block Group 1, Census Tract 76.01, District of Columbia, District of Columbia",156,9,138,0,2,0,0,7,156,156,9,138,0,2,0,0,7,0,0,0,0,0,0,0,0,110010076011002,6,607,607,6,psa_10,6D2
1000000US110010099053002,"Block 3002, Block Group 3, Census Tract 99.05, District of Columbia, District of Columbia",118,4,106,0,0,1,2,5,118,114,4,104,0,0,1,0,5,4,0,2,0,0,0,2,0,110010099053002,6,604,604,6,psa_14,6D3
1000000US110010077031005,"Block 1005, Block Group 1, Census Tract 77.03, District of Columbia, District of Columbia",151,18,34,1,0,0,91,7,151,31,0,31,0,0,0,0,0,120,18,3,1,0,0,91,7,110010077031005,6,603,603,6,psa_15,6D3
1000000US110010009022018,"Block 2018, Block Group 2, Census Tract 9.02, District of Columbia, District of Columbia",73,70,1,0,0,0,0,2,73,65,62,1,0,0,0,0,2,8,8,0,0,0,0,0,0,110010009022018,2,205,205,2,psa_46,2D2
1000000US110010012004003,"Block 4003, Block Group 4, Census Tract 12, District of Columbia, District of Columbia",68,63,0,0,2,0,0,3,68,68,63,0,0,2,0,0,3,0,0,0,0,0,0,0,0,110010012004003,2,202,202,2,psa_52,2D1
1000000US110010041002005,"Block 2005, Block Group 2, Census Tract 41, District of Columbia, District of Columbia",17,17,0,0,0,0,0,0,17,15,15,0,0,0,0,0,0,2,2,0,0,0,0,0,0,110010041002005,2,208,208,2,psa_33,2D3
1000000US110010025011001,"Block 1001, Block Group 1, Census Tract 25.01, District of Columbia, District of Columbia",61,6,44,0,0,0,5,6,61,52,6,44,0,0,0,0,2,9,0,0,0,0,0,5,4,110010025011001,4,404,404,4,psa_48,4D3
1000000US110010034002008,"Block 2008, Block Group 2, Census Tract 34, District of Columbia, District of Columbia",0,0,0,0,0,0,0,0,0,0,0,0,0,0,0,0,0,0,0,0,0,0,0,0,0,110010034002008,3,306,306,3,psa_38,3D2
1000000US110010062021064,"Block 1064, Block Group 1, Census Tract 62.02, District of Columbia, District of Columbia",0,0,0,0,0,0,0,0,0,0,0,0,0,0,0,0,0,0,0,0,0,0,0,0,0,110010062021064,2,207,207,2,psa_24,2D3
1000000US110010019013003,"Block 3003, Block Group 3, Census Tract 19.01, District of Columbia, District of Columbia",42,6,23,7,1,0,5,0,42,21,0,20,0,1,0,0,0,21,6,3,7,0,0,5,0,110010019013003,4,402,402,4,psa_53,4D1
1000000US110010020012003,"Block 2003, Block Group 2, Census Tract 20.01, District of Columbia, District of Columbia",0,0,0,0,0,0,0,0,0,0,0,0,0,0,0,0,0,0,0,0,0,0,0,0,0,110010020012003,4,403,403,4,psa_51,4D1
1000000US110010015001004,"Block 1004, Block Group 1, Census Tract 15, District of Columbia, District of Columbia",0,0,0,0,0,0,0,0,0,0,0,0,0,0,0,0,0,0,0,0,0,0,0,0,0,110010015001004,4,401,401,4,psa_56,4D1
1000000US110010111001037,"Block 1037, Block Group 1, Census Tract 111, District of Columbia, District of Columbia",108,3,91,0,0,0,7,7,108,101,3,91,0,0,0,0,7,7,0,0,0,0,0,7,0,110010111001037,5,503,503,5,psa_45,5D2
1000000US110010021021009,"Block 1009, Block Group 1, Census Tract 21.02, District of Columbia, District of Columbia",0,0,0,0,0,0,0,0,0,0,0,0,0,0,0,0,0,0,0,0,0,0,0,0,0,110010021021009,4,402,402,4,psa_53,4D1
1000000US110010016004031,"Block 4031, Block Group 4, Census Tract 16, District of Columbia, District of Columbia",0,0,0,0,0,0,0,0,0,0,0,0,0,0,0,0,0,0,0,0,0,0,0,0,0,110010016004031,2,201,201,2,psa_55,2D1
1000000US110010077081005,"Block 1005, Block Group 1, Census Tract 77.08, District of Columbia, District of Columbia",67,0,67,0,0,0,0,0,67,67,0,67,0,0,0,0,0,0,0,0,0,0,0,0,0,110010077081005,6,603,603,6,psa_15,6D3
1000000US110010062021126,"Block 1126, Block Group 1, Census Tract 62.02, District of Columbia, District of Columbia",0,0,0,0,0,0,0,0,0,0,0,0,0,0,0,0,0,0,0,0,0,0,0,0,0,110010062021126,1,102,102,1,psa_18,1D1
1000000US110010089031015,"Block 1015, Block Group 1, Census Tract 89.03, District of Columbia, District of Columbia",0,0,0,0,0,0,0,0,0,0,0,0,0,0,0,0,0,0,0,0,0,0,0,0,0,110010089031015,5,507,507,5,psa_23,5D3
1000000US110010055003012,"Block 3012, Block Group 3, Census Tract 55, District of Columbia, District of Columbia",0,0,0,0,0,0,0,0,0,0,0,0,0,0,0,0,0,0,0,0,0,0,0,0,0,110010055003012,2,207,207,2,psa_24,2D3
1000000US110010021021008,"Block 1008, Block Group 1, Census Tract 21.02, District of Columbia, District of Columbia",82,0,73,0,4,0,1,4,82,79,0,71,0,4,0,0,4,3,0,2,0,0,0,1,0,110010021021008,4,406,406,4,psa_54,4D2
1000000US110010070001005,"Block 1005, Block Group 1, Census Tract 70, District of Columbia, District of Columbia",128,104,10,0,4,0,5,5,128,113,96,9,0,4,0,0,4,15,8,1,0,0,0,5,1,110010070001005,1,106,106,1,psa_13,1D3
1000000US110010044001005,"Block 1005, Block Group 1, Census Tract 44, District of Columbia, District of Columbia",69,43,17,0,4,0,0,5,69,63,39,15,0,4,0,0,5,6,4,2,0,0,0,0,0,110010044001005,3,305,305,3,psa_32,3D2
1000000US110010062021045,"Block 1045, Block Group 1, Census Tract 62.02, District of Columbia, District of Columbia",0,0,0,0,0,0,0,0,0,0,0,0,0,0,0,0,0,0,0,0,0,0,0,0,0,110010062021045,2,207,207,2,psa_24,2D3
1000000US110010073041005,"Block 1005, Block Group 1, Census Tract 73.04, District of Columbia, District of Columbia",162,1,156,0,0,0,0,5,162,162,1,156,0,0,0,0,5,0,0,0,0,0,0,0,0,110010073041005,7,705,705,7,psa_3,7D2
1000000US110010111001034,"Block 1034, Block Group 1, Census Tract 111, District of Columbia, District of Columbia",0,0,0,0,0,0,0,0,0,0,0,0,0,0,0,0,0,0,0,0,0,0,0,0,0,110010111001034,5,503,503,5,psa_45,5D2
1000000US110010005011003,"Block 1003, Block Group 1, Census Tract 5.01, District of Columbia, District of Columbia",0,0,0,0,0,0,0,0,0,0,0,0,0,0,0,0,0,0,0,0,0,0,0,0,0,110010005011003,2,204,204,2,psa_44,2D2
1000000US110010011004024,"Block 4024, Block Group 4, Census Tract 11, District of Columbia, District of Columbia",20,20,0,0,0,0,0,0,20,16,16,0,0,0,0,0,0,4,4,0,0,0,0,0,0,110010011004024,2,202,202,2,psa_52,2D1
1000000US110010074081000,"Block 1000, Block Group 1, Census Tract 74.08, District of Columbia, District of Columbia",1136,23,1097,3,2,0,0,11,1136,1113,17,1080,3,2,0,0,11,23,6,17,0,0,0,0,0,110010074081000,7,702,702,7,psa_6,7D1
1000000US110010026002028,"Block 2028, Block Group 2, Census Tract 26, District of Columbia, District of Columbia",65,23,41,0,1,0,0,0,65,59,17,41,0,1,0,0,0,6,6,0,0,0,0,0,0,110010026002028,4,404,404,4,psa_48,4D3
1000000US110010036003000,"Block 3000, Block Group 3, Census Tract 36, District of Columbia, District of Columbia",178,98,55,1,5,0,8,11,178,162,92,54,1,5,0,0,10,16,6,1,0,0,0,8,1,110010036003000,3,304,304,3,psa_36,3D1
1000000US110010073041012,"Block 1012, Block Group 1, Census Tract 73.04, District of Columbia, District of Columbia",300,5,291,0,3,1,0,0,300,298,5,289,0,3,1,0,0,2,0,2,0,0,0,0,0,110010073041012,7,706,706,7,psa_2,7D3
1000000US110010102001019,"Block 1019, Block Group 1, Census Tract 102, District of Columbia, District of Columbia",177,77,84,0,10,0,0,6,177,170,73,83,0,10,0,0,4,7,4,1,0,0,0,0,2,110010102001019,1,103,103,1,psa_12,1D1
1000000US110010104002038,"Block 2038, Block Group 2, Census Tract 104, District of Columbia, District of Columbia",0,0,0,0,0,0,0,0,0,0,0,0,0,0,0,0,0,0,0,0,0,0,0,0,0,110010104002038,7,703,703,7,psa_8,7D1
1000000US110010014011000,"Block 1000, Block Group 1, Census Tract 14.01, District of Columbia, District of Columbia",0,0,0,0,0,0,0,0,0,0,0,0,0,0,0,0,0,0,0,0,0,0,0,0,0,110010014011000,2,201,201,2,psa_55,2D1
1000000US110010073011007,"Block 1007, Block Group 1, Census Tract 73.01, District of Columbia, District of Columbia",131,83,33,2,7,0,4,2,131,114,73,31,1,7,0,0,2,17,10,2,1,0,0,4,0,110010073011007,7,703,703,7,psa_8,7D1
1000000US110010068012004,"Block 2004, Block Group 2, Census Tract 68.01, District of Columbia, District of Columbia",125,56,58,1,3,0,0,7,125,121,54,58,1,3,0,0,5,4,2,0,0,0,0,0,2,110010068012004,1,107,107,1,psa_16,1D2
1000000US110010073011130,"Block 1130, Block Group 1, Census Tract 73.01, District of Columbia, District of Columbia",0,0,0,0,0,0,0,0,0,0,0,0,0,0,0,0,0,0,0,0,0,0,0,0,0,110010073011130,7,708,708,7,psa_1,7D3
1000000US110010099012017,"Block 2017, Block Group 2, Census Tract 99.01, District of Columbia, District of Columbia",32,0,29,0,0,0,0,3,32,31,0,29,0,0,0,0,2,1,0,0,0,0,0,0,1,110010099012017,6,605,605,6,psa_11,6D2
1000000US110010059001029,"Block 1029, Block Group 1, Census Tract 59, District of Columbia, District of Columbia",0,0,0,0,0,0,0,0,0,0,0,0,0,0,0,0,0,0,0,0,0,0,0,0,0,110010059001029,1,102,102,1,psa_18,1D1
1000000US110010095071005,"Block 1005, Block Group 1, Census Tract 95.07, District of Columbia, District of Columbia",137,1,128,0,0,0,8,0,137,125,1,124,0,0,0,0,0,12,0,4,0,0,0,8,0,110010095071005,4,406,406,4,psa_54,4D2
1000000US110010093021009,"Block 1009, Block Group 1, Census Tract 93.02, District of Columbia, District of Columbia",74,24,48,0,2,0,0,0,74,74,24,48,0,2,0,0,0,0,0,0,0,0,0,0,0,110010093021009,5,504,504,5,psa_43,5D2
1000000US110010098072000,"Block 2000, Block Group 2, Census Tract 98.07, District of Columbia, District of Columbia",408,23,367,2,0,0,2,14,408,379,6,358,2,0,0,0,13,29,17,9,0,0,0,2,1,110010098072000,7,708,708,7,psa_1,7D3
1000000US110010078083005,"Block 3005, Block Group 3, Census Tract 78.08, District of Columbia, District of Columbia",0,0,0,0,0,0,0,0,0,0,0,0,0,0,0,0,0,0,0,0,0,0,0,0,0,110010078083005,6,608,608,6,psa_19,6D1
1000000US110010098071001,"Block 1001, Block Group 1, Census Tract 98.07, District of Columbia, District of Columbia",0,0,0,0,0,0,0,0,0,0,0,0,0,0,0,0,0,0,0,0,0,0,0,0,0,110010098071001,7,707,707,7,psa_4,7D2
1000000US110010016001015,"Block 1015, Block Group 1, Census Tract 16, District of Columbia, District of Columbia",30,6,24,0,0,0,0,0,30,30,6,24,0,0,0,0,0,0,0,0,0,0,0,0,0,110010016001015,4,401,401,4,psa_56,4D1
1000000US110010108001004,"Block 1004, Block Group 1, Census Tract 108.00, District of Columbia, District of Columbia",0,0,0,0,0,0,0,0,0,0,0,0,0,0,0,0,0,0,0,0,0,0,0,0,0,110010108001004,2,207,207,2,psa_24,2D3
1000000US110010067003001,"Block 3001, Block Group 3, Census Tract 67, District of Columbia, District of Columbia",110,95,8,0,4,0,0,3,110,106,91,8,0,4,0,0,3,4,4,0,0,0,0,0,0,110010067003001,1,107,107,1,psa_16,1D2
1000000US110010043001007,"Block 1007, Block Group 1, Census Tract 43, District of Columbia, District of Columbia",101,84,8,0,4,0,0,5,101,92,77,6,0,4,0,0,5,9,7,2,0,0,0,0,0,110010043001007,3,301,301,3,psa_31,3D3
1000000US110010076052004,"Block 2004, Block Group 2, Census Tract 76.05, District of Columbia, District of Columbia",0,0,0,0,0,0,0,0,0,0,0,0,0,0,0,0,0,0,0,0,0,0,0,0,0,110010076052004,6,606,606,6,psa_7,6D2
1000000US110010041002013,"Block 2013, Block Group 2, Census Tract 41, District of Columbia, District of Columbia",32,26,0,2,0,0,1,3,32,26,26,0,0,0,0,0,0,6,0,0,2,0,0,1,3,110010041002013,2,208,208,2,psa_33,2D3
1000000US110010062021044,"Block 1044, Block Group 1, Census Tract 62.02, District of Columbia, District of Columbia",0,0,0,0,0,0,0,0,0,0,0,0,0,0,0,0,0,0,0,0,0,0,0,0,0,110010062021044,2,207,207,2,psa_24,2D3
1000000US110010097001005,"Block 1005, Block Group 1, Census Tract 97, District of Columbia, District of Columbia",0,0,0,0,0,0,0,0,0,0,0,0,0,0,0,0,0,0,0,0,0,0,0,0,0,110010097001005,7,706,706,7,psa_2,7D3
1000000US110010099032004,"Block 2004, Block Group 2, Census Tract 99.03, District of Columbia, District of Columbia",99,0,99,0,0,0,0,0,99,99,0,99,0,0,0,0,0,0,0,0,0,0,0,0,0,110010099032004,6,604,604,6,psa_14,6D3
1000000US110010111003027,"Block 3027, Block Group 3, Census Tract 111, District of Columbia, District of Columbia",0,0,0,0,0,0,0,0,0,0,0,0,0,0,0,0,0,0,0,0,0,0,0,0,0,110010111003027,5,503,503,5,psa_45,5D2
1000000US110010008014002,"Block 4002, Block Group 4, Census Tract 8.01, District of Columbia, District of Columbia",76,63,0,0,1,0,12,0,76,62,56,0,0,1,0,5,0,14,7,0,0,0,0,7,0,110010008014002,2,205,205,2,psa_46,2D2
1000000US110010078091006,"Block 1006, Block Group 1, Census Tract 78.09, District of Columbia, District of Columbia",162,2,159,0,0,0,0,1,162,161,2,158,0,0,0,0,1,1,0,1,0,0,0,0,0,110010078091006,6,608,608,6,psa_19,6D1
1000000US110010021026005,"Block 6005, Block Group 6, Census Tract 21.02, District of Columbia, District of Columbia",114,7,92,0,0,0,15,0,114,86,1,85,0,0,0,0,0,28,6,7,0,0,0,15,0,110010021026005,4,403,403,4,psa_51,4D1
1000000US110010062021228,"Block 1228, Block Group 1, Census Tract 62.02, District of Columbia, District of Columbia",0,0,0,0,0,0,0,0,0,0,0,0,0,0,0,0,0,0,0,0,0,0,0,0,0,110010062021228,1,103,103,1,psa_12,1D1
1000000US110010101002001,"Block 2001, Block Group 2, Census Tract 101, District of Columbia, District of Columbia",676,312,79,2,217,0,39,27,676,569,248,76,2,216,0,9,18,107,64,3,0,1,0,30,9,110010101002001,2,208,208,2,psa_33,2D3
1000000US110010006004017,"Block 4017, Block Group 4, Census Tract 6, District of Columbia, District of Columbia",65,65,0,0,0,0,0,0,65,62,62,0,0,0,0,0,0,3,3,0,0,0,0,0,0,110010006004017,2,203,203,2,psa_50,2D1
1000000US110010010016020,"Block 6020, Block Group 6, Census Tract 10.01, District of Columbia, District of Columbia",55,52,0,0,2,0,1,0,55,53,51,0,0,2,0,0,0,2,1,0,0,0,0,1,0,110010010016020,2,202,202,2,psa_52,2D1
1000000US110010070001006,"Block 1006, Block Group 1, Census Tract 70, District of Columbia, District of Columbia",0,0,0,0,0,0,0,0,0,0,0,0,0,0,0,0,0,0,0,0,0,0,0,0,0,110010070001006,1,106,106,1,psa_13,1D3
1000000US110010010015010,"Block 5010, Block Group 5, Census Tract 10.01, District of Columbia, District of Columbia",78,61,8,1,8,0,0,0,78,71,55,8,0,8,0,0,0,7,6,0,1,0,0,0,0,110010010015010,2,202,202,2,psa_52,2D1
1000000US110010012003008,"Block 3008, Block Group 3, Census Tract 12, District of Columbia, District of Columbia",79,72,5,0,2,0,0,0,79,73,66,5,0,2,0,0,0,6,6,0,0,0,0,0,0,110010012003008,2,202,202,2,psa_52,2D1
1000000US110010012004021,"Block 4021, Block Group 4, Census Tract 12, District of Columbia, District of Columbia",76,65,1,0,2,0,0,8,76,75,64,1,0,2,0,0,8,1,1,0,0,0,0,0,0,110010012004021,2,202,202,2,psa_52,2D1
1000000US110010001002008,"Block 2008, Block Group 2, Census Tract 1, District of Columbia, District of Columbia",104,96,5,3,0,0,0,0,104,101,93,5,3,0,0,0,0,3,3,0,0,0,0,0,0,110010001002008,2,206,206,2,psa_29,2D2
1000000US110010088031030,"Block 1030, Block Group 1, Census Tract 88.03, District of Columbia, District of Columbia",0,0,0,0,0,0,0,0,0,0,0,0,0,0,0,0,0,0,0,0,0,0,0,0,0,110010088031030,5,501,501,5,psa_35,5D1
1000000US110010091021006,"Block 1006, Block Group 1, Census Tract 91.02, District of Columbia, District of Columbia",10,0,10,0,0,0,0,0,10,10,0,10,0,0,0,0,0,0,0,0,0,0,0,0,0,110010091021006,5,505,505,5,psa_34,5D2
1000000US110010096011021,"Block 1021, Block Group 1, Census Tract 96.01, District of Columbia, District of Columbia",29,0,29,0,0,0,0,0,29,29,0,29,0,0,0,0,0,0,0,0,0,0,0,0,0,110010096011021,6,601,601,6,psa_30,6D1
1000000US110010017022005,"Block 2005, Block Group 2, Census Tract 17.02, District of Columbia, District of Columbia",19,12,2,0,4,0,0,1,19,18,12,1,0,4,0,0,1,1,0,1,0,0,0,0,0,110010017022005,4,401,401,4,psa_56,4D1
1000000US110010019011003,"Block 1003, Block Group 1, Census Tract 19.01, District of Columbia, District of Columbia",23,4,16,0,3,0,0,0,23,23,4,16,0,3,0,0,0,0,0,0,0,0,0,0,0,110010019011003,4,402,402,4,psa_53,4D1
1000000US110010020021010,"Block 1010, Block Group 1, Census Tract 20.02, District of Columbia, District of Columbia",24,15,9,0,0,0,0,0,24,24,15,9,0,0,0,0,0,0,0,0,0,0,0,0,0,110010020021010,4,404,404,4,psa_48,4D3
1000000US110010041001004,"Block 1004, Block Group 1, Census Tract 41, District of Columbia, District of Columbia",168,155,8,0,4,0,1,0,168,155,146,5,0,4,0,0,0,13,9,3,0,0,0,1,0,110010041001004,2,208,208,2,psa_33,2D3
1000000US110010076042028,"Block 2028, Block Group 2, Census Tract 76.04, District of Columbia, District of Columbia",39,14,23,0,0,0,2,0,39,39,14,23,0,0,0,2,0,0,0,0,0,0,0,0,0,110010076042028,6,606,606,6,psa_7,6D2
1000000US110010002021002,"Block 1002, Block Group 1, Census Tract 2.02, District of Columbia, District of Columbia",40,33,0,0,7,0,0,0,40,40,33,0,0,7,0,0,0,0,0,0,0,0,0,0,0,110010002021002,2,206,206,2,psa_29,2D2
1000000US110010008014007,"Block 4007, Block Group 4, Census Tract 8.01, District of Columbia, District of Columbia",20,20,0,0,0,0,0,0,20,20,20,0,0,0,0,0,0,0,0,0,0,0,0,0,0,110010008014007,2,205,205,2,psa_46,2D2
1000000US110010012001003,"Block 1003, Block Group 1, Census Tract 12, District of Columbia, District of Columbia",534,366,55,2,75,0,13,23,534,489,345,51,2,72,0,0,19,45,21,4,0,3,0,13,4,110010012001003,2,203,203,2,psa_50,2D1
1000000US110010106002029,"Block 2029, Block Group 2, Census Tract 106, District of Columbia, District of Columbia",0,0,0,0,0,0,0,0,0,0,0,0,0,0,0,0,0,0,0,0,0,0,0,0,0,110010106002029,1,102,102,1,psa_18,1D1
1000000US110010049011002,"Block 1002, Block Group 1, Census Tract 49.01, District of Columbia, District of Columbia",156,94,48,1,5,0,3,5,156,149,89,48,1,5,0,1,5,7,5,0,0,0,0,2,0,110010049011002,3,307,307,3,psa_28,3D3
1000000US110010076033005,"Block 3005, Block Group 3, Census Tract 76.03, District of Columbia, District of Columbia",31,5,22,0,0,0,3,1,31,26,5,21,0,0,0,0,0,5,0,1,0,0,0,3,1,110010076033005,6,606,606,6,psa_7,6D2
1000000US110010095052015,"Block 2015, Block Group 2, Census Tract 95.05, District of Columbia, District of Columbia",1,0,1,0,0,0,0,0,1,1,0,1,0,0,0,0,0,0,0,0,0,0,0,0,0,110010095052015,4,406,406,4,psa_54,4D2
1000000US110010062021156,"Block 1156, Block Group 1, Census Tract 62.02, District of Columbia, District of Columbia",0,0,0,0,0,0,0,0,0,0,0,0,0,0,0,0,0,0,0,0,0,0,0,0,0,110010062021156,1,102,102,1,psa_18,1D1
1000000US110010108002014,"Block 2014, Block Group 2, Census Tract 108.00, District of Columbia, District of Columbia",0,0,0,0,0,0,0,0,0,0,0,0,0,0,0,0,0,0,0,0,0,0,0,0,0,110010108002014,2,207,207,2,psa_24,2D3
1000000US110010010013013,"Block 3013, Block Group 3, Census Tract 10.01, District of Columbia, District of Columbia",82,76,3,0,0,0,2,1,82,74,70,3,0,0,0,0,1,8,6,0,0,0,0,2,0,110010010013013,2,202,202,2,psa_52,2D1
1000000US110010021022004,"Block 2004, Block Group 2, Census Tract 21.02, District of Columbia, District of Columbia",21,1,13,0,1,0,5,1,21,16,1,13,0,1,0,0,1,5,0,0,0,0,0,5,0,110010021022004,4,406,406,4,psa_54,4D2
1000000US110010013012005,"Block 2005, Block Group 2, Census Tract 13.01, District of Columbia, District of Columbia",70,48,10,0,9,0,0,3,70,69,48,9,0,9,0,0,3,1,0,1,0,0,0,0,0,110010013012005,2,203,203,2,psa_50,2D1
1000000US110010016004036,"Block 4036, Block Group 4, Census Tract 16, District of Columbia, District of Columbia",36,6,25,0,3,0,0,2,36,34,4,25,0,3,0,0,2,2,2,0,0,0,0,0,0,110010016004036,4,401,401,4,psa_56,4D1
1000000US110010107002001,"Block 2001, Block Group 2, Census Tract 107, District of Columbia, District of Columbia",0,0,0,0,0,0,0,0,0,0,0,0,0,0,0,0,0,0,0,0,0,0,0,0,0,110010107002001,2,208,208,2,psa_33,2D3
1000000US110010071001017,"Block 1017, Block Group 1, Census Tract 71, District of Columbia, District of Columbia",0,0,0,0,0,0,0,0,0,0,0,0,0,0,0,0,0,0,0,0,0,0,0,0,0,110010071001017,1,106,106,1,psa_13,1D3
1000000US110010074093001,"Block 3001, Block Group 3, Census Tract 74.09, District of Columbia, District of Columbia",179,0,179,0,0,0,0,0,179,178,0,178,0,0,0,0,0,1,0,1,0,0,0,0,0,110010074093001,7,704,704,7,psa_5,7D2
1000000US110010108003007,"Block 3007, Block Group 3, Census Tract 108.00, District of Columbia, District of Columbia",0,0,0,0,0,0,0,0,0,0,0,0,0,0,0,0,0,0,0,0,0,0,0,0,0,110010108003007,2,207,207,2,psa_24,2D3
1000000US110010041003013,"Block 3013, Block Group 3, Census Tract 41, District of Columbia, District of Columbia",67,56,0,0,8,1,0,2,67,65,54,0,0,8,1,0,2,2,2,0,0,0,0,0,0,110010041003013,2,208,208,2,psa_33,2D3
1000000US110010009013023,"Block 3023, Block Group 3, Census Tract 9.01, District of Columbia, District of Columbia",0,0,0,0,0,0,0,0,0,0,0,0,0,0,0,0,0,0,0,0,0,0,0,0,0,110010009013023,2,205,205,2,psa_46,2D2
1000000US110010004002011,"Block 2011, Block Group 2, Census Tract 4, District of Columbia, District of Columbia",19,11,0,0,8,0,0,0,19,18,10,0,0,8,0,0,0,1,1,0,0,0,0,0,0,110010004002011,2,204,204,2,psa_44,2D2
1000000US110010017021011,"Block 1011, Block Group 1, Census Tract 17.02, District of Columbia, District of Columbia",0,0,0,0,0,0,0,0,0,0,0,0,0,0,0,0,0,0,0,0,0,0,0,0,0,110010017021011,4,401,401,4,psa_56,4D1
1000000US110010095091008,"Block 1008, Block Group 1, Census Tract 95.09, District of Columbia, District of Columbia",0,0,0,0,0,0,0,0,0,0,0,0,0,0,0,0,0,0,0,0,0,0,0,0,0,110010095091008,4,405,405,4,psa_49,4D2
1000000US110010050022005,"Block 2005, Block Group 2, Census Tract 50.02, District of Columbia, District of Columbia",397,341,13,0,20,0,3,20,397,362,312,13,0,20,0,1,16,35,29,0,0,0,0,2,4,110010050022005,3,307,307,3,psa_28,3D3
1000000US110010111002005,"Block 2005, Block Group 2, Census Tract 111, District of Columbia, District of Columbia",48,4,42,0,0,0,0,2,48,48,4,42,0,0,0,0,2,0,0,0,0,0,0,0,0,110010111002005,5,503,503,5,psa_45,5D2
1000000US110010027012002,"Block 2002, Block Group 2, Census Tract 27.01, District of Columbia, District of Columbia",327,154,79,1,30,1,42,20,327,248,129,77,0,29,1,0,12,79,25,2,1,1,0,42,8,110010027012002,3,302,302,3,psa_42,3D1
1000000US110010080012011,"Block 2011, Block Group 2, Census Tract 80.01, District of Columbia, District of Columbia",127,71,44,0,3,0,0,9,127,125,69,44,0,3,0,0,9,2,2,0,0,0,0,0,0,110010080012011,1,108,108,1,psa_17,1D2
1000000US110010102002040,"Block 2040, Block Group 2, Census Tract 102, District of Columbia, District of Columbia",157,102,34,0,8,0,5,8,157,144,95,34,0,8,0,0,7,13,7,0,0,0,0,5,1,110010102002040,1,103,103,1,psa_12,1D1
1000000US110010001004017,"Block 4017, Block Group 4, Census Tract 1, District of Columbia, District of Columbia",4,2,1,0,0,0,0,1,4,3,1,1,0,0,0,0,1,1,1,0,0,0,0,0,0,110010001004017,2,206,206,2,psa_29,2D2
1000000US110010011004005,"Block 4005, Block Group 4, Census Tract 11, District of Columbia, District of Columbia",38,30,3,0,2,0,0,3,38,34,26,3,0,2,0,0,3,4,4,0,0,0,0,0,0,110010011004005,2,202,202,2,psa_52,2D1
1000000US110010019021006,"Block 1006, Block Group 1, Census Tract 19.02, District of Columbia, District of Columbia",96,3,78,0,0,0,10,5,96,84,3,78,0,0,0,0,3,12,0,0,0,0,0,10,2,110010019021006,4,402,402,4,psa_53,4D1
1000000US110010078043018,"Block 3018, Block Group 3, Census Tract 78.04, District of Columbia, District of Columbia",11,3,8,0,0,0,0,0,11,11,3,8,0,0,0,0,0,0,0,0,0,0,0,0,0,110010078043018,6,608,608,6,psa_19,6D1
1000000US110010076051005,"Block 1005, Block Group 1, Census Tract 76.05, District of Columbia, District of Columbia",58,2,56,0,0,0,0,0,58,58,2,56,0,0,0,0,0,0,0,0,0,0,0,0,0,110010076051005,6,607,607,6,psa_10,6D2
1000000US110010015004009,"Block 4009, Block Group 4, Census Tract 15, District of Columbia, District of Columbia",155,137,8,0,4,0,0,6,155,139,124,8,0,4,0,0,3,16,13,0,0,0,0,0,3,110010015004009,2,201,201,2,psa_55,2D1
1000000US110010111003019,"Block 3019, Block Group 3, Census Tract 111, District of Columbia, District of Columbia",0,0,0,0,0,0,0,0,0,0,0,0,0,0,0,0,0,0,0,0,0,0,0,0,0,110010111003019,5,506,506,5,psa_26,5D3
1000000US110010021024004,"Block 4004, Block Group 4, Census Tract 21.02, District of Columbia, District of Columbia",0,0,0,0,0,0,0,0,0,0,0,0,0,0,0,0,0,0,0,0,0,0,0,0,0,110010021024004,4,406,406,4,psa_54,4D2
1000000US110010074011002,"Block 1002, Block Group 1, Census Tract 74.01, District of Columbia, District of Columbia",0,0,0,0,0,0,0,0,0,0,0,0,0,0,0,0,0,0,0,0,0,0,0,0,0,110010074011002,7,703,703,7,psa_8,7D1
1000000US110010018031004,"Block 1004, Block Group 1, Census Tract 18.03, District of Columbia, District of Columbia",0,0,0,0,0,0,0,0,0,0,0,0,0,0,0,0,0,0,0,0,0,0,0,0,0,110010018031004,4,402,402,4,psa_53,4D1
1000000US110010012003006,"Block 3006, Block Group 3, Census Tract 12, District of Columbia, District of Columbia",19,14,0,0,1,0,0,4,19,19,14,0,0,1,0,0,4,0,0,0,0,0,0,0,0,110010012003006,2,202,202,2,psa_52,2D1
1000000US110010053012005,"Block 2005, Block Group 2, Census Tract 53.01, District of Columbia, District of Columbia",12,8,3,0,0,1,0,0,12,10,7,3,0,0,0,0,0,2,1,0,0,0,1,0,0,110010053012005,2,208,208,2,psa_33,2D3
1000000US110010009022027,"Block 2027, Block Group 2, Census Tract 9.02, District of Columbia, District of Columbia",65,65,0,0,0,0,0,0,65,59,59,0,0,0,0,0,0,6,6,0,0,0,0,0,0,110010009022027,2,205,205,2,psa_46,2D2
1000000US110010039003003,"Block 3003, Block Group 3, Census Tract 39, District of Columbia, District of Columbia",301,218,32,4,12,0,18,17,301,242,189,30,2,12,0,0,9,59,29,2,2,0,0,18,8,110010039003003,3,303,303,3,psa_37,3D3
1000000US110010078092003,"Block 2003, Block Group 2, Census Tract 78.09, District of Columbia, District of Columbia",78,0,74,0,0,0,2,2,78,74,0,74,0,0,0,0,0,4,0,0,0,0,0,2,2,110010078092003,6,602,602,6,psa_25,6D1
1000000US110010081001006,"Block 1006, Block Group 1, Census Tract 81, District of Columbia, District of Columbia",128,101,15,4,3,0,2,3,128,122,97,15,3,3,0,1,3,6,4,0,1,0,0,1,0,110010081001006,1,108,108,1,psa_17,1D2
1000000US110010095093000,"Block 3000, Block Group 3, Census Tract 95.09, District of Columbia, District of Columbia",91,10,68,0,7,0,6,0,91,85,10,68,0,7,0,0,0,6,0,0,0,0,0,6,0,110010095093000,4,405,405,4,psa_49,4D2
1000000US110010005021005,"Block 1005, Block Group 1, Census Tract 5.02, District of Columbia, District of Columbia",33,33,0,0,0,0,0,0,33,29,29,0,0,0,0,0,0,4,4,0,0,0,0,0,0,110010005021005,2,204,204,2,psa_44,2D2
1000000US110010025011000,"Block 1000, Block Group 1, Census Tract 25.01, District of Columbia, District of Columbia",298,43,182,1,1,2,65,4,298,209,24,180,1,1,1,2,0,89,19,2,0,0,1,63,4,110010025011000,4,404,404,4,psa_48,4D3
1000000US110010062021243,"Block 1243, Block Group 1, Census Tract 62.02, District of Columbia, District of Columbia",0,0,0,0,0,0,0,0,0,0,0,0,0,0,0,0,0,0,0,0,0,0,0,0,0,110010062021243,2,207,207,2,psa_24,2D3
1000000US110010071001029,"Block 1029, Block Group 1, Census Tract 71, District of Columbia, District of Columbia",0,0,0,0,0,0,0,0,0,0,0,0,0,0,0,0,0,0,0,0,0,0,0,0,0,110010071001029,1,106,106,1,psa_13,1D3
1000000US110010002021009,"Block 1009, Block Group 1, Census Tract 2.02, District of Columbia, District of Columbia",81,81,0,0,0,0,0,0,81,77,77,0,0,0,0,0,0,4,4,0,0,0,0,0,0,110010002021009,2,206,206,2,psa_29,2D2
1000000US110010111001032,"Block 1032, Block Group 1, Census Tract 111, District of Columbia, District of Columbia",0,0,0,0,0,0,0,0,0,0,0,0,0,0,0,0,0,0,0,0,0,0,0,0,0,110010111001032,5,503,503,5,psa_45,5D2
1000000US110010022022002,"Block 2002, Block Group 2, Census Tract 22.02, District of Columbia, District of Columbia",0,0,0,0,0,0,0,0,0,0,0,0,0,0,0,0,0,0,0,0,0,0,0,0,0,110010022022002,4,407,407,4,psa_47,4D2
1000000US110010009013008,"Block 3008, Block Group 3, Census Tract 9.01, District of Columbia, District of Columbia",22,22,0,0,0,0,0,0,22,22,22,0,0,0,0,0,0,0,0,0,0,0,0,0,0,110010009013008,2,205,205,2,psa_46,2D2
1000000US110010072002036,"Block 2036, Block Group 2, Census Tract 72, District of Columbia, District of Columbia",19,19,0,0,0,0,0,0,19,18,18,0,0,0,0,0,0,1,1,0,0,0,0,0,0,110010072002036,1,106,106,1,psa_13,1D3
1000000US110010011001002,"Block 1002, Block Group 1, Census Tract 11, District of Columbia, District of Columbia",16,16,0,0,0,0,0,0,16,14,14,0,0,0,0,0,0,2,2,0,0,0,0,0,0,110010011001002,2,201,201,2,psa_55,2D1
1000000US110010065001001,"Block 1001, Block Group 1, Census Tract 65, District of Columbia, District of Columbia",149,139,4,0,3,0,0,3,149,144,134,4,0,3,0,0,3,5,5,0,0,0,0,0,0,110010065001001,1,107,107,1,psa_16,1D2
1000000US110010003001002,"Block 1002, Block Group 1, Census Tract 3, District of Columbia, District of Columbia",68,60,0,0,4,0,0,4,68,68,60,0,0,4,0,0,4,0,0,0,0,0,0,0,0,110010003001002,2,204,204,2,psa_44,2D2
1000000US110010015001000,"Block 1000, Block Group 1, Census Tract 15, District of Columbia, District of Columbia",0,0,0,0,0,0,0,0,0,0,0,0,0,0,0,0,0,0,0,0,0,0,0,0,0,110010015001000,2,201,201,2,psa_55,2D1
1000000US110010010012011,"Block 2011, Block Group 2, Census Tract 10.01, District of Columbia, District of Columbia",82,72,8,1,0,0,1,0,82,69,60,8,0,0,0,1,0,13,12,0,1,0,0,0,0,110010010012011,2,202,202,2,psa_52,2D1
1000000US110010103001013,"Block 1013, Block Group 1, Census Tract 103, District of Columbia, District of Columbia",49,22,17,3,7,0,0,0,49,49,22,17,3,7,0,0,0,0,0,0,0,0,0,0,0,110010103001013,4,401,401,4,psa_56,4D1
1000000US110010006003008,"Block 3008, Block Group 3, Census Tract 6, District of Columbia, District of Columbia",0,0,0,0,0,0,0,0,0,0,0,0,0,0,0,0,0,0,0,0,0,0,0,0,0,110010006003008,2,204,204,2,psa_44,2D2
1000000US110010103001012,"Block 1012, Block Group 1, Census Tract 103, District of Columbia, District of Columbia",212,15,181,0,4,0,5,7,212,196,13,177,0,3,0,0,3,16,2,4,0,1,0,5,4,110010103001012,4,401,401,4,psa_56,4D1
1000000US110010067003008,"Block 3008, Block Group 3, Census Tract 67, District of Columbia, District of Columbia",134,110,13,1,5,0,0,5,134,131,108,13,1,5,0,0,4,3,2,0,0,0,0,0,1,110010067003008,1,107,107,1,psa_16,1D2
1000000US110010059001018,"Block 1018, Block Group 1, Census Tract 59, District of Columbia, District of Columbia",283,209,26,0,37,1,1,9,283,271,202,25,0,37,1,0,6,12,7,1,0,0,0,1,3,110010059001018,1,101,101,1,psa_20,1D1
1000000US110010079031004,"Block 1004, Block Group 1, Census Tract 79.03, District of Columbia, District of Columbia",20,0,20,0,0,0,0,0,20,20,0,20,0,0,0,0,0,0,0,0,0,0,0,0,0,110010079031004,5,507,507,5,psa_23,5D3
1000000US110010080012004,"Block 2004, Block Group 2, Census Tract 80.01, District of Columbia, District of Columbia",36,19,17,0,0,0,0,0,36,35,18,17,0,0,0,0,0,1,1,0,0,0,0,0,0,110010080012004,1,108,108,1,psa_17,1D2
1000000US110010095092008,"Block 2008, Block Group 2, Census Tract 95.09, District of Columbia, District of Columbia",0,0,0,0,0,0,0,0,0,0,0,0,0,0,0,0,0,0,0,0,0,0,0,0,0,110010095092008,4,405,405,4,psa_49,4D2
1000000US110010012004017,"Block 4017, Block Group 4, Census Tract 12, District of Columbia, District of Columbia",84,63,9,0,8,0,0,4,84,79,58,9,0,8,0,0,4,5,5,0,0,0,0,0,0,110010012004017,2,202,202,2,psa_52,2D1
1000000US110010093021006,"Block 1006, Block Group 1, Census Tract 93.02, District of Columbia, District of Columbia",70,25,43,0,0,0,0,2,70,67,23,42,0,0,0,0,2,3,2,1,0,0,0,0,0,110010093021006,5,504,504,5,psa_43,5D2
1000000US110010008013012,"Block 3012, Block Group 3, Census Tract 8.01, District of Columbia, District of Columbia",35,34,1,0,0,0,0,0,35,33,32,1,0,0,0,0,0,2,2,0,0,0,0,0,0,110010008013012,2,205,205,2,psa_46,2D2
1000000US110010023012009,"Block 2009, Block Group 2, Census Tract 23.01, District of Columbia, District of Columbia",115,12,95,0,4,0,4,0,115,106,12,90,0,4,0,0,0,9,0,5,0,0,0,4,0,110010023012009,4,407,407,4,psa_47,4D2
1000000US110010058002009,"Block 2009, Block Group 2, Census Tract 58, District of Columbia, District of Columbia",42,34,1,0,0,0,7,0,42,35,34,1,0,0,0,0,0,7,0,0,0,0,0,7,0,110010058002009,1,101,101,1,psa_20,1D1
1000000US110010103002000,"Block 2000, Block Group 2, Census Tract 103, District of Columbia, District of Columbia",0,0,0,0,0,0,0,0,0,0,0,0,0,0,0,0,0,0,0,0,0,0,0,0,0,110010103002000,4,401,401,4,psa_56,4D1
1000000US110010004002009,"Block 2009, Block Group 2, Census Tract 4, District of Columbia, District of Columbia",5,5,0,0,0,0,0,0,5,5,5,0,0,0,0,0,0,0,0,0,0,0,0,0,0,110010004002009,2,204,204,2,psa_44,2D2
1000000US110010078082019,"Block 2019, Block Group 2, Census Tract 78.08, District of Columbia, District of Columbia",0,0,0,0,0,0,0,0,0,0,0,0,0,0,0,0,0,0,0,0,0,0,0,0,0,110010078082019,6,608,608,6,psa_19,6D1
1000000US110010020021020,"Block 1020, Block Group 1, Census Tract 20.02, District of Columbia, District of Columbia",14,5,7,0,1,0,0,1,14,9,5,2,0,1,0,0,1,5,0,5,0,0,0,0,0,110010020021020,4,404,404,4,psa_48,4D3
1000000US110010019014001,"Block 4001, Block Group 4, Census Tract 19.01, District of Columbia, District of Columbia",61,19,32,2,1,0,0,7,61,60,18,32,2,1,0,0,7,1,1,0,0,0,0,0,0,110010019014001,4,402,402,4,psa_53,4D1
1000000US110010068022001,"Block 2001, Block Group 2, Census Tract 68.02, District of Columbia, District of Columbia",156,46,97,0,4,0,0,9,156,141,41,94,0,4,0,0,2,15,5,3,0,0,0,0,7,110010068022001,1,107,107,1,psa_16,1D2
1000000US110010087022003,"Block 2003, Block Group 2, Census Tract 87.02, District of Columbia, District of Columbia",78,17,58,0,0,1,0,2,78,67,6,58,0,0,1,0,2,11,11,0,0,0,0,0,0,110010087022003,5,502,502,5,psa_40,5D1
1000000US110010026001013,"Block 1013, Block Group 1, Census Tract 26, District of Columbia, District of Columbia",0,0,0,0,0,0,0,0,0,0,0,0,0,0,0,0,0,0,0,0,0,0,0,0,0,110010026001013,4,404,404,4,psa_48,4D3
1000000US110010044002010,"Block 2010, Block Group 2, Census Tract 44, District of Columbia, District of Columbia",264,96,130,4,6,0,26,2,264,211,84,118,1,6,0,0,2,53,12,12,3,0,0,26,0,110010044002010,3,305,305,3,psa_32,3D2
1000000US110010080021010,"Block 1010, Block Group 1, Census Tract 80.02, District of Columbia, District of Columbia",104,50,44,0,4,0,0,6,104,103,49,44,0,4,0,0,6,1,1,0,0,0,0,0,0,110010080021010,1,108,108,1,psa_17,1D2
1000000US110010029002005,"Block 2005, Block Group 2, Census Tract 29, District of Columbia, District of Columbia",688,322,91,11,24,4,137,99,688,316,184,89,0,24,4,6,9,372,138,2,11,0,0,131,90,110010029002005,4,408,408,4,psa_39,4D3
1000000US110010076053001,"Block 3001, Block Group 3, Census Tract 76.05, District of Columbia, District of Columbia",39,0,37,0,1,0,0,1,39,39,0,37,0,1,0,0,1,0,0,0,0,0,0,0,0,110010076053001,6,607,607,6,psa_10,6D2
1000000US110010106002030,"Block 2030, Block Group 2, Census Tract 106, District of Columbia, District of Columbia",0,0,0,0,0,0,0,0,0,0,0,0,0,0,0,0,0,0,0,0,0,0,0,0,0,110010106002030,1,102,102,1,psa_18,1D1
1000000US110010034002014,"Block 2014, Block Group 2, Census Tract 34, District of Columbia, District of Columbia",56,1,49,0,0,0,5,1,56,51,1,49,0,0,0,0,1,5,0,0,0,0,0,5,0,110010034002014,3,306,306,3,psa_38,3D2
1000000US110010096021028,"Block 1028, Block Group 1, Census Tract 96.02, District of Columbia, District of Columbia",0,0,0,0,0,0,0,0,0,0,0,0,0,0,0,0,0,0,0,0,0,0,0,0,0,110010096021028,6,602,602,6,psa_25,6D1
1000000US110010098042003,"Block 2003, Block Group 2, Census Tract 98.04, District of Columbia, District of Columbia",107,6,99,0,0,0,2,0,107,99,0,99,0,0,0,0,0,8,6,0,0,0,0,2,0,110010098042003,7,705,705,7,psa_3,7D2
1000000US110010104001011,"Block 1011, Block Group 1, Census Tract 104, District of Columbia, District of Columbia",3,0,3,0,0,0,0,0,3,3,0,3,0,0,0,0,0,0,0,0,0,0,0,0,0,110010104001011,7,705,705,7,psa_3,7D2
1000000US110010108002003,"Block 2003, Block Group 2, Census Tract 108.00, District of Columbia, District of Columbia",0,0,0,0,0,0,0,0,0,0,0,0,0,0,0,0,0,0,0,0,0,0,0,0,0,110010108002003,2,207,207,2,psa_24,2D3
1000000US110010027013002,"Block 3002, Block Group 3, Census Tract 27.01, District of Columbia, District of Columbia",141,123,7,2,6,0,0,3,141,131,115,7,0,6,0,0,3,10,8,0,2,0,0,0,0,110010027013002,3,302,302,3,psa_42,3D1
1000000US110010067001003,"Block 1003, Block Group 1, Census Tract 67, District of Columbia, District of Columbia",11,11,0,0,0,0,0,0,11,11,11,0,0,0,0,0,0,0,0,0,0,0,0,0,0,110010067001003,1,107,107,1,psa_16,1D2
1000000US110010108002009,"Block 2009, Block Group 2, Census Tract 108.00, District of Columbia, District of Columbia",765,508,52,0,167,0,11,27,765,711,471,52,0,167,0,3,18,54,37,0,0,0,0,8,9,110010108002009,2,207,207,2,psa_24,2D3
1000000US110010074071004,"Block 1004, Block Group 1, Census Tract 74.07, District of Columbia, District of Columbia",68,0,68,0,0,0,0,0,68,66,0,66,0,0,0,0,0,2,0,2,0,0,0,0,0,110010074071004,7,702,702,7,psa_6,7D1
1000000US110010078062005,"Block 2005, Block Group 2, Census Tract 78.06, District of Columbia, District of Columbia",0,0,0,0,0,0,0,0,0,0,0,0,0,0,0,0,0,0,0,0,0,0,0,0,0,110010078062005,6,602,602,6,psa_25,6D1
1000000US110010071002008,"Block 2008, Block Group 2, Census Tract 71, District of Columbia, District of Columbia",76,33,23,0,1,0,0,19,76,62,29,23,0,1,0,0,9,14,4,0,0,0,0,0,10,110010071002008,1,106,106,1,psa_13,1D3
1000000US110010102002011,"Block 2011, Block Group 2, Census Tract 102, District of Columbia, District of Columbia",0,0,0,0,0,0,0,0,0,0,0,0,0,0,0,0,0,0,0,0,0,0,0,0,0,110010102002011,1,103,103,1,psa_12,1D1
1000000US110010049021003,"Block 1003, Block Group 1, Census Tract 49.02, District of Columbia, District of Columbia",30,27,2,0,0,0,0,1,30,30,27,2,0,0,0,0,1,0,0,0,0,0,0,0,0,110010049021003,3,307,307,3,psa_28,3D3
1000000US110010031001009,"Block 1009, Block Group 1, Census Tract 31, District of Columbia, District of Columbia",210,100,57,0,5,0,42,6,210,136,78,52,0,5,0,1,0,74,22,5,0,0,0,41,6,110010031001009,3,302,302,3,psa_42,3D1
1000000US110010109002009,"Block 2009, Block Group 2, Census Tract 109, District of Columbia, District of Columbia",0,0,0,0,0,0,0,0,0,0,0,0,0,0,0,0,0,0,0,0,0,0,0,0,0,110010109002009,7,708,708,7,psa_1,7D3
1000000US110010029002009,"Block 2009, Block Group 2, Census Tract 29, District of Columbia, District of Columbia",80,52,12,0,16,0,0,0,80,68,40,12,0,16,0,0,0,12,12,0,0,0,0,0,0,110010029002009,3,302,302,3,psa_42,3D1
1000000US110010022022005,"Block 2005, Block Group 2, Census Tract 22.02, District of Columbia, District of Columbia",0,0,0,0,0,0,0,0,0,0,0,0,0,0,0,0,0,0,0,0,0,0,0,0,0,110010022022005,4,407,407,4,psa_47,4D2
1000000US110010099022003,"Block 2003, Block Group 2, Census Tract 99.02, District of Columbia, District of Columbia",155,0,151,0,0,0,1,3,155,155,0,151,0,0,0,1,3,0,0,0,0,0,0,0,0,110010099022003,6,605,605,6,psa_11,6D2
1000000US110010103002005,"Block 2005, Block Group 2, Census Tract 103, District of Columbia, District of Columbia",57,5,45,1,6,0,0,0,57,56,4,45,1,6,0,0,0,1,1,0,0,0,0,0,0,110010103002005,4,401,401,4,psa_56,4D1
1000000US110010015002002,"Block 2002, Block Group 2, Census Tract 15, District of Columbia, District of Columbia",87,69,9,0,4,0,0,5,87,81,64,9,0,3,0,0,5,6,5,0,0,1,0,0,0,110010015002002,2,201,201,2,psa_55,2D1
1000000US110010047021021,"Block 1021, Block Group 1, Census Tract 47.02, District of Columbia, District of Columbia",6,1,4,0,0,0,0,1,6,5,1,4,0,0,0,0,0,1,0,0,0,0,0,0,1,110010047021021,1,102,102,1,psa_18,1D1
1000000US110010098102006,"Block 2006, Block Group 2, Census Tract 98.10, District of Columbia, District of Columbia",54,2,52,0,0,0,0,0,54,53,2,51,0,0,0,0,0,1,0,1,0,0,0,0,0,110010098102006,7,708,708,7,psa_1,7D3
1000000US110010109002045,"Block 2045, Block Group 2, Census Tract 109, District of Columbia, District of Columbia",0,0,0,0,0,0,0,0,0,0,0,0,0,0,0,0,0,0,0,0,0,0,0,0,0,110010109002045,7,708,708,7,psa_1,7D3
1000000US110010072002032,"Block 2032, Block Group 2, Census Tract 72, District of Columbia, District of Columbia",0,0,0,0,0,0,0,0,0,0,0,0,0,0,0,0,0,0,0,0,0,0,0,0,0,110010072002032,1,106,106,1,psa_13,1D3
1000000US110010076042030,"Block 2030, Block Group 2, Census Tract 76.04, District of Columbia, District of Columbia",74,9,64,0,0,1,0,0,74,74,9,64,0,0,1,0,0,0,0,0,0,0,0,0,0,110010076042030,6,606,606,6,psa_7,6D2
1000000US110010092011003,"Block 1003, Block Group 1, Census Tract 92.01, District of Columbia, District of Columbia",324,279,12,0,10,0,12,11,324,298,264,11,0,9,0,3,11,26,15,1,0,1,0,9,0,110010092011003,5,502,502,5,psa_40,5D1
1000000US110010004001017,"Block 1017, Block Group 1, Census Tract 4, District of Columbia, District of Columbia",43,40,0,0,3,0,0,0,43,41,38,0,0,3,0,0,0,2,2,0,0,0,0,0,0,110010004001017,2,204,204,2,psa_44,2D2
1000000US110010006004009,"Block 4009, Block Group 4, Census Tract 6, District of Columbia, District of Columbia",94,91,0,1,2,0,0,0,94,91,90,0,0,1,0,0,0,3,1,0,1,1,0,0,0,110010006004009,2,203,203,2,psa_50,2D1
1000000US110010073041009,"Block 1009, Block Group 1, Census Tract 73.04, District of Columbia, District of Columbia",0,0,0,0,0,0,0,0,0,0,0,0,0,0,0,0,0,0,0,0,0,0,0,0,0,110010073041009,7,705,705,7,psa_3,7D2
1000000US110010099072006,"Block 2006, Block Group 2, Census Tract 99.07, District of Columbia, District of Columbia",44,1,42,0,1,0,0,0,44,44,1,42,0,1,0,0,0,0,0,0,0,0,0,0,0,110010099072006,6,605,605,6,psa_11,6D2
1000000US110010102001018,"Block 1018, Block Group 1, Census Tract 102, District of Columbia, District of Columbia",131,58,54,0,7,0,1,11,131,127,55,54,0,7,0,1,10,4,3,0,0,0,0,0,1,110010102001018,1,103,103,1,psa_12,1D1
1000000US110010058001037,"Block 1037, Block Group 1, Census Tract 58, District of Columbia, District of Columbia",0,0,0,0,0,0,0,0,0,0,0,0,0,0,0,0,0,0,0,0,0,0,0,0,0,110010058001037,2,209,209,2,psa_57,2D3
1000000US110010008013029,"Block 3029, Block Group 3, Census Tract 8.01, District of Columbia, District of Columbia",35,33,1,0,0,0,0,1,35,32,30,1,0,0,0,0,1,3,3,0,0,0,0,0,0,110010008013029,2,205,205,2,psa_46,2D2
1000000US110010062021246,"Block 1246, Block Group 1, Census Tract 62.02, District of Columbia, District of Columbia",0,0,0,0,0,0,0,0,0,0,0,0,0,0,0,0,0,0,0,0,0,0,0,0,0,110010062021246,1,103,103,1,psa_12,1D1
1000000US110010059001034,"Block 1034, Block Group 1, Census Tract 59, District of Columbia, District of Columbia",0,0,0,0,0,0,0,0,0,0,0,0,0,0,0,0,0,0,0,0,0,0,0,0,0,110010059001034,1,102,102,1,psa_18,1D1
1000000US110010080022015,"Block 2015, Block Group 2, Census Tract 80.02, District of Columbia, District of Columbia",29,24,5,0,0,0,0,0,29,29,24,5,0,0,0,0,0,0,0,0,0,0,0,0,0,110010080022015,1,108,108,1,psa_17,1D2
1000000US110010081002002,"Block 2002, Block Group 2, Census Tract 81, District of Columbia, District of Columbia",122,94,27,0,1,0,0,0,122,117,90,26,0,1,0,0,0,5,4,1,0,0,0,0,0,110010081002002,1,108,108,1,psa_17,1D2
1000000US110010014021000,"Block 1000, Block Group 1, Census Tract 14.02, District of Columbia, District of Columbia",101,91,4,0,6,0,0,0,101,100,90,4,0,6,0,0,0,1,1,0,0,0,0,0,0,110010014021000,2,201,201,2,psa_55,2D1
1000000US110010046002006,"Block 2006, Block Group 2, Census Tract 46, District of Columbia, District of Columbia",258,69,174,0,6,0,4,5,258,245,62,174,0,6,0,0,3,13,7,0,0,0,0,4,2,110010046002006,3,308,308,3,psa_27,3D2
1000000US110010050022006,"Block 2006, Block Group 2, Census Tract 50.02, District of Columbia, District of Columbia",146,104,15,2,11,2,8,4,146,129,96,15,2,11,2,0,3,17,8,0,0,0,0,8,1,110010050022006,3,307,307,3,psa_28,3D3
1000000US110010009013002,"Block 3002, Block Group 3, Census Tract 9.01, District of Columbia, District of Columbia",35,34,0,0,1,0,0,0,35,30,29,0,0,1,0,0,0,5,5,0,0,0,0,0,0,110010009013002,2,205,205,2,psa_46,2D2
1000000US110010017022000,"Block 2000, Block Group 2, Census Tract 17.02, District of Columbia, District of Columbia",184,53,103,0,10,0,7,11,184,167,46,103,0,9,0,0,9,17,7,0,0,1,0,7,2,110010017022000,4,401,401,4,psa_56,4D1
1000000US110010022012002,"Block 2002, Block Group 2, Census Tract 22.01, District of Columbia, District of Columbia",0,0,0,0,0,0,0,0,0,0,0,0,0,0,0,0,0,0,0,0,0,0,0,0,0,110010022012002,4,407,407,4,psa_47,4D2
1000000US110010097001001,"Block 1001, Block Group 1, Census Tract 97, District of Columbia, District of Columbia",0,0,0,0,0,0,0,0,0,0,0,0,0,0,0,0,0,0,0,0,0,0,0,0,0,110010097001001,7,705,705,7,psa_3,7D2
1000000US110010008014000,"Block 4000, Block Group 4, Census Tract 8.01, District of Columbia, District of Columbia",446,375,42,0,21,0,0,8,446,422,358,36,0,21,0,0,7,24,17,6,0,0,0,0,1,110010008014000,2,205,205,2,psa_46,2D2
1000000US110010076015008,"Block 5008, Block Group 5, Census Tract 76.01, District of Columbia, District of Columbia",0,0,0,0,0,0,0,0,0,0,0,0,0,0,0,0,0,0,0,0,0,0,0,0,0,110010076015008,6,607,607,6,psa_10,6D2
1000000US110010039002007,"Block 2007, Block Group 2, Census Tract 39, District of Columbia, District of Columbia",0,0,0,0,0,0,0,0,0,0,0,0,0,0,0,0,0,0,0,0,0,0,0,0,0,110010039002007,2,204,204,2,psa_44,2D2
1000000US110010095031015,"Block 1015, Block Group 1, Census Tract 95.03, District of Columbia, District of Columbia",64,3,59,0,0,0,0,2,64,63,2,59,0,0,0,0,2,1,1,0,0,0,0,0,0,110010095031015,4,405,405,4,psa_49,4D2
1000000US110010009021007,"Block 1007, Block Group 1, Census Tract 9.02, District of Columbia, District of Columbia",139,120,11,0,8,0,0,0,139,137,118,11,0,8,0,0,0,2,2,0,0,0,0,0,0,110010009021007,2,205,205,2,psa_46,2D2
1000000US110010016002010,"Block 2010, Block Group 2, Census Tract 16, District of Columbia, District of Columbia",45,18,22,0,0,0,0,5,45,41,18,21,0,0,0,0,2,4,0,1,0,0,0,0,3,110010016002010,4,401,401,4,psa_56,4D1
1000000US110010076052000,"Block 2000, Block Group 2, Census Tract 76.05, District of Columbia, District of Columbia",89,1,77,0,0,0,1,10,89,83,1,77,0,0,0,1,4,6,0,0,0,0,0,0,6,110010076052000,6,607,607,6,psa_10,6D2
1000000US110010102002006,"Block 2006, Block Group 2, Census Tract 102, District of Columbia, District of Columbia",0,0,0,0,0,0,0,0,0,0,0,0,0,0,0,0,0,0,0,0,0,0,0,0,0,110010102002006,1,103,103,1,psa_12,1D1
1000000US110010049012007,"Block 2007, Block Group 2, Census Tract 49.01, District of Columbia, District of Columbia",0,0,0,0,0,0,0,0,0,0,0,0,0,0,0,0,0,0,0,0,0,0,0,0,0,110010049012007,3,307,307,3,psa_28,3D3
1000000US110010095081010,"Block 1010, Block Group 1, Census Tract 95.08, District of Columbia, District of Columbia",0,0,0,0,0,0,0,0,0,0,0,0,0,0,0,0,0,0,0,0,0,0,0,0,0,110010095081010,4,405,405,4,psa_49,4D2
1000000US110010102001017,"Block 1017, Block Group 1, Census Tract 102, District of Columbia, District of Columbia",0,0,0,0,0,0,0,0,0,0,0,0,0,0,0,0,0,0,0,0,0,0,0,0,0,110010102001017,1,103,103,1,psa_12,1D1
1000000US110010010013005,"Block 3005, Block Group 3, Census Tract 10.01, District of Columbia, District of Columbia",81,70,3,0,5,0,1,2,81,74,65,3,0,5,0,0,1,7,5,0,0,0,0,1,1,110010010013005,2,202,202,2,psa_52,2D1
1000000US110010094002020,"Block 2020, Block Group 2, Census Tract 94, District of Columbia, District of Columbia",59,2,45,0,0,0,12,0,59,47,2,45,0,0,0,0,0,12,0,0,0,0,0,12,0,110010094002020,5,504,504,5,psa_43,5D2
1000000US110010021015001,"Block 5001, Block Group 5, Census Tract 21.01, District of Columbia, District of Columbia",216,10,148,7,3,0,47,1,216,137,9,126,0,1,0,0,1,79,1,22,7,2,0,47,0,110010021015001,4,403,403,4,psa_51,4D1
1000000US110010062021096,"Block 1096, Block Group 1, Census Tract 62.02, District of Columbia, District of Columbia",0,0,0,0,0,0,0,0,0,0,0,0,0,0,0,0,0,0,0,0,0,0,0,0,0,110010062021096,2,207,207,2,psa_24,2D3
1000000US110010011002018,"Block 2018, Block Group 2, Census Tract 11, District of Columbia, District of Columbia",70,63,0,0,3,0,0,4,70,66,60,0,0,3,0,0,3,4,3,0,0,0,0,0,1,110010011002018,2,202,202,2,psa_52,2D1
1000000US110010072002046,"Block 2046, Block Group 2, Census Tract 72, District of Columbia, District of Columbia",0,0,0,0,0,0,0,0,0,0,0,0,0,0,0,0,0,0,0,0,0,0,0,0,0,110010072002046,1,106,106,1,psa_13,1D3
1000000US110010078041000,"Block 1000, Block Group 1, Census Tract 78.04, District of Columbia, District of Columbia",202,2,199,0,0,0,1,0,202,199,2,197,0,0,0,0,0,3,0,2,0,0,0,1,0,110010078041000,6,602,602,6,psa_25,6D1
1000000US110010068041003,"Block 1003, Block Group 1, Census Tract 68.04, District of Columbia, District of Columbia",0,0,0,0,0,0,0,0,0,0,0,0,0,0,0,0,0,0,0,0,0,0,0,0,0,110010068041003,1,108,108,1,psa_17,1D2
1000000US110010088042000,"Block 2000, Block Group 2, Census Tract 88.04, District of Columbia, District of Columbia",0,0,0,0,0,0,0,0,0,0,0,0,0,0,0,0,0,0,0,0,0,0,0,0,0,110010088042000,5,506,506,5,psa_26,5D3
1000000US110010091021005,"Block 1005, Block Group 1, Census Tract 91.02, District of Columbia, District of Columbia",253,15,207,4,0,0,13,14,253,225,15,204,1,0,0,2,3,28,0,3,3,0,0,11,11,110010091021005,5,505,505,5,psa_34,5D2
1000000US110010010014011,"Block 4011, Block Group 4, Census Tract 10.01, District of Columbia, District of Columbia",0,0,0,0,0,0,0,0,0,0,0,0,0,0,0,0,0,0,0,0,0,0,0,0,0,110010010014011,2,202,202,2,psa_52,2D1
1000000US110010078091001,"Block 1001, Block Group 1, Census Tract 78.09, District of Columbia, District of Columbia",385,10,359,5,0,0,2,9,385,364,2,358,1,0,0,0,3,21,8,1,4,0,0,2,6,110010078091001,6,608,608,6,psa_19,6D1
1000000US110010022021000,"Block 1000, Block Group 1, Census Tract 22.02, District of Columbia, District of Columbia",77,11,46,0,0,0,20,0,77,53,7,46,0,0,0,0,0,24,4,0,0,0,0,20,0,110010022021000,4,407,407,4,psa_47,4D2
1000000US110010028012006,"Block 2006, Block Group 2, Census Tract 28.01, District of Columbia, District of Columbia",590,58,416,2,16,0,77,21,590,464,24,406,0,16,0,4,14,126,34,10,2,0,0,73,7,110010028012006,4,408,408,4,psa_39,4D3
1000000US110010106002007,"Block 2007, Block Group 2, Census Tract 106, District of Columbia, District of Columbia",0,0,0,0,0,0,0,0,0,0,0,0,0,0,0,0,0,0,0,0,0,0,0,0,0,110010106002007,5,501,501,5,psa_35,5D1
1000000US110010012004005,"Block 4005, Block Group 4, Census Tract 12, District of Columbia, District of Columbia",61,53,6,0,0,0,0,2,61,56,49,5,0,0,0,0,2,5,4,1,0,0,0,0,0,110010012004005,2,202,202,2,psa_52,2D1
1000000US110010042022004,"Block 2004, Block Group 2, Census Tract 42.02, District of Columbia, District of Columbia",492,424,33,1,23,0,3,8,492,471,409,32,1,23,0,1,5,21,15,1,0,0,0,2,3,110010042022004,2,208,208,2,psa_33,2D3
1000000US110010078042006,"Block 2006, Block Group 2, Census Tract 78.04, District of Columbia, District of Columbia",90,0,90,0,0,0,0,0,90,87,0,87,0,0,0,0,0,3,0,3,0,0,0,0,0,110010078042006,6,602,602,6,psa_25,6D1
1000000US110010104002006,"Block 2006, Block Group 2, Census Tract 104, District of Columbia, District of Columbia",0,0,0,0,0,0,0,0,0,0,0,0,0,0,0,0,0,0,0,0,0,0,0,0,0,110010104002006,7,703,703,7,psa_8,7D1
1000000US110010039002008,"Block 2008, Block Group 2, Census Tract 39, District of Columbia, District of Columbia",0,0,0,0,0,0,0,0,0,0,0,0,0,0,0,0,0,0,0,0,0,0,0,0,0,110010039002008,2,204,204,2,psa_44,2D2
1000000US110010026001010,"Block 1010, Block Group 1, Census Tract 26, District of Columbia, District of Columbia",35,25,8,0,0,0,2,0,35,33,25,8,0,0,0,0,0,2,0,0,0,0,0,2,0,110010026001010,4,404,404,4,psa_48,4D3
1000000US110010012002005,"Block 2005, Block Group 2, Census Tract 12, District of Columbia, District of Columbia",0,0,0,0,0,0,0,0,0,0,0,0,0,0,0,0,0,0,0,0,0,0,0,0,0,110010012002005,2,202,202,2,psa_52,2D1
1000000US110010095041009,"Block 1009, Block Group 1, Census Tract 95.04, District of Columbia, District of Columbia",48,15,26,0,0,0,4,3,48,39,12,26,0,0,0,0,1,9,3,0,0,0,0,4,2,110010095041009,4,405,405,4,psa_49,4D2
1000000US110010010014005,"Block 4005, Block Group 4, Census Tract 10.01, District of Columbia, District of Columbia",71,66,0,0,0,0,0,5,71,64,59,0,0,0,0,0,5,7,7,0,0,0,0,0,0,110010010014005,2,202,202,2,psa_52,2D1
1000000US110010055003006,"Block 3006, Block Group 3, Census Tract 55, District of Columbia, District of Columbia",48,38,1,0,7,0,1,1,48,46,38,0,0,7,0,0,1,2,0,1,0,0,0,1,0,110010055003006,2,207,207,2,psa_24,2D3
1000000US110010064001007,"Block 1007, Block Group 1, Census Tract 64, District of Columbia, District of Columbia",122,0,116,0,0,0,0,6,122,117,0,115,0,0,0,0,2,5,0,1,0,0,0,0,4,110010064001007,1,105,105,1,psa_22,1D3
1000000US110010075021004,"Block 1004, Block Group 1, Census Tract 75.02, District of Columbia, District of Columbia",265,6,244,0,1,0,4,10,265,265,6,244,0,1,0,4,10,0,0,0,0,0,0,0,0,110010075021004,7,702,702,7,psa_6,7D1
1000000US110010078062012,"Block 2012, Block Group 2, Census Tract 78.06, District of Columbia, District of Columbia",33,1,32,0,0,0,0,0,33,31,0,31,0,0,0,0,0,2,1,1,0,0,0,0,0,110010078062012,6,602,602,6,psa_25,6D1
1000000US110010001003007,"Block 3007, Block Group 3, Census Tract 1, District of Columbia, District of Columbia",49,46,0,0,2,0,0,1,49,44,41,0,0,2,0,0,1,5,5,0,0,0,0,0,0,110010001003007,2,206,206,2,psa_29,2D2
1000000US110010024003001,"Block 3001, Block Group 3, Census Tract 24, District of Columbia, District of Columbia",166,44,98,0,4,1,11,8,166,144,41,93,0,4,1,0,5,22,3,5,0,0,0,11,3,110010024003001,4,407,407,4,psa_47,4D2
1000000US110010040023000,"Block 3000, Block Group 3, Census Tract 40.02, District of Columbia, District of Columbia",0,0,0,0,0,0,0,0,0,0,0,0,0,0,0,0,0,0,0,0,0,0,0,0,0,110010040023000,3,303,303,3,psa_37,3D3
1000000US110010083021017,"Block 1017, Block Group 1, Census Tract 83.02, District of Columbia, District of Columbia",209,190,5,1,7,0,0,6,209,202,186,5,1,6,0,0,4,7,4,0,0,1,0,0,2,110010083021017,1,108,108,1,psa_17,1D2
1000000US110010105001003,"Block 1003, Block Group 1, Census Tract 105, District of Columbia, District of Columbia",671,223,391,2,19,0,14,22,671,628,197,390,2,18,0,2,19,43,26,1,0,1,0,12,3,110010105001003,1,103,103,1,psa_12,1D1
1000000US110010072002035,"Block 2035, Block Group 2, Census Tract 72, District of Columbia, District of Columbia",0,0,0,0,0,0,0,0,0,0,0,0,0,0,0,0,0,0,0,0,0,0,0,0,0,110010072002035,1,106,106,1,psa_13,1D3
1000000US110010092032002,"Block 2002, Block Group 2, Census Tract 92.03, District of Columbia, District of Columbia",0,0,0,0,0,0,0,0,0,0,0,0,0,0,0,0,0,0,0,0,0,0,0,0,0,110010092032002,5,502,502,5,psa_40,5D1
1000000US110010093012015,"Block 2015, Block Group 2, Census Tract 93.01, District of Columbia, District of Columbia",40,20,20,0,0,0,0,0,40,39,19,20,0,0,0,0,0,1,1,0,0,0,0,0,0,110010093012015,5,504,504,5,psa_43,5D2
1000000US110010021014001,"Block 4001, Block Group 4, Census Tract 21.01, District of Columbia, District of Columbia",44,2,27,0,0,0,15,0,44,27,0,27,0,0,0,0,0,17,2,0,0,0,0,15,0,110010021014001,4,403,403,4,psa_51,4D1
1000000US110010033021004,"Block 1004, Block Group 1, Census Tract 33.02, District of Columbia, District of Columbia",283,88,172,5,1,0,11,6,283,260,79,170,5,1,0,0,5,23,9,2,0,0,0,11,1,110010033021004,3,308,308,3,psa_27,3D2
1000000US110010044001007,"Block 1007, Block Group 1, Census Tract 44, District of Columbia, District of Columbia",94,77,7,1,7,0,2,0,94,90,75,7,1,7,0,0,0,4,2,0,0,0,0,2,0,110010044001007,3,305,305,3,psa_32,3D2
1000000US110010078082001,"Block 2001, Block Group 2, Census Tract 78.08, District of Columbia, District of Columbia",54,0,48,1,4,0,0,1,54,54,0,48,1,4,0,0,1,0,0,0,0,0,0,0,0,110010078082001,6,608,608,6,psa_19,6D1
1000000US110010097001008,"Block 1008, Block Group 1, Census Tract 97, District of Columbia, District of Columbia",0,0,0,0,0,0,0,0,0,0,0,0,0,0,0,0,0,0,0,0,0,0,0,0,0,110010097001008,7,706,706,7,psa_2,7D3
1000000US110010041003007,"Block 3007, Block Group 3, Census Tract 41, District of Columbia, District of Columbia",0,0,0,0,0,0,0,0,0,0,0,0,0,0,0,0,0,0,0,0,0,0,0,0,0,110010041003007,2,208,208,2,psa_33,2D3
1000000US110010065002018,"Block 2018, Block Group 2, Census Tract 65, District of Columbia, District of Columbia",168,136,20,0,6,0,3,3,168,160,131,20,0,6,0,0,3,8,5,0,0,0,0,3,0,110010065002018,1,106,106,1,psa_13,1D3
1000000US110010010015013,"Block 5013, Block Group 5, Census Tract 10.01, District of Columbia, District of Columbia",54,51,3,0,0,0,0,0,54,48,45,3,0,0,0,0,0,6,6,0,0,0,0,0,0,110010010015013,2,202,202,2,psa_52,2D1
1000000US110010043002005,"Block 2005, Block Group 2, Census Tract 43, District of Columbia, District of Columbia",148,111,23,0,10,0,0,4,148,139,104,23,0,10,0,0,2,9,7,0,0,0,0,0,2,110010043002005,3,301,301,3,psa_31,3D3
1000000US110010073011002,"Block 1002, Block Group 1, Census Tract 73.01, District of Columbia, District of Columbia",0,0,0,0,0,0,0,0,0,0,0,0,0,0,0,0,0,0,0,0,0,0,0,0,0,110010073011002,7,703,703,7,psa_8,7D1
1000000US110010064002033,"Block 2033, Block Group 2, Census Tract 64, District of Columbia, District of Columbia",0,0,0,0,0,0,0,0,0,0,0,0,0,0,0,0,0,0,0,0,0,0,0,0,0,110010064002033,1,105,105,1,psa_22,1D3
1000000US110010073011131,"Block 1131, Block Group 1, Census Tract 73.01, District of Columbia, District of Columbia",0,0,0,0,0,0,0,0,0,0,0,0,0,0,0,0,0,0,0,0,0,0,0,0,0,110010073011131,7,703,703,7,psa_8,7D1
1000000US110010007011002,"Block 1002, Block Group 1, Census Tract 7.01, District of Columbia, District of Columbia",19,19,0,0,0,0,0,0,19,18,18,0,0,0,0,0,0,1,1,0,0,0,0,0,0,110010007011002,2,204,204,2,psa_44,2D2
1000000US110010010016012,"Block 6012, Block Group 6, Census Tract 10.01, District of Columbia, District of Columbia",55,53,1,0,1,0,0,0,55,53,51,1,0,1,0,0,0,2,2,0,0,0,0,0,0,110010010016012,2,202,202,2,psa_52,2D1
1000000US110010070002008,"Block 2008, Block Group 2, Census Tract 70, District of Columbia, District of Columbia",0,0,0,0,0,0,0,0,0,0,0,0,0,0,0,0,0,0,0,0,0,0,0,0,0,110010070002008,1,107,107,1,psa_16,1D2
1000000US110010098022000,"Block 2000, Block Group 2, Census Tract 98.02, District of Columbia, District of Columbia",273,0,268,0,0,0,0,5,273,266,0,264,0,0,0,0,2,7,0,4,0,0,0,0,3,110010098022000,7,706,706,7,psa_2,7D3
1000000US110010044002015,"Block 2015, Block Group 2, Census Tract 44, District of Columbia, District of Columbia",162,100,43,1,14,0,0,4,162,149,91,43,0,14,0,0,1,13,9,0,1,0,0,0,3,110010044002015,3,305,305,3,psa_32,3D2
1000000US110010004001022,"Block 1022, Block Group 1, Census Tract 4, District of Columbia, District of Columbia",0,0,0,0,0,0,0,0,0,0,0,0,0,0,0,0,0,0,0,0,0,0,0,0,0,110010004001022,2,204,204,2,psa_44,2D2
1000000US110010008014003,"Block 4003, Block Group 4, Census Tract 8.01, District of Columbia, District of Columbia",34,29,4,0,1,0,0,0,34,32,27,4,0,1,0,0,0,2,2,0,0,0,0,0,0,110010008014003,2,205,205,2,psa_46,2D2
1000000US110010062021180,"Block 1180, Block Group 1, Census Tract 62.02, District of Columbia, District of Columbia",0,0,0,0,0,0,0,0,0,0,0,0,0,0,0,0,0,0,0,0,0,0,0,0,0,110010062021180,2,207,207,2,psa_24,2D3
1000000US110010084022003,"Block 2003, Block Group 2, Census Tract 84.02, District of Columbia, District of Columbia",0,0,0,0,0,0,0,0,0,0,0,0,0,0,0,0,0,0,0,0,0,0,0,0,0,110010084022003,1,104,104,1,psa_21,1D2
1000000US110010106001006,"Block 1006, Block Group 1, Census Tract 106, District of Columbia, District of Columbia",175,50,104,0,15,0,0,6,175,175,50,104,0,15,0,0,6,0,0,0,0,0,0,0,0,110010106001006,5,501,501,5,psa_35,5D1
1000000US110010062021157,"Block 1157, Block Group 1, Census Tract 62.02, District of Columbia, District of Columbia",0,0,0,0,0,0,0,0,0,0,0,0,0,0,0,0,0,0,0,0,0,0,0,0,0,110010062021157,1,102,102,1,psa_18,1D1
1000000US110010062021097,"Block 1097, Block Group 1, Census Tract 62.02, District of Columbia, District of Columbia",0,0,0,0,0,0,0,0,0,0,0,0,0,0,0,0,0,0,0,0,0,0,0,0,0,110010062021097,2,207,207,2,psa_24,2D3
1000000US110010033011001,"Block 1001, Block Group 1, Census Tract 33.01, District of Columbia, District of Columbia",232,28,197,1,1,0,0,5,232,228,27,195,1,1,0,0,4,4,1,2,0,0,0,0,1,110010033011001,3,306,306,3,psa_38,3D2
1000000US110010078043000,"Block 3000, Block Group 3, Census Tract 78.04, District of Columbia, District of Columbia",63,0,63,0,0,0,0,0,63,63,0,63,0,0,0,0,0,0,0,0,0,0,0,0,0,110010078043000,6,602,602,6,psa_25,6D1
1000000US110010048011024,"Block 1024, Block Group 1, Census Tract 48.01, District of Columbia, District of Columbia",0,0,0,0,0,0,0,0,0,0,0,0,0,0,0,0,0,0,0,0,0,0,0,0,0,110010048011024,3,308,308,3,psa_27,3D2
1000000US110010034001003,"Block 1003, Block Group 1, Census Tract 34, District of Columbia, District of Columbia",382,30,321,0,9,0,5,17,382,367,28,316,0,8,0,2,13,15,2,5,0,1,0,3,4,110010034001003,3,306,306,3,psa_38,3D2
1000000US110010004002030,"Block 2030, Block Group 2, Census Tract 4, District of Columbia, District of Columbia",0,0,0,0,0,0,0,0,0,0,0,0,0,0,0,0,0,0,0,0,0,0,0,0,0,110010004002030,2,204,204,2,psa_44,2D2
1000000US110010098071007,"Block 1007, Block Group 1, Census Tract 98.07, District of Columbia, District of Columbia",110,5,90,0,6,0,1,8,110,106,5,87,0,6,0,0,8,4,0,3,0,0,0,1,0,110010098071007,7,708,708,7,psa_1,7D3
1000000US110010048021007,"Block 1007, Block Group 1, Census Tract 48.02, District of Columbia, District of Columbia",162,93,46,1,8,0,6,8,162,143,82,45,1,8,0,1,6,19,11,1,0,0,0,5,2,110010048021007,3,308,308,3,psa_27,3D2
1000000US110010071001016,"Block 1016, Block Group 1, Census Tract 71, District of Columbia, District of Columbia",0,0,0,0,0,0,0,0,0,0,0,0,0,0,0,0,0,0,0,0,0,0,0,0,0,110010071001016,1,106,106,1,psa_13,1D3
1000000US110010074011041,"Block 1041, Block Group 1, Census Tract 74.01, District of Columbia, District of Columbia",0,0,0,0,0,0,0,0,0,0,0,0,0,0,0,0,0,0,0,0,0,0,0,0,0,110010074011041,7,703,703,7,psa_8,7D1
1000000US110010002024012,"Block 4012, Block Group 4, Census Tract 2.02, District of Columbia, District of Columbia",4,4,0,0,0,0,0,0,4,4,4,0,0,0,0,0,0,0,0,0,0,0,0,0,0,110010002024012,2,206,206,2,psa_29,2D2
1000000US110010021023003,"Block 3003, Block Group 3, Census Tract 21.02, District of Columbia, District of Columbia",151,9,136,0,0,0,0,6,151,145,9,133,0,0,0,0,3,6,0,3,0,0,0,0,3,110010021023003,4,403,403,4,psa_51,4D1
1000000US110010106002034,"Block 2034, Block Group 2, Census Tract 106, District of Columbia, District of Columbia",15,6,9,0,0,0,0,0,15,15,6,9,0,0,0,0,0,0,0,0,0,0,0,0,0,110010106002034,1,102,102,1,psa_18,1D1
1000000US110010095053008,"Block 3008, Block Group 3, Census Tract 95.05, District of Columbia, District of Columbia",174,13,146,1,0,0,9,5,174,150,7,139,1,0,0,0,3,24,6,7,0,0,0,9,2,110010095053008,4,406,406,4,psa_54,4D2
1000000US110010002021007,"Block 1007, Block Group 1, Census Tract 2.02, District of Columbia, District of Columbia",29,24,0,0,4,0,0,1,29,26,21,0,0,4,0,0,1,3,3,0,0,0,0,0,0,110010002021007,2,206,206,2,psa_29,2D2
1000000US110010078031004,"Block 1004, Block Group 1, Census Tract 78.03, District of Columbia, District of Columbia",0,0,0,0,0,0,0,0,0,0,0,0,0,0,0,0,0,0,0,0,0,0,0,0,0,110010078031004,6,602,602,6,psa_25,6D1
1000000US110010077072025,"Block 2025, Block Group 2, Census Tract 77.07, District of Columbia, District of Columbia",7,0,7,0,0,0,0,0,7,7,0,7,0,0,0,0,0,0,0,0,0,0,0,0,0,110010077072025,6,605,605,6,psa_11,6D2
1000000US110010099032007,"Block 2007, Block Group 2, Census Tract 99.03, District of Columbia, District of Columbia",64,1,63,0,0,0,0,0,64,64,1,63,0,0,0,0,0,0,0,0,0,0,0,0,0,110010099032007,6,604,604,6,psa_14,6D3
1000000US110010072001022,"Block 1022, Block Group 1, Census Tract 72, District of Columbia, District of Columbia",0,0,0,0,0,0,0,0,0,0,0,0,0,0,0,0,0,0,0,0,0,0,0,0,0,110010072001022,1,106,106,1,psa_13,1D3
1000000US110010107001030,"Block 1030, Block Group 1, Census Tract 107, District of Columbia, District of Columbia",0,0,0,0,0,0,0,0,0,0,0,0,0,0,0,0,0,0,0,0,0,0,0,0,0,110010107001030,2,207,207,2,psa_24,2D3
1000000US110010015005002,"Block 5002, Block Group 5, Census Tract 15, District of Columbia, District of Columbia",87,76,2,0,5,0,0,4,87,87,76,2,0,5,0,0,4,0,0,0,0,0,0,0,0,110010015005002,2,201,201,2,psa_55,2D1
1000000US110010073042005,"Block 2005, Block Group 2, Census Tract 73.04, District of Columbia, District of Columbia",80,6,73,0,0,0,1,0,80,77,6,71,0,0,0,0,0,3,0,2,0,0,0,1,0,110010073042005,7,705,705,7,psa_3,7D2
1000000US110010088022001,"Block 2001, Block Group 2, Census Tract 88.02, District of Columbia, District of Columbia",101,2,97,0,0,0,0,2,101,101,2,97,0,0,0,0,2,0,0,0,0,0,0,0,0,110010088022001,5,506,506,5,psa_26,5D3
1000000US110010066001005,"Block 1005, Block Group 1, Census Tract 66, District of Columbia, District of Columbia",0,0,0,0,0,0,0,0,0,0,0,0,0,0,0,0,0,0,0,0,0,0,0,0,0,110010066001005,1,106,106,1,psa_13,1D3
1000000US110010109002019,"Block 2019, Block Group 2, Census Tract 109, District of Columbia, District of Columbia",0,0,0,0,0,0,0,0,0,0,0,0,0,0,0,0,0,0,0,0,0,0,0,0,0,110010109002019,7,708,708,7,psa_1,7D3
1000000US110010058002014,"Block 2014, Block Group 2, Census Tract 58, District of Columbia, District of Columbia",0,0,0,0,0,0,0,0,0,0,0,0,0,0,0,0,0,0,0,0,0,0,0,0,0,110010058002014,1,102,102,1,psa_18,1D1
1000000US110010093013012,"Block 3012, Block Group 3, Census Tract 93.01, District of Columbia, District of Columbia",5,0,5,0,0,0,0,0,5,5,0,5,0,0,0,0,0,0,0,0,0,0,0,0,0,110010093013012,5,504,504,5,psa_43,5D2
1000000US110010005021008,"Block 1008, Block Group 1, Census Tract 5.02, District of Columbia, District of Columbia",184,154,2,3,14,0,5,6,184,150,131,2,1,13,0,1,2,34,23,0,2,1,0,4,4,110010005021008,2,204,204,2,psa_44,2D2
1000000US110010009013012,"Block 3012, Block Group 3, Census Tract 9.01, District of Columbia, District of Columbia",86,86,0,0,0,0,0,0,86,83,83,0,0,0,0,0,0,3,3,0,0,0,0,0,0,110010009013012,2,205,205,2,psa_46,2D2
1000000US110010013023005,"Block 3005, Block Group 3, Census Tract 13.02, District of Columbia, District of Columbia",71,55,5,0,10,0,1,0,71,64,48,5,0,10,0,1,0,7,7,0,0,0,0,0,0,110010013023005,2,203,203,2,psa_50,2D1
1000000US110010015004004,"Block 4004, Block Group 4, Census Tract 15, District of Columbia, District of Columbia",88,87,0,0,1,0,0,0,88,88,87,0,0,1,0,0,0,0,0,0,0,0,0,0,0,110010015004004,2,201,201,2,psa_55,2D1
1000000US110010072001010,"Block 1010, Block Group 1, Census Tract 72, District of Columbia, District of Columbia",976,736,159,2,37,0,8,34,976,918,698,151,2,37,0,1,29,58,38,8,0,0,0,7,5,110010072001010,1,106,106,1,psa_13,1D3
1000000US110010025024003,"Block 4003, Block Group 4, Census Tract 25.02, District of Columbia, District of Columbia",0,0,0,0,0,0,0,0,0,0,0,0,0,0,0,0,0,0,0,0,0,0,0,0,0,110010025024003,4,404,404,4,psa_48,4D3
1000000US110010046001004,"Block 1004, Block Group 1, Census Tract 46, District of Columbia, District of Columbia",384,99,246,1,13,0,9,16,384,347,77,243,1,13,0,1,12,37,22,3,0,0,0,8,4,110010046001004,3,308,308,3,psa_27,3D2
1000000US110010005011001,"Block 1001, Block Group 1, Census Tract 5.01, District of Columbia, District of Columbia",0,0,0,0,0,0,0,0,0,0,0,0,0,0,0,0,0,0,0,0,0,0,0,0,0,110010005011001,2,203,203,2,psa_50,2D1
1000000US110010041002004,"Block 2004, Block Group 2, Census Tract 41, District of Columbia, District of Columbia",43,39,0,0,4,0,0,0,43,42,38,0,0,4,0,0,0,1,1,0,0,0,0,0,0,110010041002004,2,208,208,2,psa_33,2D3
1000000US110010004002006,"Block 2006, Block Group 2, Census Tract 4, District of Columbia, District of Columbia",37,36,0,0,1,0,0,0,37,37,36,0,0,1,0,0,0,0,0,0,0,0,0,0,0,110010004002006,2,204,204,2,psa_44,2D2
1000000US110010055005001,"Block 5001, Block Group 5, Census Tract 55, District of Columbia, District of Columbia",258,188,10,1,41,1,4,13,258,235,176,10,1,40,1,0,7,23,12,0,0,1,0,4,6,110010055005001,2,208,208,2,psa_33,2D3
1000000US110010059001030,"Block 1030, Block Group 1, Census Tract 59, District of Columbia, District of Columbia",0,0,0,0,0,0,0,0,0,0,0,0,0,0,0,0,0,0,0,0,0,0,0,0,0,110010059001030,1,101,101,1,psa_20,1D1
1000000US110010074031001,"Block 1001, Block Group 1, Census Tract 74.03, District of Columbia, District of Columbia",0,0,0,0,0,0,0,0,0,0,0,0,0,0,0,0,0,0,0,0,0,0,0,0,0,110010074031001,7,704,704,7,psa_5,7D2
1000000US110010104001020,"Block 1020, Block Group 1, Census Tract 104, District of Columbia, District of Columbia",0,0,0,0,0,0,0,0,0,0,0,0,0,0,0,0,0,0,0,0,0,0,0,0,0,110010104001020,7,707,707,7,psa_4,7D2
1000000US110010016001008,"Block 1008, Block Group 1, Census Tract 16, District of Columbia, District of Columbia",35,10,25,0,0,0,0,0,35,34,9,25,0,0,0,0,0,1,1,0,0,0,0,0,0,110010016001008,4,401,401,4,psa_56,4D1
1000000US110010022011003,"Block 1003, Block Group 1, Census Tract 22.01, District of Columbia, District of Columbia",184,8,154,0,0,0,21,1,184,157,2,154,0,0,0,0,1,27,6,0,0,0,0,21,0,110010022011003,4,407,407,4,psa_47,4D2
1000000US110010072002043,"Block 2043, Block Group 2, Census Tract 72, District of Columbia, District of Columbia",0,0,0,0,0,0,0,0,0,0,0,0,0,0,0,0,0,0,0,0,0,0,0,0,0,110010072002043,1,106,106,1,psa_13,1D3
1000000US110010072002002,"Block 2002, Block Group 2, Census Tract 72, District of Columbia, District of Columbia",0,0,0,0,0,0,0,0,0,0,0,0,0,0,0,0,0,0,0,0,0,0,0,0,0,110010072002002,1,106,106,1,psa_13,1D3
1000000US110010078071003,"Block 1003, Block Group 1, Census Tract 78.07, District of Columbia, District of Columbia",57,0,57,0,0,0,0,0,57,57,0,57,0,0,0,0,0,0,0,0,0,0,0,0,0,110010078071003,6,608,608,6,psa_19,6D1
1000000US110010092032008,"Block 2008, Block Group 2, Census Tract 92.03, District of Columbia, District of Columbia",95,16,73,0,0,0,1,5,95,93,15,73,0,0,0,0,5,2,1,0,0,0,0,1,0,110010092032008,5,502,502,5,psa_40,5D1
1000000US110010003004010,"Block 4010, Block Group 4, Census Tract 3, District of Columbia, District of Columbia",135,123,1,0,5,0,2,4,135,130,120,1,0,5,0,0,4,5,3,0,0,0,0,2,0,110010003004010,2,204,204,2,psa_44,2D2
1000000US110010004002014,"Block 2014, Block Group 2, Census Tract 4, District of Columbia, District of Columbia",0,0,0,0,0,0,0,0,0,0,0,0,0,0,0,0,0,0,0,0,0,0,0,0,0,110010004002014,2,204,204,2,psa_44,2D2
1000000US110010106002055,"Block 2055, Block Group 2, Census Tract 106, District of Columbia, District of Columbia",0,0,0,0,0,0,0,0,0,0,0,0,0,0,0,0,0,0,0,0,0,0,0,0,0,110010106002055,1,102,102,1,psa_18,1D1
1000000US110010039002009,"Block 2009, Block Group 2, Census Tract 39, District of Columbia, District of Columbia",0,0,0,0,0,0,0,0,0,0,0,0,0,0,0,0,0,0,0,0,0,0,0,0,0,110010039002009,2,204,204,2,psa_44,2D2
1000000US110010024001008,"Block 1008, Block Group 1, Census Tract 24, District of Columbia, District of Columbia",101,23,70,0,1,0,7,0,101,88,17,70,0,1,0,0,0,13,6,0,0,0,0,7,0,110010024001008,4,407,407,4,psa_47,4D2
1000000US110010018041006,"Block 1006, Block Group 1, Census Tract 18.04, District of Columbia, District of Columbia",192,53,98,1,0,0,26,14,192,105,8,97,0,0,0,0,0,87,45,1,1,0,0,26,14,110010018041006,4,402,402,4,psa_53,4D1
1000000US110010039004000,"Block 4000, Block Group 4, Census Tract 39, District of Columbia, District of Columbia",537,420,58,1,20,1,11,26,537,486,384,57,1,20,1,3,20,51,36,1,0,0,0,8,6,110010039004000,3,303,303,3,psa_37,3D3
1000000US110010073011055,"Block 1055, Block Group 1, Census Tract 73.01, District of Columbia, District of Columbia",0,0,0,0,0,0,0,0,0,0,0,0,0,0,0,0,0,0,0,0,0,0,0,0,0,110010073011055,7,708,708,7,psa_1,7D3
1000000US110010075022001,"Block 2001, Block Group 2, Census Tract 75.02, District of Columbia, District of Columbia",159,2,146,0,0,0,0,11,159,149,2,141,0,0,0,0,6,10,0,5,0,0,0,0,5,110010075022001,7,702,702,7,psa_6,7D1
1000000US110010094004003,"Block 4003, Block Group 4, Census Tract 94, District of Columbia, District of Columbia",23,0,23,0,0,0,0,0,23,18,0,18,0,0,0,0,0,5,0,5,0,0,0,0,0,110010094004003,5,503,503,5,psa_45,5D2
1000000US110010095042012,"Block 2012, Block Group 2, Census Tract 95.04, District of Columbia, District of Columbia",43,9,33,0,1,0,0,0,43,41,7,33,0,1,0,0,0,2,2,0,0,0,0,0,0,110010095042012,4,405,405,4,psa_49,4D2
1000000US110010013011009,"Block 1009, Block Group 1, Census Tract 13.01, District of Columbia, District of Columbia",105,91,8,0,3,0,1,2,105,95,85,7,0,3,0,0,0,10,6,1,0,0,0,1,2,110010013011009,2,203,203,2,psa_50,2D1
1000000US110010056002021,"Block 2021, Block Group 2, Census Tract 56, District of Columbia, District of Columbia",0,0,0,0,0,0,0,0,0,0,0,0,0,0,0,0,0,0,0,0,0,0,0,0,0,110010056002021,2,207,207,2,psa_24,2D3
1000000US110010058001006,"Block 1006, Block Group 1, Census Tract 58, District of Columbia, District of Columbia",0,0,0,0,0,0,0,0,0,0,0,0,0,0,0,0,0,0,0,0,0,0,0,0,0,110010058001006,2,209,209,2,psa_57,2D3
1000000US110010062021175,"Block 1175, Block Group 1, Census Tract 62.02, District of Columbia, District of Columbia",0,0,0,0,0,0,0,0,0,0,0,0,0,0,0,0,0,0,0,0,0,0,0,0,0,110010062021175,2,207,207,2,psa_24,2D3
1000000US110010033013005,"Block 3005, Block Group 3, Census Tract 33.01, District of Columbia, District of Columbia",177,93,66,0,13,0,2,3,177,170,88,65,0,13,0,1,3,7,5,1,0,0,0,1,0,110010033013005,3,306,306,3,psa_38,3D2
1000000US110010073011127,"Block 1127, Block Group 1, Census Tract 73.01, District of Columbia, District of Columbia",0,0,0,0,0,0,0,0,0,0,0,0,0,0,0,0,0,0,0,0,0,0,0,0,0,110010073011127,7,703,703,7,psa_8,7D1
1000000US110010056002002,"Block 2002, Block Group 2, Census Tract 56, District of Columbia, District of Columbia",5,0,4,0,1,0,0,0,5,5,0,4,0,1,0,0,0,0,0,0,0,0,0,0,0,110010056002002,2,207,207,2,psa_24,2D3
1000000US110010062021144,"Block 1144, Block Group 1, Census Tract 62.02, District of Columbia, District of Columbia",0,0,0,0,0,0,0,0,0,0,0,0,0,0,0,0,0,0,0,0,0,0,0,0,0,110010062021144,1,102,102,1,psa_18,1D1
1000000US110010072001005,"Block 1005, Block Group 1, Census Tract 72, District of Columbia, District of Columbia",0,0,0,0,0,0,0,0,0,0,0,0,0,0,0,0,0,0,0,0,0,0,0,0,0,110010072001005,1,106,106,1,psa_13,1D3
1000000US110010076015009,"Block 5009, Block Group 5, Census Tract 76.01, District of Columbia, District of Columbia",0,0,0,0,0,0,0,0,0,0,0,0,0,0,0,0,0,0,0,0,0,0,0,0,0,110010076015009,6,607,607,6,psa_10,6D2
1000000US110010083021010,"Block 1010, Block Group 1, Census Tract 83.02, District of Columbia, District of Columbia",14,5,9,0,0,0,0,0,14,14,5,9,0,0,0,0,0,0,0,0,0,0,0,0,0,110010083021010,1,108,108,1,psa_17,1D2
1000000US110010009012001,"Block 2001, Block Group 2, Census Tract 9.01, District of Columbia, District of Columbia",0,0,0,0,0,0,0,0,0,0,0,0,0,0,0,0,0,0,0,0,0,0,0,0,0,110010009012001,2,205,205,2,psa_46,2D2
1000000US110010080022010,"Block 2010, Block Group 2, Census Tract 80.02, District of Columbia, District of Columbia",22,10,10,1,1,0,0,0,22,21,10,10,1,0,0,0,0,1,0,0,0,1,0,0,0,110010080022010,1,108,108,1,psa_17,1D2
1000000US110010011003009,"Block 3009, Block Group 3, Census Tract 11, District of Columbia, District of Columbia",28,23,5,0,0,0,0,0,28,25,20,5,0,0,0,0,0,3,3,0,0,0,0,0,0,110010011003009,2,203,203,2,psa_50,2D1
1000000US110010074071002,"Block 1002, Block Group 1, Census Tract 74.07, District of Columbia, District of Columbia",106,0,103,1,0,0,0,2,106,106,0,103,1,0,0,0,2,0,0,0,0,0,0,0,0,110010074071002,7,702,702,7,psa_6,7D1
1000000US110010108003008,"Block 3008, Block Group 3, Census Tract 108.00, District of Columbia, District of Columbia",0,0,0,0,0,0,0,0,0,0,0,0,0,0,0,0,0,0,0,0,0,0,0,0,0,110010108003008,2,207,207,2,psa_24,2D3
1000000US110010022012006,"Block 2006, Block Group 2, Census Tract 22.01, District of Columbia, District of Columbia",127,2,41,0,12,0,72,0,127,52,0,40,0,12,0,0,0,75,2,1,0,0,0,72,0,110010022012006,4,407,407,4,psa_47,4D2
1000000US110010007011001,"Block 1001, Block Group 1, Census Tract 7.01, District of Columbia, District of Columbia",81,76,1,0,3,0,0,1,81,76,71,1,0,3,0,0,1,5,5,0,0,0,0,0,0,110010007011001,2,204,204,2,psa_44,2D2
1000000US110010099022006,"Block 2006, Block Group 2, Census Tract 99.02, District of Columbia, District of Columbia",72,2,69,0,0,0,0,1,72,69,0,68,0,0,0,0,1,3,2,1,0,0,0,0,0,110010099022006,6,605,605,6,psa_11,6D2
1000000US110010062021028,"Block 1028, Block Group 1, Census Tract 62.02, District of Columbia, District of Columbia",0,0,0,0,0,0,0,0,0,0,0,0,0,0,0,0,0,0,0,0,0,0,0,0,0,110010062021028,2,207,207,2,psa_24,2D3
1000000US110010068012001,"Block 2001, Block Group 2, Census Tract 68.01, District of Columbia, District of Columbia",56,17,39,0,0,0,0,0,56,56,17,39,0,0,0,0,0,0,0,0,0,0,0,0,0,110010068012001,1,107,107,1,psa_16,1D2
1000000US110010078062007,"Block 2007, Block Group 2, Census Tract 78.06, District of Columbia, District of Columbia",71,0,71,0,0,0,0,0,71,71,0,71,0,0,0,0,0,0,0,0,0,0,0,0,0,110010078062007,6,602,602,6,psa_25,6D1
1000000US110010018041001,"Block 1001, Block Group 1, Census Tract 18.04, District of Columbia, District of Columbia",24,4,15,0,0,0,5,0,24,19,4,15,0,0,0,0,0,5,0,0,0,0,0,5,0,110010018041001,4,401,401,4,psa_56,4D1
1000000US110010074031006,"Block 1006, Block Group 1, Census Tract 74.03, District of Columbia, District of Columbia",206,2,201,2,1,0,0,0,206,202,2,199,0,1,0,0,0,4,0,2,2,0,0,0,0,110010074031006,7,704,704,7,psa_5,7D2
1000000US110010099032000,"Block 2000, Block Group 2, Census Tract 99.03, District of Columbia, District of Columbia",69,0,69,0,0,0,0,0,69,69,0,69,0,0,0,0,0,0,0,0,0,0,0,0,0,110010099032000,6,604,604,6,psa_14,6D3
1000000US110010004001000,"Block 1000, Block Group 1, Census Tract 4, District of Columbia, District of Columbia",6,3,3,0,0,0,0,0,6,6,3,3,0,0,0,0,0,0,0,0,0,0,0,0,0,110010004001000,2,204,204,2,psa_44,2D2
1000000US110010102002004,"Block 2004, Block Group 2, Census Tract 102, District of Columbia, District of Columbia",0,0,0,0,0,0,0,0,0,0,0,0,0,0,0,0,0,0,0,0,0,0,0,0,0,110010102002004,1,103,103,1,psa_12,1D1
1000000US110010078071001,"Block 1001, Block Group 1, Census Tract 78.07, District of Columbia, District of Columbia",42,0,42,0,0,0,0,0,42,42,0,42,0,0,0,0,0,0,0,0,0,0,0,0,0,110010078071001,6,608,608,6,psa_19,6D1
1000000US110010090001005,"Block 1005, Block Group 1, Census Tract 90, District of Columbia, District of Columbia",0,0,0,0,0,0,0,0,0,0,0,0,0,0,0,0,0,0,0,0,0,0,0,0,0,110010090001005,5,503,503,5,psa_45,5D2
1000000US110010011004009,"Block 4009, Block Group 4, Census Tract 11, District of Columbia, District of Columbia",25,25,0,0,0,0,0,0,25,22,22,0,0,0,0,0,0,3,3,0,0,0,0,0,0,110010011004009,2,202,202,2,psa_52,2D1
1000000US110010013011017,"Block 1017, Block Group 1, Census Tract 13.01, District of Columbia, District of Columbia",65,64,1,0,0,0,0,0,65,59,58,1,0,0,0,0,0,6,6,0,0,0,0,0,0,110010013011017,2,203,203,2,psa_50,2D1
1000000US110010072002009,"Block 2009, Block Group 2, Census Tract 72, District of Columbia, District of Columbia",0,0,0,0,0,0,0,0,0,0,0,0,0,0,0,0,0,0,0,0,0,0,0,0,0,110010072002009,1,106,106,1,psa_13,1D3
1000000US110010095012005,"Block 2005, Block Group 2, Census Tract 95.01, District of Columbia, District of Columbia",71,1,59,3,0,2,5,1,71,63,1,58,3,0,0,0,1,8,0,1,0,0,2,5,0,110010095012005,4,405,405,4,psa_49,4D2
1000000US110010009022014,"Block 2014, Block Group 2, Census Tract 9.02, District of Columbia, District of Columbia",0,0,0,0,0,0,0,0,0,0,0,0,0,0,0,0,0,0,0,0,0,0,0,0,0,110010009022014,2,205,205,2,psa_46,2D2
1000000US110010068011001,"Block 1001, Block Group 1, Census Tract 68.01, District of Columbia, District of Columbia",120,46,57,0,6,0,0,11,120,113,40,57,0,6,0,0,10,7,6,0,0,0,0,0,1,110010068011001,1,107,107,1,psa_16,1D2
1000000US110010093021003,"Block 1003, Block Group 1, Census Tract 93.02, District of Columbia, District of Columbia",75,14,57,0,0,0,0,4,75,74,13,57,0,0,0,0,4,1,1,0,0,0,0,0,0,110010093021003,5,504,504,5,psa_43,5D2
1000000US110010099051010,"Block 1010, Block Group 1, Census Tract 99.05, District of Columbia, District of Columbia",118,0,115,0,1,0,0,2,118,117,0,114,0,1,0,0,2,1,0,1,0,0,0,0,0,110010099051010,6,604,604,6,psa_14,6D3
1000000US110010102002026,"Block 2026, Block Group 2, Census Tract 102, District of Columbia, District of Columbia",0,0,0,0,0,0,0,0,0,0,0,0,0,0,0,0,0,0,0,0,0,0,0,0,0,110010102002026,1,103,103,1,psa_12,1D1
1000000US110010111003017,"Block 3017, Block Group 3, Census Tract 111, District of Columbia, District of Columbia",180,24,134,7,1,0,10,4,180,150,12,128,5,1,0,1,3,30,12,6,2,0,0,9,1,110010111003017,5,505,505,5,psa_34,5D2
1000000US110010042021005,"Block 1005, Block Group 1, Census Tract 42.02, District of Columbia, District of Columbia",295,255,5,3,20,0,5,7,295,274,241,5,1,20,0,0,7,21,14,0,2,0,0,5,0,110010042021005,2,208,208,2,psa_33,2D3
1000000US110010046002008,"Block 2008, Block Group 2, Census Tract 46, District of Columbia, District of Columbia",96,37,53,0,3,0,0,3,96,94,35,53,0,3,0,0,3,2,2,0,0,0,0,0,0,110010046002008,3,308,308,3,psa_27,3D2
1000000US110010072001023,"Block 1023, Block Group 1, Census Tract 72, District of Columbia, District of Columbia",300,208,50,2,29,0,7,4,300,272,188,50,1,29,0,1,3,28,20,0,1,0,0,6,1,110010072001023,1,106,106,1,psa_13,1D3
1000000US110010084021004,"Block 1004, Block Group 1, Census Tract 84.02, District of Columbia, District of Columbia",104,72,25,0,1,0,1,5,104,100,69,24,0,1,0,1,5,4,3,1,0,0,0,0,0,110010084021004,1,104,104,1,psa_21,1D2
1000000US110010111002006,"Block 2006, Block Group 2, Census Tract 111, District of Columbia, District of Columbia",136,5,100,0,0,0,31,0,136,103,3,100,0,0,0,0,0,33,2,0,0,0,0,31,0,110010111002006,5,503,503,5,psa_45,5D2
1000000US110010024002014,"Block 2014, Block Group 2, Census Tract 24, District of Columbia, District of Columbia",114,30,59,0,0,0,25,0,114,79,20,59,0,0,0,0,0,35,10,0,0,0,0,25,0,110010024002014,4,407,407,4,psa_47,4D2
1000000US110010062021211,"Block 1211, Block Group 1, Census Tract 62.02, District of Columbia, District of Columbia",0,0,0,0,0,0,0,0,0,0,0,0,0,0,0,0,0,0,0,0,0,0,0,0,0,110010062021211,1,103,103,1,psa_12,1D1
1000000US110010102001004,"Block 1004, Block Group 1, Census Tract 102, District of Columbia, District of Columbia",0,0,0,0,0,0,0,0,0,0,0,0,0,0,0,0,0,0,0,0,0,0,0,0,0,110010102001004,1,103,103,1,psa_12,1D1
1000000US110010008013024,"Block 3024, Block Group 3, Census Tract 8.01, District of Columbia, District of Columbia",0,0,0,0,0,0,0,0,0,0,0,0,0,0,0,0,0,0,0,0,0,0,0,0,0,110010008013024,2,204,204,2,psa_44,2D2
1000000US110010014021006,"Block 1006, Block Group 1, Census Tract 14.02, District of Columbia, District of Columbia",3,3,0,0,0,0,0,0,3,3,3,0,0,0,0,0,0,0,0,0,0,0,0,0,0,110010014021006,2,201,201,2,psa_55,2D1
1000000US110010088042009,"Block 2009, Block Group 2, Census Tract 88.04, District of Columbia, District of Columbia",0,0,0,0,0,0,0,0,0,0,0,0,0,0,0,0,0,0,0,0,0,0,0,0,0,110010088042009,5,506,506,5,psa_26,5D3
1000000US110010010012012,"Block 2012, Block Group 2, Census Tract 10.01, District of Columbia, District of Columbia",17,17,0,0,0,0,0,0,17,17,17,0,0,0,0,0,0,0,0,0,0,0,0,0,0,110010010012012,2,202,202,2,psa_52,2D1
1000000US110010096021003,"Block 1003, Block Group 1, Census Tract 96.02, District of Columbia, District of Columbia",0,0,0,0,0,0,0,0,0,0,0,0,0,0,0,0,0,0,0,0,0,0,0,0,0,110010096021003,6,601,601,6,psa_30,6D1
1000000US110010076033008,"Block 3008, Block Group 3, Census Tract 76.03, District of Columbia, District of Columbia",87,4,83,0,0,0,0,0,87,87,4,83,0,0,0,0,0,0,0,0,0,0,0,0,0,110010076033008,6,606,606,6,psa_7,6D2
1000000US110010110002002,"Block 2002, Block Group 2, Census Tract 110, District of Columbia, District of Columbia",0,0,0,0,0,0,0,0,0,0,0,0,0,0,0,0,0,0,0,0,0,0,0,0,0,110010110002002,1,103,103,1,psa_12,1D1
1000000US110010018041003,"Block 1003, Block Group 1, Census Tract 18.04, District of Columbia, District of Columbia",13,0,13,0,0,0,0,0,13,13,0,13,0,0,0,0,0,0,0,0,0,0,0,0,0,110010018041003,4,401,401,4,psa_56,4D1
1000000US110010108002004,"Block 2004, Block Group 2, Census Tract 108.00, District of Columbia, District of Columbia",0,0,0,0,0,0,0,0,0,0,0,0,0,0,0,0,0,0,0,0,0,0,0,0,0,110010108002004,2,207,207,2,psa_24,2D3
1000000US110010014023000,"Block 3000, Block Group 3, Census Tract 14.02, District of Columbia, District of Columbia",44,36,1,0,5,0,0,2,44,42,34,1,0,5,0,0,2,2,2,0,0,0,0,0,0,110010014023000,2,201,201,2,psa_55,2D1
1000000US110010024002009,"Block 2009, Block Group 2, Census Tract 24, District of Columbia, District of Columbia",110,18,65,1,4,0,20,2,110,83,14,63,1,4,0,0,1,27,4,2,0,0,0,20,1,110010024002009,4,407,407,4,psa_47,4D2
1000000US110010028021002,"Block 1002, Block Group 1, Census Tract 28.02, District of Columbia, District of Columbia",276,115,20,8,12,0,97,24,276,75,40,19,1,12,0,1,2,201,75,1,7,0,0,96,22,110010028021002,3,302,302,3,psa_42,3D1
1000000US110010080022021,"Block 2021, Block Group 2, Census Tract 80.02, District of Columbia, District of Columbia",0,0,0,0,0,0,0,0,0,0,0,0,0,0,0,0,0,0,0,0,0,0,0,0,0,110010080022021,1,108,108,1,psa_17,1D2
1000000US110010084101014,"Block 1014, Block Group 1, Census Tract 84.10, District of Columbia, District of Columbia",120,25,88,0,1,0,1,5,120,116,22,88,0,1,0,0,5,4,3,0,0,0,0,1,0,110010084101014,1,104,104,1,psa_21,1D2
1000000US110010104002042,"Block 2042, Block Group 2, Census Tract 104, District of Columbia, District of Columbia",132,3,124,1,0,0,0,4,132,132,3,124,1,0,0,0,4,0,0,0,0,0,0,0,0,110010104002042,7,707,707,7,psa_4,7D2
1000000US110010009011006,"Block 1006, Block Group 1, Census Tract 9.01, District of Columbia, District of Columbia",50,41,0,0,7,0,0,2,50,47,38,0,0,7,0,0,2,3,3,0,0,0,0,0,0,110010009011006,2,205,205,2,psa_46,2D2
1000000US110010111001007,"Block 1007, Block Group 1, Census Tract 111, District of Columbia, District of Columbia",19,0,13,0,4,0,0,2,19,19,0,13,0,4,0,0,2,0,0,0,0,0,0,0,0,110010111001007,5,503,503,5,psa_45,5D2
1000000US110010078062018,"Block 2018, Block Group 2, Census Tract 78.06, District of Columbia, District of Columbia",70,0,70,0,0,0,0,0,70,70,0,70,0,0,0,0,0,0,0,0,0,0,0,0,0,110010078062018,6,602,602,6,psa_25,6D1
1000000US110010041003017,"Block 3017, Block Group 3, Census Tract 41, District of Columbia, District of Columbia",0,0,0,0,0,0,0,0,0,0,0,0,0,0,0,0,0,0,0,0,0,0,0,0,0,110010041003017,2,208,208,2,psa_33,2D3
1000000US110010070002009,"Block 2009, Block Group 2, Census Tract 70, District of Columbia, District of Columbia",92,80,11,0,0,0,1,0,92,84,73,11,0,0,0,0,0,8,7,0,0,0,0,1,0,110010070002009,1,106,106,1,psa_13,1D3
1000000US110010099042001,"Block 2001, Block Group 2, Census Tract 99.04, District of Columbia, District of Columbia",103,9,88,0,0,0,3,3,103,95,4,88,0,0,0,0,3,8,5,0,0,0,0,3,0,110010099042001,6,604,604,6,psa_14,6D3
1000000US110010008022015,"Block 2015, Block Group 2, Census Tract 8.02, District of Columbia, District of Columbia",127,106,0,0,10,0,7,4,127,117,101,0,0,10,0,2,4,10,5,0,0,0,0,5,0,110010008022015,2,205,205,2,psa_46,2D2
1000000US110010010012027,"Block 2027, Block Group 2, Census Tract 10.01, District of Columbia, District of Columbia",23,15,1,0,2,0,0,5,23,23,15,1,0,2,0,0,5,0,0,0,0,0,0,0,0,110010010012027,2,202,202,2,psa_52,2D1
1000000US110010106002005,"Block 2005, Block Group 2, Census Tract 106, District of Columbia, District of Columbia",0,0,0,0,0,0,0,0,0,0,0,0,0,0,0,0,0,0,0,0,0,0,0,0,0,110010106002005,5,501,501,5,psa_35,5D1
1000000US110010021011002,"Block 1002, Block Group 1, Census Tract 21.01, District of Columbia, District of Columbia",126,30,69,0,5,1,16,5,126,79,3,69,0,5,1,0,1,47,27,0,0,0,0,16,4,110010021011002,4,403,403,4,psa_51,4D1
1000000US110010025023003,"Block 3003, Block Group 3, Census Tract 25.02, District of Columbia, District of Columbia",271,71,134,2,7,0,47,10,271,209,59,128,2,7,0,7,6,62,12,6,0,0,0,40,4,110010025023003,4,404,404,4,psa_48,4D3
1000000US110010076042033,"Block 2033, Block Group 2, Census Tract 76.04, District of Columbia, District of Columbia",0,0,0,0,0,0,0,0,0,0,0,0,0,0,0,0,0,0,0,0,0,0,0,0,0,110010076042033,6,606,606,6,psa_7,6D2
1000000US110010107002003,"Block 2003, Block Group 2, Census Tract 107, District of Columbia, District of Columbia",2,1,1,0,0,0,0,0,2,2,1,1,0,0,0,0,0,0,0,0,0,0,0,0,0,110010107002003,2,208,208,2,psa_33,2D3
1000000US110010098072002,"Block 2002, Block Group 2, Census Tract 98.07, District of Columbia, District of Columbia",0,0,0,0,0,0,0,0,0,0,0,0,0,0,0,0,0,0,0,0,0,0,0,0,0,110010098072002,7,708,708,7,psa_1,7D3
1000000US110010011004026,"Block 4026, Block Group 4, Census Tract 11, District of Columbia, District of Columbia",0,0,0,0,0,0,0,0,0,0,0,0,0,0,0,0,0,0,0,0,0,0,0,0,0,110010011004026,2,202,202,2,psa_52,2D1
1000000US110010019014013,"Block 4013, Block Group 4, Census Tract 19.01, District of Columbia, District of Columbia",87,22,60,0,0,0,2,3,87,78,15,60,0,0,0,0,3,9,7,0,0,0,0,2,0,110010019014013,4,402,402,4,psa_53,4D1
1000000US110010062021147,"Block 1147, Block Group 1, Census Tract 62.02, District of Columbia, District of Columbia",0,0,0,0,0,0,0,0,0,0,0,0,0,0,0,0,0,0,0,0,0,0,0,0,0,110010062021147,1,102,102,1,psa_18,1D1
1000000US110010103001015,"Block 1015, Block Group 1, Census Tract 103, District of Columbia, District of Columbia",78,15,62,0,0,0,1,0,78,77,15,62,0,0,0,0,0,1,0,0,0,0,0,1,0,110010103001015,4,401,401,4,psa_56,4D1
1000000US110010002023013,"Block 3013, Block Group 3, Census Tract 2.02, District of Columbia, District of Columbia",40,37,0,0,0,0,0,3,40,33,30,0,0,0,0,0,3,7,7,0,0,0,0,0,0,110010002023013,2,206,206,2,psa_29,2D2
1000000US110010096031006,"Block 1006, Block Group 1, Census Tract 96.03, District of Columbia, District of Columbia",100,0,100,0,0,0,0,0,100,100,0,100,0,0,0,0,0,0,0,0,0,0,0,0,0,110010096031006,6,603,603,6,psa_15,6D3
1000000US110010014011005,"Block 1005, Block Group 1, Census Tract 14.01, District of Columbia, District of Columbia",72,71,0,0,0,0,1,0,72,64,63,0,0,0,0,1,0,8,8,0,0,0,0,0,0,110010014011005,2,201,201,2,psa_55,2D1
1000000US110010073011044,"Block 1044, Block Group 1, Census Tract 73.01, District of Columbia, District of Columbia",44,33,9,0,0,0,2,0,44,37,28,9,0,0,0,0,0,7,5,0,0,0,0,2,0,110010073011044,7,707,707,7,psa_4,7D2
1000000US110010091022009,"Block 2009, Block Group 2, Census Tract 91.02, District of Columbia, District of Columbia",110,7,99,0,2,0,2,0,110,106,4,99,0,2,0,1,0,4,3,0,0,0,0,1,0,110010091022009,5,505,505,5,psa_34,5D2
1000000US110010009012014,"Block 2014, Block Group 2, Census Tract 9.01, District of Columbia, District of Columbia",46,44,0,0,1,0,1,0,46,45,44,0,0,1,0,0,0,1,0,0,0,0,0,1,0,110010009012014,2,205,205,2,psa_46,2D2
1000000US110010029002002,"Block 2002, Block Group 2, Census Tract 29, District of Columbia, District of Columbia",178,47,44,6,7,0,69,5,178,75,32,36,0,7,0,0,0,103,15,8,6,0,0,69,5,110010029002002,4,408,408,4,psa_39,4D3
1000000US110010047012002,"Block 2002, Block Group 2, Census Tract 47.01, District of Columbia, District of Columbia",163,14,146,0,3,0,0,0,163,160,14,143,0,3,0,0,0,3,0,3,0,0,0,0,0,110010047012002,1,102,102,1,psa_18,1D1
1000000US110010111003014,"Block 3014, Block Group 3, Census Tract 111, District of Columbia, District of Columbia",0,0,0,0,0,0,0,0,0,0,0,0,0,0,0,0,0,0,0,0,0,0,0,0,0,110010111003014,5,505,505,5,psa_34,5D2
1000000US110010025022009,"Block 2009, Block Group 2, Census Tract 25.02, District of Columbia, District of Columbia",127,56,49,5,2,0,10,5,127,79,32,38,5,2,0,0,2,48,24,11,0,0,0,10,3,110010025022009,4,404,404,4,psa_48,4D3
1000000US110010107001032,"Block 1032, Block Group 1, Census Tract 107, District of Columbia, District of Columbia",53,15,32,1,0,0,3,2,53,44,13,29,1,0,0,0,1,9,2,3,0,0,0,3,1,110010107001032,2,207,207,2,psa_24,2D3
1000000US110010027023003,"Block 3003, Block Group 3, Census Tract 27.02, District of Columbia, District of Columbia",0,0,0,0,0,0,0,0,0,0,0,0,0,0,0,0,0,0,0,0,0,0,0,0,0,110010027023003,3,302,302,3,psa_42,3D1
1000000US110010095031014,"Block 1014, Block Group 1, Census Tract 95.03, District of Columbia, District of Columbia",67,12,50,0,3,0,2,0,67,59,6,50,0,3,0,0,0,8,6,0,0,0,0,2,0,110010095031014,4,405,405,4,psa_49,4D2
1000000US110010098011000,"Block 1000, Block Group 1, Census Tract 98.01, District of Columbia, District of Columbia",0,0,0,0,0,0,0,0,0,0,0,0,0,0,0,0,0,0,0,0,0,0,0,0,0,110010098011000,7,705,705,7,psa_3,7D2
1000000US110010093012017,"Block 2017, Block Group 2, Census Tract 93.01, District of Columbia, District of Columbia",66,39,25,0,0,0,0,2,66,58,32,25,0,0,0,0,1,8,7,0,0,0,0,0,1,110010093012017,5,504,504,5,psa_43,5D2
1000000US110010073011071,"Block 1071, Block Group 1, Census Tract 73.01, District of Columbia, District of Columbia",0,0,0,0,0,0,0,0,0,0,0,0,0,0,0,0,0,0,0,0,0,0,0,0,0,110010073011071,7,707,707,7,psa_4,7D2
1000000US110010098112008,"Block 2008, Block Group 2, Census Tract 98.11, District of Columbia, District of Columbia",39,0,38,0,0,0,0,1,39,39,0,38,0,0,0,0,1,0,0,0,0,0,0,0,0,110010098112008,7,706,706,7,psa_2,7D3
1000000US110010052014004,"Block 4004, Block Group 4, Census Tract 52.01, District of Columbia, District of Columbia",249,213,11,0,14,0,3,8,249,234,203,11,0,14,0,1,5,15,10,0,0,0,0,2,3,110010052014004,2,208,208,2,psa_33,2D3
1000000US110010008014014,"Block 4014, Block Group 4, Census Tract 8.01, District of Columbia, District of Columbia",22,22,0,0,0,0,0,0,22,22,22,0,0,0,0,0,0,0,0,0,0,0,0,0,0,110010008014014,2,205,205,2,psa_46,2D2
1000000US110010062021208,"Block 1208, Block Group 1, Census Tract 62.02, District of Columbia, District of Columbia",0,0,0,0,0,0,0,0,0,0,0,0,0,0,0,0,0,0,0,0,0,0,0,0,0,110010062021208,1,103,103,1,psa_12,1D1
1000000US110010073011128,"Block 1128, Block Group 1, Census Tract 73.01, District of Columbia, District of Columbia",0,0,0,0,0,0,0,0,0,0,0,0,0,0,0,0,0,0,0,0,0,0,0,0,0,110010073011128,7,703,703,7,psa_8,7D1
1000000US110010094001011,"Block 1011, Block Group 1, Census Tract 94, District of Columbia, District of Columbia",44,11,32,0,1,0,0,0,44,44,11,32,0,1,0,0,0,0,0,0,0,0,0,0,0,110010094001011,5,503,503,5,psa_45,5D2
1000000US110010095071009,"Block 1009, Block Group 1, Census Tract 95.07, District of Columbia, District of Columbia",99,1,74,0,0,0,19,5,99,77,1,74,0,0,0,0,2,22,0,0,0,0,0,19,3,110010095071009,4,406,406,4,psa_54,4D2
1000000US110010105002011,"Block 2011, Block Group 2, Census Tract 105, District of Columbia, District of Columbia",0,0,0,0,0,0,0,0,0,0,0,0,0,0,0,0,0,0,0,0,0,0,0,0,0,110010105002011,1,103,103,1,psa_12,1D1
1000000US110010013021000,"Block 1000, Block Group 1, Census Tract 13.02, District of Columbia, District of Columbia",100,83,10,0,6,0,0,1,100,98,81,10,0,6,0,0,1,2,2,0,0,0,0,0,0,110010013021000,2,203,203,2,psa_50,2D1
1000000US110010016001007,"Block 1007, Block Group 1, Census Tract 16, District of Columbia, District of Columbia",40,12,26,0,2,0,0,0,40,39,12,25,0,2,0,0,0,1,0,1,0,0,0,0,0,110010016001007,4,401,401,4,psa_56,4D1
1000000US110010098031003,"Block 1003, Block Group 1, Census Tract 98.03, District of Columbia, District of Columbia",194,0,194,0,0,0,0,0,194,191,0,191,0,0,0,0,0,3,0,3,0,0,0,0,0,110010098031003,7,707,707,7,psa_4,7D2
1000000US110010101001012,"Block 1012, Block Group 1, Census Tract 101, District of Columbia, District of Columbia",168,125,18,0,18,0,3,4,168,151,111,18,0,18,0,1,3,17,14,0,0,0,0,2,1,110010101001012,2,209,209,2,psa_57,2D3
1000000US110010001001003,"Block 1003, Block Group 1, Census Tract 1, District of Columbia, District of Columbia",141,137,0,0,4,0,0,0,141,134,130,0,0,4,0,0,0,7,7,0,0,0,0,0,0,110010001001003,2,206,206,2,psa_29,2D2
1000000US110010044002008,"Block 2008, Block Group 2, Census Tract 44, District of Columbia, District of Columbia",129,97,25,1,1,0,0,5,129,117,86,25,1,1,0,0,4,12,11,0,0,0,0,0,1,110010044002008,3,305,305,3,psa_32,3D2
1000000US110010106002027,"Block 2027, Block Group 2, Census Tract 106, District of Columbia, District of Columbia",0,0,0,0,0,0,0,0,0,0,0,0,0,0,0,0,0,0,0,0,0,0,0,0,0,110010106002027,5,501,501,5,psa_35,5D1
1000000US110010002022003,"Block 2003, Block Group 2, Census Tract 2.02, District of Columbia, District of Columbia",78,75,0,0,1,0,0,2,78,78,75,0,0,1,0,0,2,0,0,0,0,0,0,0,0,110010002022003,2,206,206,2,psa_29,2D2
1000000US110010017021027,"Block 1027, Block Group 1, Census Tract 17.02, District of Columbia, District of Columbia",60,38,17,2,2,0,0,1,60,55,34,17,1,2,0,0,1,5,4,0,1,0,0,0,0,110010017021027,4,401,401,4,psa_56,4D1
1000000US110010073042004,"Block 2004, Block Group 2, Census Tract 73.04, District of Columbia, District of Columbia",157,3,153,1,0,0,0,0,157,155,2,152,1,0,0,0,0,2,1,1,0,0,0,0,0,110010073042004,7,705,705,7,psa_3,7D2
1000000US110010076013000,"Block 3000, Block Group 3, Census Tract 76.01, District of Columbia, District of Columbia",98,6,87,0,1,0,0,4,98,95,6,84,0,1,0,0,4,3,0,3,0,0,0,0,0,110010076013000,6,607,607,6,psa_10,6D2
1000000US110010087021000,"Block 1000, Block Group 1, Census Tract 87.02, District of Columbia, District of Columbia",0,0,0,0,0,0,0,0,0,0,0,0,0,0,0,0,0,0,0,0,0,0,0,0,0,110010087021000,5,502,502,5,psa_40,5D1
1000000US110010073011138,"Block 1138, Block Group 1, Census Tract 73.01, District of Columbia, District of Columbia",64,36,15,1,2,1,0,9,64,55,32,15,1,2,1,0,4,9,4,0,0,0,0,0,5,110010073011138,7,707,707,7,psa_4,7D2
1000000US110010095082004,"Block 2004, Block Group 2, Census Tract 95.08, District of Columbia, District of Columbia",80,7,72,1,0,0,0,0,80,75,2,72,1,0,0,0,0,5,5,0,0,0,0,0,0,110010095082004,4,406,406,4,psa_54,4D2
1000000US110010027011002,"Block 1002, Block Group 1, Census Tract 27.01, District of Columbia, District of Columbia",223,178,17,0,14,0,2,12,223,204,163,17,0,14,0,0,10,19,15,0,0,0,0,2,2,110010027011002,3,302,302,3,psa_42,3D1
1000000US110010075031001,"Block 1001, Block Group 1, Census Tract 75.03, District of Columbia, District of Columbia",30,1,28,0,0,0,0,1,30,30,1,28,0,0,0,0,1,0,0,0,0,0,0,0,0,110010075031001,7,701,701,7,psa_9,7D1
1000000US110010080012007,"Block 2007, Block Group 2, Census Tract 80.01, District of Columbia, District of Columbia",67,18,45,2,1,0,0,1,67,65,18,45,0,1,0,0,1,2,0,0,2,0,0,0,0,110010080012007,1,108,108,1,psa_17,1D2
1000000US110010030002000,"Block 2000, Block Group 2, Census Tract 30, District of Columbia, District of Columbia",134,86,42,0,4,0,2,0,134,126,79,42,0,4,0,1,0,8,7,0,0,0,0,1,0,110010030002000,3,302,302,3,psa_42,3D1
1000000US110010081002000,"Block 2000, Block Group 2, Census Tract 81, District of Columbia, District of Columbia",140,100,32,1,0,0,2,5,140,135,98,32,1,0,0,0,4,5,2,0,0,0,0,2,1,110010081002000,1,108,108,1,psa_17,1D2
1000000US110010095031006,"Block 1006, Block Group 1, Census Tract 95.03, District of Columbia, District of Columbia",0,0,0,0,0,0,0,0,0,0,0,0,0,0,0,0,0,0,0,0,0,0,0,0,0,110010095031006,4,405,405,4,psa_49,4D2
1000000US110010011001013,"Block 1013, Block Group 1, Census Tract 11, District of Columbia, District of Columbia",419,307,47,1,41,0,8,15,419,364,266,47,0,40,0,1,10,55,41,0,1,1,0,7,5,110010011001013,2,201,201,2,psa_55,2D1
1000000US110010055001002,"Block 1002, Block Group 1, Census Tract 55, District of Columbia, District of Columbia",56,51,2,0,2,0,0,1,56,52,47,2,0,2,0,0,1,4,4,0,0,0,0,0,0,110010055001002,2,208,208,2,psa_33,2D3
1000000US110010073011038,"Block 1038, Block Group 1, Census Tract 73.01, District of Columbia, District of Columbia",0,0,0,0,0,0,0,0,0,0,0,0,0,0,0,0,0,0,0,0,0,0,0,0,0,110010073011038,7,703,703,7,psa_8,7D1
1000000US110010014012013,"Block 2013, Block Group 2, Census Tract 14.01, District of Columbia, District of Columbia",150,134,1,0,9,0,0,6,150,148,132,1,0,9,0,0,6,2,2,0,0,0,0,0,0,110010014012013,2,201,201,2,psa_55,2D1
1000000US110010017021010,"Block 1010, Block Group 1, Census Tract 17.02, District of Columbia, District of Columbia",0,0,0,0,0,0,0,0,0,0,0,0,0,0,0,0,0,0,0,0,0,0,0,0,0,110010017021010,4,401,401,4,psa_56,4D1
1000000US110010046002004,"Block 2004, Block Group 2, Census Tract 46, District of Columbia, District of Columbia",0,0,0,0,0,0,0,0,0,0,0,0,0,0,0,0,0,0,0,0,0,0,0,0,0,110010046002004,3,306,306,3,psa_38,3D2
1000000US110010099032008,"Block 2008, Block Group 2, Census Tract 99.03, District of Columbia, District of Columbia",52,0,51,1,0,0,0,0,52,52,0,51,1,0,0,0,0,0,0,0,0,0,0,0,0,110010099032008,6,604,604,6,psa_14,6D3
1000000US110010049011005,"Block 1005, Block Group 1, Census Tract 49.01, District of Columbia, District of Columbia",156,4,144,0,0,0,4,4,156,151,3,144,0,0,0,0,4,5,1,0,0,0,0,4,0,110010049011005,3,307,307,3,psa_28,3D3
1000000US110010077033001,"Block 3001, Block Group 3, Census Tract 77.03, District of Columbia, District of Columbia",832,2,813,2,0,0,2,13,832,826,2,810,2,0,0,0,12,6,0,3,0,0,0,2,1,110010077033001,6,603,603,6,psa_15,6D3
1000000US110010058001034,"Block 1034, Block Group 1, Census Tract 58, District of Columbia, District of Columbia",0,0,0,0,0,0,0,0,0,0,0,0,0,0,0,0,0,0,0,0,0,0,0,0,0,110010058001034,2,209,209,2,psa_57,2D3
1000000US110010033013000,"Block 3000, Block Group 3, Census Tract 33.01, District of Columbia, District of Columbia",233,56,154,0,5,0,6,12,233,222,52,153,0,5,0,0,12,11,4,1,0,0,0,6,0,110010033013000,3,306,306,3,psa_38,3D2
1000000US110010013013006,"Block 3006, Block Group 3, Census Tract 13.01, District of Columbia, District of Columbia",7,7,0,0,0,0,0,0,7,7,7,0,0,0,0,0,0,0,0,0,0,0,0,0,0,110010013013006,2,203,203,2,psa_50,2D1
1000000US110010015005006,"Block 5006, Block Group 5, Census Tract 15, District of Columbia, District of Columbia",92,84,1,0,3,0,0,4,92,83,75,1,0,3,0,0,4,9,9,0,0,0,0,0,0,110010015005006,2,201,201,2,psa_55,2D1
1000000US110010020023004,"Block 3004, Block Group 3, Census Tract 20.02, District of Columbia, District of Columbia",113,39,57,0,1,0,7,9,113,86,25,54,0,1,0,0,6,27,14,3,0,0,0,7,3,110010020023004,4,403,403,4,psa_51,4D1
1000000US110010077092013,"Block 2013, Block Group 2, Census Tract 77.09, District of Columbia, District of Columbia",97,3,92,0,0,0,2,0,97,94,2,92,0,0,0,0,0,3,1,0,0,0,0,2,0,110010077092013,6,605,605,6,psa_11,6D2
1000000US110010077092011,"Block 2011, Block Group 2, Census Tract 77.09, District of Columbia, District of Columbia",52,4,46,0,0,0,2,0,52,50,4,46,0,0,0,0,0,2,0,0,0,0,0,2,0,110010077092011,6,605,605,6,psa_11,6D2
1000000US110010001004008,"Block 4008, Block Group 4, Census Tract 1, District of Columbia, District of Columbia",50,47,0,0,0,0,3,0,50,45,43,0,0,0,0,2,0,5,4,0,0,0,0,1,0,110010001004008,2,206,206,2,psa_29,2D2
1000000US110010008021003,"Block 1003, Block Group 1, Census Tract 8.02, District of Columbia, District of Columbia",168,119,16,0,25,1,2,5,168,151,107,16,0,25,1,0,2,17,12,0,0,0,0,2,3,110010008021003,2,205,205,2,psa_46,2D2
1000000US110010099011001,"Block 1001, Block Group 1, Census Tract 99.01, District of Columbia, District of Columbia",91,2,89,0,0,0,0,0,91,91,2,89,0,0,0,0,0,0,0,0,0,0,0,0,0,110010099011001,6,605,605,6,psa_11,6D2
1000000US110010104002004,"Block 2004, Block Group 2, Census Tract 104, District of Columbia, District of Columbia",0,0,0,0,0,0,0,0,0,0,0,0,0,0,0,0,0,0,0,0,0,0,0,0,0,110010104002004,7,703,703,7,psa_8,7D1
1000000US110010040012001,"Block 2001, Block Group 2, Census Tract 40.01, District of Columbia, District of Columbia",233,213,7,0,7,0,2,4,233,224,207,7,0,7,0,1,2,9,6,0,0,0,0,1,2,110010040012001,3,303,303,3,psa_37,3D3
1000000US110010007014005,"Block 4005, Block Group 4, Census Tract 7.01, District of Columbia, District of Columbia",57,56,1,0,0,0,0,0,57,54,53,1,0,0,0,0,0,3,3,0,0,0,0,0,0,110010007014005,2,204,204,2,psa_44,2D2
1000000US110010111002025,"Block 2025, Block Group 2, Census Tract 111, District of Columbia, District of Columbia",79,7,64,3,1,0,0,4,79,77,5,64,3,1,0,0,4,2,2,0,0,0,0,0,0,110010111002025,5,503,503,5,psa_45,5D2
1000000US110010015004012,"Block 4012, Block Group 4, Census Tract 15, District of Columbia, District of Columbia",127,114,7,0,5,0,1,0,127,118,106,7,0,5,0,0,0,9,8,0,0,0,0,1,0,110010015004012,2,201,201,2,psa_55,2D1
1000000US110010095031007,"Block 1007, Block Group 1, Census Tract 95.03, District of Columbia, District of Columbia",94,15,76,0,1,0,2,0,94,94,15,76,0,1,0,2,0,0,0,0,0,0,0,0,0,110010095031007,4,405,405,4,psa_49,4D2
1000000US110010025011008,"Block 1008, Block Group 1, Census Tract 25.01, District of Columbia, District of Columbia",0,0,0,0,0,0,0,0,0,0,0,0,0,0,0,0,0,0,0,0,0,0,0,0,0,110010025011008,4,404,404,4,psa_48,4D3
1000000US110010089031008,"Block 1008, Block Group 1, Census Tract 89.03, District of Columbia, District of Columbia",55,0,55,0,0,0,0,0,55,55,0,55,0,0,0,0,0,0,0,0,0,0,0,0,0,110010089031008,5,507,507,5,psa_23,5D3
1000000US110010009012003,"Block 2003, Block Group 2, Census Tract 9.01, District of Columbia, District of Columbia",0,0,0,0,0,0,0,0,0,0,0,0,0,0,0,0,0,0,0,0,0,0,0,0,0,110010009012003,2,205,205,2,psa_46,2D2
1000000US110010064002006,"Block 2006, Block Group 2, Census Tract 64, District of Columbia, District of Columbia",0,0,0,0,0,0,0,0,0,0,0,0,0,0,0,0,0,0,0,0,0,0,0,0,0,110010064002006,1,105,105,1,psa_22,1D3
1000000US110010062021013,"Block 1013, Block Group 1, Census Tract 62.02, District of Columbia, District of Columbia",0,0,0,0,0,0,0,0,0,0,0,0,0,0,0,0,0,0,0,0,0,0,0,0,0,110010062021013,1,102,102,1,psa_18,1D1
1000000US110010096041007,"Block 1007, Block Group 1, Census Tract 96.04, District of Columbia, District of Columbia",0,0,0,0,0,0,0,0,0,0,0,0,0,0,0,0,0,0,0,0,0,0,0,0,0,110010096041007,5,507,507,5,psa_23,5D3
1000000US110010072002056,"Block 2056, Block Group 2, Census Tract 72, District of Columbia, District of Columbia",0,0,0,0,0,0,0,0,0,0,0,0,0,0,0,0,0,0,0,0,0,0,0,0,0,110010072002056,1,106,106,1,psa_13,1D3
1000000US110010099041001,"Block 1001, Block Group 1, Census Tract 99.04, District of Columbia, District of Columbia",61,2,26,0,0,0,33,0,61,28,2,26,0,0,0,0,0,33,0,0,0,0,0,33,0,110010099041001,6,604,604,6,psa_14,6D3
1000000US110010013022009,"Block 2009, Block Group 2, Census Tract 13.02, District of Columbia, District of Columbia",270,240,7,1,17,0,2,3,270,258,228,7,1,17,0,2,3,12,12,0,0,0,0,0,0,110010013022009,2,204,204,2,psa_44,2D2
1000000US110010022012007,"Block 2007, Block Group 2, Census Tract 22.01, District of Columbia, District of Columbia",122,14,89,0,1,0,14,4,122,98,4,89,0,1,0,0,4,24,10,0,0,0,0,14,0,110010022012007,4,407,407,4,psa_47,4D2
1000000US110010077072009,"Block 2009, Block Group 2, Census Tract 77.07, District of Columbia, District of Columbia",9,0,9,0,0,0,0,0,9,9,0,9,0,0,0,0,0,0,0,0,0,0,0,0,0,110010077072009,6,604,604,6,psa_14,6D3
1000000US110010009011016,"Block 1016, Block Group 1, Census Tract 9.01, District of Columbia, District of Columbia",202,181,7,0,7,0,0,7,202,198,177,7,0,7,0,0,7,4,4,0,0,0,0,0,0,110010009011016,2,205,205,2,psa_46,2D2
1000000US110010055004002,"Block 4002, Block Group 4, Census Tract 55, District of Columbia, District of Columbia",214,193,3,0,8,0,3,7,214,201,185,3,0,8,0,0,5,13,8,0,0,0,0,3,2,110010055004002,2,208,208,2,psa_33,2D3
1000000US110010023011016,"Block 1016, Block Group 1, Census Tract 23.01, District of Columbia, District of Columbia",0,0,0,0,0,0,0,0,0,0,0,0,0,0,0,0,0,0,0,0,0,0,0,0,0,110010023011016,4,407,407,4,psa_47,4D2
1000000US110010034001001,"Block 1001, Block Group 1, Census Tract 34, District of Columbia, District of Columbia",283,23,240,0,7,1,1,11,283,270,16,235,0,7,1,0,11,13,7,5,0,0,0,1,0,110010034001001,3,306,306,3,psa_38,3D2
1000000US110010076032002,"Block 2002, Block Group 2, Census Tract 76.03, District of Columbia, District of Columbia",91,12,73,0,0,0,0,6,91,91,12,73,0,0,0,0,6,0,0,0,0,0,0,0,0,110010076032002,6,606,606,6,psa_7,6D2
1000000US110010001003000,"Block 3000, Block Group 3, Census Tract 1, District of Columbia, District of Columbia",46,37,1,0,8,0,0,0,46,44,35,1,0,8,0,0,0,2,2,0,0,0,0,0,0,110010001003000,2,206,206,2,psa_29,2D2
1000000US110010026001020,"Block 1020, Block Group 1, Census Tract 26, District of Columbia, District of Columbia",0,0,0,0,0,0,0,0,0,0,0,0,0,0,0,0,0,0,0,0,0,0,0,0,0,110010026001020,2,203,203,2,psa_50,2D1
1000000US110010078043010,"Block 3010, Block Group 3, Census Tract 78.04, District of Columbia, District of Columbia",3,0,3,0,0,0,0,0,3,3,0,3,0,0,0,0,0,0,0,0,0,0,0,0,0,110010078043010,6,608,608,6,psa_19,6D1
1000000US110010041003024,"Block 3024, Block Group 3, Census Tract 41, District of Columbia, District of Columbia",4,4,0,0,0,0,0,0,4,2,2,0,0,0,0,0,0,2,2,0,0,0,0,0,0,110010041003024,2,208,208,2,psa_33,2D3
1000000US110010074011010,"Block 1010, Block Group 1, Census Tract 74.01, District of Columbia, District of Columbia",0,0,0,0,0,0,0,0,0,0,0,0,0,0,0,0,0,0,0,0,0,0,0,0,0,110010074011010,7,701,701,7,psa_9,7D1
1000000US110010041003000,"Block 3000, Block Group 3, Census Tract 41, District of Columbia, District of Columbia",34,28,1,0,0,0,4,1,34,32,26,1,0,0,0,4,1,2,2,0,0,0,0,0,0,110010041003000,2,208,208,2,psa_33,2D3
1000000US110010096033003,"Block 3003, Block Group 3, Census Tract 96.03, District of Columbia, District of Columbia",90,3,80,1,0,0,0,6,90,86,3,80,1,0,0,0,2,4,0,0,0,0,0,0,4,110010096033003,6,603,603,6,psa_15,6D3
1000000US110010008012014,"Block 2014, Block Group 2, Census Tract 8.01, District of Columbia, District of Columbia",36,25,0,0,6,0,0,5,36,33,23,0,0,6,0,0,4,3,2,0,0,0,0,0,1,110010008012014,2,205,205,2,psa_46,2D2
1000000US110010075041007,"Block 1007, Block Group 1, Census Tract 75.04, District of Columbia, District of Columbia",102,3,97,0,0,0,0,2,102,101,3,97,0,0,0,0,1,1,0,0,0,0,0,0,1,110010075041007,7,701,701,7,psa_9,7D1
1000000US110010064002020,"Block 2020, Block Group 2, Census Tract 64, District of Columbia, District of Columbia",0,0,0,0,0,0,0,0,0,0,0,0,0,0,0,0,0,0,0,0,0,0,0,0,0,110010064002020,1,105,105,1,psa_22,1D3
1000000US110010075032005,"Block 2005, Block Group 2, Census Tract 75.03, District of Columbia, District of Columbia",287,2,274,0,0,0,0,11,287,277,1,267,0,0,0,0,9,10,1,7,0,0,0,0,2,110010075032005,7,701,701,7,psa_9,7D1
1000000US110010092011011,"Block 1011, Block Group 1, Census Tract 92.01, District of Columbia, District of Columbia",37,3,32,0,1,0,1,0,37,36,3,32,0,1,0,0,0,1,0,0,0,0,0,1,0,110010092011011,5,502,502,5,psa_40,5D1
1000000US110010073011025,"Block 1025, Block Group 1, Census Tract 73.01, District of Columbia, District of Columbia",0,0,0,0,0,0,0,0,0,0,0,0,0,0,0,0,0,0,0,0,0,0,0,0,0,110010073011025,7,703,703,7,psa_8,7D1
1000000US110010093021014,"Block 1014, Block Group 1, Census Tract 93.02, District of Columbia, District of Columbia",165,25,127,0,0,0,3,10,165,152,20,122,0,0,0,0,10,13,5,5,0,0,0,3,0,110010093021014,5,504,504,5,psa_43,5D2
1000000US110010017022008,"Block 2008, Block Group 2, Census Tract 17.02, District of Columbia, District of Columbia",19,12,1,0,1,0,2,3,19,17,12,1,0,1,0,0,3,2,0,0,0,0,0,2,0,110010017022008,4,401,401,4,psa_56,4D1
1000000US110010072001011,"Block 1011, Block Group 1, Census Tract 72, District of Columbia, District of Columbia",402,306,51,0,32,0,6,7,402,389,298,51,0,32,0,1,7,13,8,0,0,0,0,5,0,110010072001011,1,106,106,1,psa_13,1D3
1000000US110010040023001,"Block 3001, Block Group 3, Census Tract 40.02, District of Columbia, District of Columbia",573,446,34,1,59,0,22,11,573,522,418,34,0,59,0,1,10,51,28,0,1,0,0,21,1,110010040023001,3,303,303,3,psa_37,3D3
1000000US110010011002017,"Block 2017, Block Group 2, Census Tract 11, District of Columbia, District of Columbia",70,58,3,0,5,0,0,4,70,70,58,3,0,5,0,0,4,0,0,0,0,0,0,0,0,110010011002017,2,202,202,2,psa_52,2D1
1000000US110010007014002,"Block 4002, Block Group 4, Census Tract 7.01, District of Columbia, District of Columbia",67,59,1,0,2,0,0,5,67,66,58,1,0,2,0,0,5,1,1,0,0,0,0,0,0,110010007014002,2,204,204,2,psa_44,2D2
1000000US110010050024003,"Block 4003, Block Group 4, Census Tract 50.02, District of Columbia, District of Columbia",149,70,66,0,8,0,2,3,149,145,67,66,0,8,0,1,3,4,3,0,0,0,0,1,0,110010050024003,3,307,307,3,psa_28,3D3
1000000US110010102002003,"Block 2003, Block Group 2, Census Tract 102, District of Columbia, District of Columbia",0,0,0,0,0,0,0,0,0,0,0,0,0,0,0,0,0,0,0,0,0,0,0,0,0,110010102002003,1,103,103,1,psa_12,1D1
1000000US110010111003022,"Block 3022, Block Group 3, Census Tract 111, District of Columbia, District of Columbia",0,0,0,0,0,0,0,0,0,0,0,0,0,0,0,0,0,0,0,0,0,0,0,0,0,110010111003022,5,505,505,5,psa_34,5D2
1000000US110010066001022,"Block 1022, Block Group 1, Census Tract 66, District of Columbia, District of Columbia",0,0,0,0,0,0,0,0,0,0,0,0,0,0,0,0,0,0,0,0,0,0,0,0,0,110010066001022,1,107,107,1,psa_16,1D2
1000000US110010023021015,"Block 1015, Block Group 1, Census Tract 23.02, District of Columbia, District of Columbia",0,0,0,0,0,0,0,0,0,0,0,0,0,0,0,0,0,0,0,0,0,0,0,0,0,110010023021015,4,405,405,4,psa_49,4D2
1000000US110010049022006,"Block 2006, Block Group 2, Census Tract 49.02, District of Columbia, District of Columbia",26,20,1,0,2,0,0,3,26,26,20,1,0,2,0,0,3,0,0,0,0,0,0,0,0,110010049022006,3,307,307,3,psa_28,3D3
1000000US110010006004003,"Block 4003, Block Group 4, Census Tract 6, District of Columbia, District of Columbia",118,99,6,0,6,0,7,0,118,100,88,6,0,6,0,0,0,18,11,0,0,0,0,7,0,110010006004003,2,203,203,2,psa_50,2D1
1000000US110010078033006,"Block 3006, Block Group 3, Census Tract 78.03, District of Columbia, District of Columbia",0,0,0,0,0,0,0,0,0,0,0,0,0,0,0,0,0,0,0,0,0,0,0,0,0,110010078033006,6,608,608,6,psa_19,6D1
1000000US110010078033011,"Block 3011, Block Group 3, Census Tract 78.03, District of Columbia, District of Columbia",33,0,32,0,0,0,1,0,33,33,0,32,0,0,0,1,0,0,0,0,0,0,0,0,0,110010078033011,6,608,608,6,psa_19,6D1
1000000US110010024001005,"Block 1005, Block Group 1, Census Tract 24, District of Columbia, District of Columbia",83,20,51,0,0,0,12,0,83,56,5,51,0,0,0,0,0,27,15,0,0,0,0,12,0,110010024001005,4,407,407,4,psa_47,4D2
1000000US110010096011043,"Block 1043, Block Group 1, Census Tract 96.01, District of Columbia, District of Columbia",0,0,0,0,0,0,0,0,0,0,0,0,0,0,0,0,0,0,0,0,0,0,0,0,0,110010096011043,6,602,602,6,psa_25,6D1
1000000US110010021021004,"Block 1004, Block Group 1, Census Tract 21.02, District of Columbia, District of Columbia",61,0,45,0,0,0,16,0,61,46,0,45,0,0,0,1,0,15,0,0,0,0,0,15,0,110010021021004,4,406,406,4,psa_54,4D2
1000000US110010074011027,"Block 1027, Block Group 1, Census Tract 74.01, District of Columbia, District of Columbia",0,0,0,0,0,0,0,0,0,0,0,0,0,0,0,0,0,0,0,0,0,0,0,0,0,110010074011027,7,703,703,7,psa_8,7D1
1000000US110010010015000,"Block 5000, Block Group 5, Census Tract 10.01, District of Columbia, District of Columbia",0,0,0,0,0,0,0,0,0,0,0,0,0,0,0,0,0,0,0,0,0,0,0,0,0,110010010015000,2,202,202,2,psa_52,2D1
1000000US110010020021014,"Block 1014, Block Group 1, Census Tract 20.02, District of Columbia, District of Columbia",0,0,0,0,0,0,0,0,0,0,0,0,0,0,0,0,0,0,0,0,0,0,0,0,0,110010020021014,4,404,404,4,psa_48,4D3
1000000US110010095042017,"Block 2017, Block Group 2, Census Tract 95.04, District of Columbia, District of Columbia",55,10,45,0,0,0,0,0,55,54,9,45,0,0,0,0,0,1,1,0,0,0,0,0,0,110010095042017,4,405,405,4,psa_49,4D2
1000000US110010019011011,"Block 1011, Block Group 1, Census Tract 19.01, District of Columbia, District of Columbia",96,2,58,1,2,0,33,0,96,63,2,58,1,2,0,0,0,33,0,0,0,0,0,33,0,110010019011011,4,402,402,4,psa_53,4D1
1000000US110010087021003,"Block 1003, Block Group 1, Census Tract 87.02, District of Columbia, District of Columbia",176,13,149,0,7,0,1,6,176,163,8,149,0,6,0,0,0,13,5,0,0,1,0,1,6,110010087021003,5,502,502,5,psa_40,5D1
1000000US110010093013018,"Block 3018, Block Group 3, Census Tract 93.01, District of Columbia, District of Columbia",89,14,56,2,6,0,7,4,89,76,8,56,2,6,0,0,4,13,6,0,0,0,0,7,0,110010093013018,5,504,504,5,psa_43,5D2
1000000US110010095032004,"Block 2004, Block Group 2, Census Tract 95.03, District of Columbia, District of Columbia",0,0,0,0,0,0,0,0,0,0,0,0,0,0,0,0,0,0,0,0,0,0,0,0,0,110010095032004,4,405,405,4,psa_49,4D2
1000000US110010106002012,"Block 2012, Block Group 2, Census Tract 106, District of Columbia, District of Columbia",142,30,106,0,6,0,0,0,142,138,27,105,0,6,0,0,0,4,3,1,0,0,0,0,0,110010106002012,5,501,501,5,psa_35,5D1
1000000US110010002023007,"Block 3007, Block Group 3, Census Tract 2.02, District of Columbia, District of Columbia",103,88,4,0,7,0,2,2,103,92,78,4,0,7,0,1,2,11,10,0,0,0,0,1,0,110010002023007,2,206,206,2,psa_29,2D2
1000000US110010038002005,"Block 2005, Block Group 2, Census Tract 38, District of Columbia, District of Columbia",0,0,0,0,0,0,0,0,0,0,0,0,0,0,0,0,0,0,0,0,0,0,0,0,0,110010038002005,3,303,303,3,psa_37,3D3
1000000US110010102002002,"Block 2002, Block Group 2, Census Tract 102, District of Columbia, District of Columbia",0,0,0,0,0,0,0,0,0,0,0,0,0,0,0,0,0,0,0,0,0,0,0,0,0,110010102002002,1,103,103,1,psa_12,1D1
1000000US110010105002023,"Block 2023, Block Group 2, Census Tract 105, District of Columbia, District of Columbia",0,0,0,0,0,0,0,0,0,0,0,0,0,0,0,0,0,0,0,0,0,0,0,0,0,110010105002023,1,103,103,1,psa_12,1D1
1000000US110010048011009,"Block 1009, Block Group 1, Census Tract 48.01, District of Columbia, District of Columbia",58,39,13,0,0,0,2,4,58,53,38,13,0,0,0,0,2,5,1,0,0,0,0,2,2,110010048011009,3,308,308,3,psa_27,3D2
1000000US110010105002019,"Block 2019, Block Group 2, Census Tract 105, District of Columbia, District of Columbia",0,0,0,0,0,0,0,0,0,0,0,0,0,0,0,0,0,0,0,0,0,0,0,0,0,110010105002019,1,103,103,1,psa_12,1D1
1000000US110010077082004,"Block 2004, Block Group 2, Census Tract 77.08, District of Columbia, District of Columbia",0,0,0,0,0,0,0,0,0,0,0,0,0,0,0,0,0,0,0,0,0,0,0,0,0,110010077082004,6,603,603,6,psa_15,6D3
1000000US110010017021016,"Block 1016, Block Group 1, Census Tract 17.02, District of Columbia, District of Columbia",97,34,51,0,7,0,0,5,97,84,29,43,0,7,0,0,5,13,5,8,0,0,0,0,0,110010017021016,4,401,401,4,psa_56,4D1
1000000US110010062021109,"Block 1109, Block Group 1, Census Tract 62.02, District of Columbia, District of Columbia",0,0,0,0,0,0,0,0,0,0,0,0,0,0,0,0,0,0,0,0,0,0,0,0,0,110010062021109,1,102,102,1,psa_18,1D1
1000000US110010042011002,"Block 1002, Block Group 1, Census Tract 42.01, District of Columbia, District of Columbia",298,260,9,1,22,0,2,4,298,264,232,8,0,22,0,0,2,34,28,1,1,0,0,2,2,110010042011002,3,301,301,3,psa_31,3D3
1000000US110010055002011,"Block 2011, Block Group 2, Census Tract 55, District of Columbia, District of Columbia",693,563,17,0,78,0,12,23,693,632,512,16,0,78,0,5,21,61,51,1,0,0,0,7,2,110010055002011,2,207,207,2,psa_24,2D3
1000000US110010050012001,"Block 2001, Block Group 2, Census Tract 50.01, District of Columbia, District of Columbia",126,84,24,0,9,0,3,6,126,115,76,24,0,9,0,0,6,11,8,0,0,0,0,3,0,110010050012001,3,307,307,3,psa_28,3D3
1000000US110010002022002,"Block 2002, Block Group 2, Census Tract 2.02, District of Columbia, District of Columbia",69,59,1,0,4,0,0,5,69,64,57,1,0,4,0,0,2,5,2,0,0,0,0,0,3,110010002022002,2,206,206,2,psa_29,2D2
1000000US110010052012001,"Block 2001, Block Group 2, Census Tract 52.01, District of Columbia, District of Columbia",153,135,8,0,5,0,3,2,153,143,127,8,0,5,0,1,2,10,8,0,0,0,0,2,0,110010052012001,3,301,301,3,psa_31,3D3
1000000US110010009012024,"Block 2024, Block Group 2, Census Tract 9.01, District of Columbia, District of Columbia",134,129,4,0,0,0,0,1,134,134,129,4,0,0,0,0,1,0,0,0,0,0,0,0,0,110010009012024,2,205,205,2,psa_46,2D2
1000000US110010009022030,"Block 2030, Block Group 2, Census Tract 9.02, District of Columbia, District of Columbia",84,79,0,0,0,0,0,5,84,83,78,0,0,0,0,0,5,1,1,0,0,0,0,0,0,110010009022030,2,205,205,2,psa_46,2D2
1000000US110010066001000,"Block 1000, Block Group 1, Census Tract 66, District of Columbia, District of Columbia",134,115,4,0,4,0,6,5,134,122,107,4,0,4,0,2,5,12,8,0,0,0,0,4,0,110010066001000,1,107,107,1,psa_16,1D2
1000000US110010015005005,"Block 5005, Block Group 5, Census Tract 15, District of Columbia, District of Columbia",53,42,10,0,0,0,0,1,53,50,39,10,0,0,0,0,1,3,3,0,0,0,0,0,0,110010015005005,2,201,201,2,psa_55,2D1
1000000US110010034002026,"Block 2026, Block Group 2, Census Tract 34, District of Columbia, District of Columbia",142,43,77,0,14,0,0,8,142,137,43,73,0,14,0,0,7,5,0,4,0,0,0,0,1,110010034002026,3,308,308,3,psa_27,3D2
1000000US110010080013000,"Block 3000, Block Group 3, Census Tract 80.01, District of Columbia, District of Columbia",90,24,63,1,0,0,0,2,90,90,24,63,1,0,0,0,2,0,0,0,0,0,0,0,0,110010080013000,1,108,108,1,psa_17,1D2
1000000US110010096041011,"Block 1011, Block Group 1, Census Tract 96.04, District of Columbia, District of Columbia",111,1,106,0,0,0,0,4,111,111,1,106,0,0,0,0,4,0,0,0,0,0,0,0,0,110010096041011,6,603,603,6,psa_15,6D3
1000000US110010001004049,"Block 4049, Block Group 4, Census Tract 1, District of Columbia, District of Columbia",0,0,0,0,0,0,0,0,0,0,0,0,0,0,0,0,0,0,0,0,0,0,0,0,0,110010001004049,2,207,207,2,psa_24,2D3
1000000US110010008012004,"Block 2004, Block Group 2, Census Tract 8.01, District of Columbia, District of Columbia",0,0,0,0,0,0,0,0,0,0,0,0,0,0,0,0,0,0,0,0,0,0,0,0,0,110010008012004,2,205,205,2,psa_46,2D2
1000000US110010095033000,"Block 3000, Block Group 3, Census Tract 95.03, District of Columbia, District of Columbia",86,21,60,0,0,0,0,5,86,85,20,60,0,0,0,0,5,1,1,0,0,0,0,0,0,110010095033000,4,405,405,4,psa_49,4D2
1000000US110010011004011,"Block 4011, Block Group 4, Census Tract 11, District of Columbia, District of Columbia",0,0,0,0,0,0,0,0,0,0,0,0,0,0,0,0,0,0,0,0,0,0,0,0,0,110010011004011,2,201,201,2,psa_55,2D1
1000000US110010062021154,"Block 1154, Block Group 1, Census Tract 62.02, District of Columbia, District of Columbia",0,0,0,0,0,0,0,0,0,0,0,0,0,0,0,0,0,0,0,0,0,0,0,0,0,110010062021154,1,103,103,1,psa_12,1D1
1000000US110010077072012,"Block 2012, Block Group 2, Census Tract 77.07, District of Columbia, District of Columbia",62,2,60,0,0,0,0,0,62,62,2,60,0,0,0,0,0,0,0,0,0,0,0,0,0,110010077072012,6,605,605,6,psa_11,6D2
1000000US110010011004004,"Block 4004, Block Group 4, Census Tract 11, District of Columbia, District of Columbia",59,55,0,0,2,0,0,2,59,59,55,0,0,2,0,0,2,0,0,0,0,0,0,0,0,110010011004004,2,202,202,2,psa_52,2D1
1000000US110010062021163,"Block 1163, Block Group 1, Census Tract 62.02, District of Columbia, District of Columbia",0,0,0,0,0,0,0,0,0,0,0,0,0,0,0,0,0,0,0,0,0,0,0,0,0,110010062021163,2,207,207,2,psa_24,2D3
1000000US110010005011006,"Block 1006, Block Group 1, Census Tract 5.01, District of Columbia, District of Columbia",422,358,20,0,29,0,0,15,422,395,332,20,0,28,0,0,15,27,26,0,0,1,0,0,0,110010005011006,2,204,204,2,psa_44,2D2
1000000US110010021021007,"Block 1007, Block Group 1, Census Tract 21.02, District of Columbia, District of Columbia",115,6,100,2,0,0,7,0,115,105,5,99,0,0,0,1,0,10,1,1,2,0,0,6,0,110010021021007,4,406,406,4,psa_54,4D2
1000000US110010111001009,"Block 1009, Block Group 1, Census Tract 111, District of Columbia, District of Columbia",7,0,7,0,0,0,0,0,7,7,0,7,0,0,0,0,0,0,0,0,0,0,0,0,0,110010111001009,5,503,503,5,psa_45,5D2
1000000US110010012002007,"Block 2007, Block Group 2, Census Tract 12, District of Columbia, District of Columbia",53,48,5,0,0,0,0,0,53,50,45,5,0,0,0,0,0,3,3,0,0,0,0,0,0,110010012002007,2,203,203,2,psa_50,2D1
1000000US110010021021010,"Block 1010, Block Group 1, Census Tract 21.02, District of Columbia, District of Columbia",0,0,0,0,0,0,0,0,0,0,0,0,0,0,0,0,0,0,0,0,0,0,0,0,0,110010021021010,4,402,402,4,psa_53,4D1
1000000US110010058001044,"Block 1044, Block Group 1, Census Tract 58, District of Columbia, District of Columbia",1,1,0,0,0,0,0,0,1,1,1,0,0,0,0,0,0,0,0,0,0,0,0,0,0,110010058001044,2,209,209,2,psa_57,2D3
1000000US110010094003021,"Block 3021, Block Group 3, Census Tract 94, District of Columbia, District of Columbia",45,9,31,0,0,0,5,0,45,44,9,31,0,0,0,4,0,1,0,0,0,0,0,1,0,110010094003021,5,503,503,5,psa_45,5D2
1000000US110010087012007,"Block 2007, Block Group 2, Census Tract 87.01, District of Columbia, District of Columbia",107,5,100,0,0,0,0,2,107,103,5,96,0,0,0,0,2,4,0,4,0,0,0,0,0,110010087012007,5,502,502,5,psa_40,5D1
1000000US110010099051005,"Block 1005, Block Group 1, Census Tract 99.05, District of Columbia, District of Columbia",103,0,99,0,2,0,0,2,103,103,0,99,0,2,0,0,2,0,0,0,0,0,0,0,0,110010099051005,6,604,604,6,psa_14,6D3
1000000US110010019011005,"Block 1005, Block Group 1, Census Tract 19.01, District of Columbia, District of Columbia",116,9,95,0,2,0,5,5,116,105,4,95,0,1,0,0,5,11,5,0,0,1,0,5,0,110010019011005,4,402,402,4,psa_53,4D1
1000000US110010011001000,"Block 1000, Block Group 1, Census Tract 11, District of Columbia, District of Columbia",12,12,0,0,0,0,0,0,12,11,11,0,0,0,0,0,0,1,1,0,0,0,0,0,0,110010011001000,2,201,201,2,psa_55,2D1
1000000US110010077032008,"Block 2008, Block Group 2, Census Tract 77.03, District of Columbia, District of Columbia",147,0,146,0,0,0,0,1,147,145,0,144,0,0,0,0,1,2,0,2,0,0,0,0,0,110010077032008,6,603,603,6,psa_15,6D3
1000000US110010079031003,"Block 1003, Block Group 1, Census Tract 79.03, District of Columbia, District of Columbia",191,30,155,1,1,0,3,1,191,171,18,149,1,1,0,1,1,20,12,6,0,0,0,2,0,110010079031003,5,507,507,5,psa_23,5D3
1000000US110010093012019,"Block 2019, Block Group 2, Census Tract 93.01, District of Columbia, District of Columbia",93,20,67,0,2,0,1,3,93,88,17,66,0,2,0,0,3,5,3,1,0,0,0,1,0,110010093012019,5,504,504,5,psa_43,5D2
1000000US110010009021008,"Block 1008, Block Group 1, Census Tract 9.02, District of Columbia, District of Columbia",16,15,1,0,0,0,0,0,16,15,14,1,0,0,0,0,0,1,1,0,0,0,0,0,0,110010009021008,2,205,205,2,psa_46,2D2
1000000US110010032002001,"Block 2001, Block Group 2, Census Tract 32, District of Columbia, District of Columbia",46,9,25,0,0,0,10,2,46,34,8,24,0,0,0,0,2,12,1,1,0,0,0,10,0,110010032002001,4,409,409,4,psa_41,4D3
1000000US110010081002004,"Block 2004, Block Group 2, Census Tract 81, District of Columbia, District of Columbia",217,186,15,0,5,0,4,7,217,200,173,15,0,5,0,0,7,17,13,0,0,0,0,4,0,110010081002004,1,108,108,1,psa_17,1D2
1000000US110010103001016,"Block 1016, Block Group 1, Census Tract 103, District of Columbia, District of Columbia",118,18,78,1,0,0,16,5,118,96,14,78,1,0,0,0,3,22,4,0,0,0,0,16,2,110010103001016,4,401,401,4,psa_56,4D1
1000000US110010016003002,"Block 3002, Block Group 3, Census Tract 16, District of Columbia, District of Columbia",35,10,24,0,0,0,0,1,35,35,10,24,0,0,0,0,1,0,0,0,0,0,0,0,0,110010016003002,4,401,401,4,psa_56,4D1
1000000US110010078083012,"Block 3012, Block Group 3, Census Tract 78.08, District of Columbia, District of Columbia",126,0,122,0,1,0,2,1,126,123,0,121,0,1,0,0,1,3,0,1,0,0,0,2,0,110010078083012,6,608,608,6,psa_19,6D1
1000000US110010079012002,"Block 2002, Block Group 2, Census Tract 79.01, District of Columbia, District of Columbia",113,4,96,1,1,0,6,5,113,107,4,96,1,1,0,0,5,6,0,0,0,0,0,6,0,110010079012002,5,507,507,5,psa_23,5D3
1000000US110010010013007,"Block 3007, Block Group 3, Census Tract 10.01, District of Columbia, District of Columbia",65,56,0,0,4,0,0,5,65,59,50,0,0,4,0,0,5,6,6,0,0,0,0,0,0,110010010013007,2,202,202,2,psa_52,2D1
1000000US110010088042015,"Block 2015, Block Group 2, Census Tract 88.04, District of Columbia, District of Columbia",84,0,84,0,0,0,0,0,84,84,0,84,0,0,0,0,0,0,0,0,0,0,0,0,0,110010088042015,5,506,506,5,psa_26,5D3
1000000US110010027012000,"Block 2000, Block Group 2, Census Tract 27.01, District of Columbia, District of Columbia",87,62,14,0,2,0,5,4,87,73,56,12,0,2,0,0,3,14,6,2,0,0,0,5,1,110010027012000,3,302,302,3,psa_42,3D1
1000000US110010073043001,"Block 3001, Block Group 3, Census Tract 73.04, District of Columbia, District of Columbia",57,0,55,0,2,0,0,0,57,57,0,55,0,2,0,0,0,0,0,0,0,0,0,0,0,110010073043001,7,705,705,7,psa_3,7D2
1000000US110010058001011,"Block 1011, Block Group 1, Census Tract 58, District of Columbia, District of Columbia",0,0,0,0,0,0,0,0,0,0,0,0,0,0,0,0,0,0,0,0,0,0,0,0,0,110010058001011,2,209,209,2,psa_57,2D3
1000000US110010068012003,"Block 2003, Block Group 2, Census Tract 68.01, District of Columbia, District of Columbia",137,51,82,0,1,0,0,3,137,137,51,82,0,1,0,0,3,0,0,0,0,0,0,0,0,110010068012003,1,107,107,1,psa_16,1D2
1000000US110010109002017,"Block 2017, Block Group 2, Census Tract 109, District of Columbia, District of Columbia",0,0,0,0,0,0,0,0,0,0,0,0,0,0,0,0,0,0,0,0,0,0,0,0,0,110010109002017,7,708,708,7,psa_1,7D3
1000000US110010053014000,"Block 4000, Block Group 4, Census Tract 53.01, District of Columbia, District of Columbia",289,238,5,1,34,0,5,6,289,264,220,4,1,34,0,0,5,25,18,1,0,0,0,5,1,110010053014000,3,301,301,3,psa_31,3D3
1000000US110010002024002,"Block 4002, Block Group 4, Census Tract 2.02, District of Columbia, District of Columbia",400,308,25,0,46,0,5,16,400,363,283,21,0,45,0,0,14,37,25,4,0,1,0,5,2,110010002024002,2,206,206,2,psa_29,2D2
1000000US110010080011002,"Block 1002, Block Group 1, Census Tract 80.01, District of Columbia, District of Columbia",132,64,64,1,1,0,1,1,132,129,63,63,1,1,0,0,1,3,1,1,0,0,0,1,0,110010080011002,1,104,104,1,psa_21,1D2
1000000US110010106002024,"Block 2024, Block Group 2, Census Tract 106, District of Columbia, District of Columbia",0,0,0,0,0,0,0,0,0,0,0,0,0,0,0,0,0,0,0,0,0,0,0,0,0,110010106002024,5,501,501,5,psa_35,5D1
1000000US110010011003007,"Block 3007, Block Group 3, Census Tract 11, District of Columbia, District of Columbia",226,190,9,0,18,1,4,4,226,210,179,9,0,18,1,1,2,16,11,0,0,0,0,3,2,110010011003007,2,201,201,2,psa_55,2D1
1000000US110010081003000,"Block 3000, Block Group 3, Census Tract 81, District of Columbia, District of Columbia",118,107,10,0,1,0,0,0,118,116,105,10,0,1,0,0,0,2,2,0,0,0,0,0,0,110010081003000,1,108,108,1,psa_17,1D2
1000000US110010094001006,"Block 1006, Block Group 1, Census Tract 94, District of Columbia, District of Columbia",27,2,25,0,0,0,0,0,27,27,2,25,0,0,0,0,0,0,0,0,0,0,0,0,0,110010094001006,5,503,503,5,psa_45,5D2
1000000US110010104002031,"Block 2031, Block Group 2, Census Tract 104, District of Columbia, District of Columbia",0,0,0,0,0,0,0,0,0,0,0,0,0,0,0,0,0,0,0,0,0,0,0,0,0,110010104002031,7,703,703,7,psa_8,7D1
1000000US110010015004001,"Block 4001, Block Group 4, Census Tract 15, District of Columbia, District of Columbia",57,40,17,0,0,0,0,0,57,54,37,17,0,0,0,0,0,3,3,0,0,0,0,0,0,110010015004001,2,201,201,2,psa_55,2D1
1000000US110010034002024,"Block 2024, Block Group 2, Census Tract 34, District of Columbia, District of Columbia",100,37,56,0,1,1,1,4,100,93,33,54,0,1,1,0,4,7,4,2,0,0,0,1,0,110010034002024,3,306,306,3,psa_38,3D2
1000000US110010099011002,"Block 1002, Block Group 1, Census Tract 99.01, District of Columbia, District of Columbia",44,0,44,0,0,0,0,0,44,40,0,40,0,0,0,0,0,4,0,4,0,0,0,0,0,110010099011002,6,605,605,6,psa_11,6D2
1000000US110010103002013,"Block 2013, Block Group 2, Census Tract 103, District of Columbia, District of Columbia",75,8,58,0,4,0,3,2,75,61,7,48,0,4,0,0,2,14,1,10,0,0,0,3,0,110010103002013,4,401,401,4,psa_56,4D1
1000000US110010008012015,"Block 2015, Block Group 2, Census Tract 8.01, District of Columbia, District of Columbia",121,118,0,0,2,0,1,0,121,119,117,0,0,2,0,0,0,2,1,0,0,0,0,1,0,110010008012015,2,205,205,2,psa_46,2D2
1000000US110010011004006,"Block 4006, Block Group 4, Census Tract 11, District of Columbia, District of Columbia",21,10,6,0,2,0,2,1,21,21,10,6,0,2,0,2,1,0,0,0,0,0,0,0,0,110010011004006,2,202,202,2,psa_52,2D1
1000000US110010101001008,"Block 1008, Block Group 1, Census Tract 101, District of Columbia, District of Columbia",0,0,0,0,0,0,0,0,0,0,0,0,0,0,0,0,0,0,0,0,0,0,0,0,0,110010101001008,2,207,207,2,psa_24,2D3
1000000US110010107002006,"Block 2006, Block Group 2, Census Tract 107, District of Columbia, District of Columbia",192,157,5,0,24,0,0,6,192,184,150,5,0,24,0,0,5,8,7,0,0,0,0,0,1,110010107002006,2,208,208,2,psa_33,2D3
1000000US110010033021002,"Block 1002, Block Group 1, Census Tract 33.02, District of Columbia, District of Columbia",83,34,45,0,3,0,0,1,83,79,34,42,0,3,0,0,0,4,0,3,0,0,0,0,1,110010033021002,3,308,308,3,psa_27,3D2
1000000US110010089042002,"Block 2002, Block Group 2, Census Tract 89.04, District of Columbia, District of Columbia",49,2,47,0,0,0,0,0,49,48,2,46,0,0,0,0,0,1,0,1,0,0,0,0,0,110010089042002,5,507,507,5,psa_23,5D3
1000000US110010008013021,"Block 3021, Block Group 3, Census Tract 8.01, District of Columbia, District of Columbia",4,3,0,0,1,0,0,0,4,4,3,0,0,1,0,0,0,0,0,0,0,0,0,0,0,110010008013021,2,205,205,2,psa_46,2D2
1000000US110010075022006,"Block 2006, Block Group 2, Census Tract 75.02, District of Columbia, District of Columbia",98,0,92,0,0,0,0,6,98,92,0,92,0,0,0,0,0,6,0,0,0,0,0,0,6,110010075022006,7,702,702,7,psa_6,7D1
1000000US110010092011016,"Block 1016, Block Group 1, Census Tract 92.01, District of Columbia, District of Columbia",76,25,41,1,2,0,0,7,76,74,24,41,1,2,0,0,6,2,1,0,0,0,0,0,1,110010092011016,5,502,502,5,psa_40,5D1
1000000US110010009011014,"Block 1014, Block Group 1, Census Tract 9.01, District of Columbia, District of Columbia",49,44,0,1,1,0,1,2,49,46,42,0,1,1,0,0,2,3,2,0,0,0,0,1,0,110010009011014,2,205,205,2,psa_46,2D2
1000000US110010030001005,"Block 1005, Block Group 1, Census Tract 30, District of Columbia, District of Columbia",656,350,199,1,47,3,29,27,656,588,328,188,1,47,0,1,23,68,22,11,0,0,3,28,4,110010030001005,3,302,302,3,psa_42,3D1
1000000US110010096011023,"Block 1023, Block Group 1, Census Tract 96.01, District of Columbia, District of Columbia",0,0,0,0,0,0,0,0,0,0,0,0,0,0,0,0,0,0,0,0,0,0,0,0,0,110010096011023,6,601,601,6,psa_30,6D1
1000000US110010095013012,"Block 3012, Block Group 3, Census Tract 95.01, District of Columbia, District of Columbia",0,0,0,0,0,0,0,0,0,0,0,0,0,0,0,0,0,0,0,0,0,0,0,0,0,110010095013012,4,405,405,4,psa_49,4D2
1000000US110010102002030,"Block 2030, Block Group 2, Census Tract 102, District of Columbia, District of Columbia",0,0,0,0,0,0,0,0,0,0,0,0,0,0,0,0,0,0,0,0,0,0,0,0,0,110010102002030,1,103,103,1,psa_12,1D1
1000000US110010015004003,"Block 4003, Block Group 4, Census Tract 15, District of Columbia, District of Columbia",91,84,3,0,2,0,0,2,91,88,81,3,0,2,0,0,2,3,3,0,0,0,0,0,0,110010015004003,2,201,201,2,psa_55,2D1
1000000US110010078043004,"Block 3004, Block Group 3, Census Tract 78.04, District of Columbia, District of Columbia",46,0,45,0,0,0,0,1,46,45,0,44,0,0,0,0,1,1,0,1,0,0,0,0,0,110010078043004,6,602,602,6,psa_25,6D1
1000000US110010013023011,"Block 3011, Block Group 3, Census Tract 13.02, District of Columbia, District of Columbia",0,0,0,0,0,0,0,0,0,0,0,0,0,0,0,0,0,0,0,0,0,0,0,0,0,110010013023011,2,203,203,2,psa_50,2D1
1000000US110010087011001,"Block 1001, Block Group 1, Census Tract 87.01, District of Columbia, District of Columbia",93,14,76,0,0,0,0,3,93,91,13,76,0,0,0,0,2,2,1,0,0,0,0,0,1,110010087011001,5,502,502,5,psa_40,5D1
1000000US110010093013009,"Block 3009, Block Group 3, Census Tract 93.01, District of Columbia, District of Columbia",49,12,36,0,0,0,0,1,49,44,7,36,0,0,0,0,1,5,5,0,0,0,0,0,0,110010093013009,5,504,504,5,psa_43,5D2
1000000US110010055002008,"Block 2008, Block Group 2, Census Tract 55, District of Columbia, District of Columbia",0,0,0,0,0,0,0,0,0,0,0,0,0,0,0,0,0,0,0,0,0,0,0,0,0,110010055002008,2,206,206,2,psa_29,2D2
1000000US110010067003007,"Block 3007, Block Group 3, Census Tract 67, District of Columbia, District of Columbia",171,131,35,0,1,0,0,4,171,168,128,35,0,1,0,0,4,3,3,0,0,0,0,0,0,110010067003007,1,107,107,1,psa_16,1D2
1000000US110010068021004,"Block 1004, Block Group 1, Census Tract 68.02, District of Columbia, District of Columbia",109,45,51,0,4,0,4,5,109,103,44,51,0,2,0,1,5,6,1,0,0,2,0,3,0,110010068021004,1,107,107,1,psa_16,1D2
1000000US110010008013010,"Block 3010, Block Group 3, Census Tract 8.01, District of Columbia, District of Columbia",75,72,3,0,0,0,0,0,75,72,69,3,0,0,0,0,0,3,3,0,0,0,0,0,0,110010008013010,2,205,205,2,psa_46,2D2
1000000US110010019012002,"Block 2002, Block Group 2, Census Tract 19.01, District of Columbia, District of Columbia",53,5,46,0,0,0,0,2,53,53,5,46,0,0,0,0,2,0,0,0,0,0,0,0,0,110010019012002,4,402,402,4,psa_53,4D1
1000000US110010072002053,"Block 2053, Block Group 2, Census Tract 72, District of Columbia, District of Columbia",0,0,0,0,0,0,0,0,0,0,0,0,0,0,0,0,0,0,0,0,0,0,0,0,0,110010072002053,1,106,106,1,psa_13,1D3
1000000US110010073011029,"Block 1029, Block Group 1, Census Tract 73.01, District of Columbia, District of Columbia",0,0,0,0,0,0,0,0,0,0,0,0,0,0,0,0,0,0,0,0,0,0,0,0,0,110010073011029,7,703,703,7,psa_8,7D1
1000000US110010078062013,"Block 2013, Block Group 2, Census Tract 78.06, District of Columbia, District of Columbia",56,2,54,0,0,0,0,0,56,56,2,54,0,0,0,0,0,0,0,0,0,0,0,0,0,110010078062013,6,602,602,6,psa_25,6D1
1000000US110010082002011,"Block 2011, Block Group 2, Census Tract 82, District of Columbia, District of Columbia",224,193,7,1,7,0,7,9,224,210,188,7,0,7,0,0,8,14,5,0,1,0,0,7,1,110010082002011,1,108,108,1,psa_17,1D2
1000000US110010014021007,"Block 1007, Block Group 1, Census Tract 14.02, District of Columbia, District of Columbia",104,82,13,0,4,0,2,3,104,101,81,13,0,4,0,1,2,3,1,0,0,0,0,1,1,110010014021007,2,201,201,2,psa_55,2D1
1000000US110010021023005,"Block 3005, Block Group 3, Census Tract 21.02, District of Columbia, District of Columbia",148,9,93,0,4,0,40,2,148,100,3,93,0,4,0,0,0,48,6,0,0,0,0,40,2,110010021023005,4,403,403,4,psa_51,4D1
1000000US110010075031019,"Block 1019, Block Group 1, Census Tract 75.03, District of Columbia, District of Columbia",0,0,0,0,0,0,0,0,0,0,0,0,0,0,0,0,0,0,0,0,0,0,0,0,0,110010075031019,7,701,701,7,psa_9,7D1
1000000US110010001003001,"Block 3001, Block Group 3, Census Tract 1, District of Columbia, District of Columbia",144,134,0,0,4,0,0,6,144,140,130,0,0,4,0,0,6,4,4,0,0,0,0,0,0,110010001003001,2,206,206,2,psa_29,2D2
1000000US110010003001009,"Block 1009, Block Group 1, Census Tract 3, District of Columbia, District of Columbia",106,92,4,0,4,0,3,3,106,99,87,4,0,4,0,2,2,7,5,0,0,0,0,1,1,110010003001009,2,206,206,2,psa_29,2D2
1000000US110010044002002,"Block 2002, Block Group 2, Census Tract 44, District of Columbia, District of Columbia",145,82,56,0,5,0,0,2,145,138,76,55,0,5,0,0,2,7,6,1,0,0,0,0,0,110010044002002,3,305,305,3,psa_32,3D2
1000000US110010101001014,"Block 1014, Block Group 1, Census Tract 101, District of Columbia, District of Columbia",4,0,4,0,0,0,0,0,4,4,0,4,0,0,0,0,0,0,0,0,0,0,0,0,0,110010101001014,2,209,209,2,psa_57,2D3
1000000US110010098112001,"Block 2001, Block Group 2, Census Tract 98.11, District of Columbia, District of Columbia",314,0,310,2,0,0,0,2,314,311,0,308,2,0,0,0,1,3,0,2,0,0,0,0,1,110010098112001,7,706,706,7,psa_2,7D3
1000000US110010101001001,"Block 1001, Block Group 1, Census Tract 101, District of Columbia, District of Columbia",201,154,17,0,20,0,6,4,201,182,138,17,0,20,0,3,4,19,16,0,0,0,0,3,0,110010101001001,2,209,209,2,psa_57,2D3
1000000US110010092011014,"Block 1014, Block Group 1, Census Tract 92.01, District of Columbia, District of Columbia",164,19,132,0,1,0,12,0,164,142,13,128,0,1,0,0,0,22,6,4,0,0,0,12,0,110010092011014,5,502,502,5,psa_40,5D1
1000000US110010093014008,"Block 4008, Block Group 4, Census Tract 93.01, District of Columbia, District of Columbia",55,18,34,0,3,0,0,0,55,54,18,33,0,3,0,0,0,1,0,1,0,0,0,0,0,110010093014008,5,504,504,5,psa_43,5D2
1000000US110010013011019,"Block 1019, Block Group 1, Census Tract 13.01, District of Columbia, District of Columbia",979,728,70,0,142,0,13,26,979,914,677,69,0,141,0,3,24,65,51,1,0,1,0,10,2,110010013011019,2,203,203,2,psa_50,2D1
1000000US110010013023003,"Block 3003, Block Group 3, Census Tract 13.02, District of Columbia, District of Columbia",14,14,0,0,0,0,0,0,14,12,12,0,0,0,0,0,0,2,2,0,0,0,0,0,0,110010013023003,2,203,203,2,psa_50,2D1
1000000US110010008013032,"Block 3032, Block Group 3, Census Tract 8.01, District of Columbia, District of Columbia",73,66,0,0,5,0,0,2,73,72,65,0,0,5,0,0,2,1,1,0,0,0,0,0,0,110010008013032,2,205,205,2,psa_46,2D2
1000000US110010035001004,"Block 1004, Block Group 1, Census Tract 35, District of Columbia, District of Columbia",192,80,70,2,6,0,26,8,192,142,69,60,0,6,0,0,7,50,11,10,2,0,0,26,1,110010035001004,3,304,304,3,psa_36,3D1
1000000US110010048021001,"Block 1001, Block Group 1, Census Tract 48.02, District of Columbia, District of Columbia",159,86,44,0,11,0,11,7,159,141,76,44,0,11,0,3,7,18,10,0,0,0,0,8,0,110010048021001,3,308,308,3,psa_27,3D2
1000000US110010092032009,"Block 2009, Block Group 2, Census Tract 92.03, District of Columbia, District of Columbia",89,36,42,1,6,0,0,4,89,84,33,41,0,6,0,0,4,5,3,1,1,0,0,0,0,110010092032009,5,502,502,5,psa_40,5D1
1000000US110010096031000,"Block 1000, Block Group 1, Census Tract 96.03, District of Columbia, District of Columbia",923,8,886,0,3,0,12,14,923,905,4,883,0,3,0,2,13,18,4,3,0,0,0,10,1,110010096031000,6,603,603,6,psa_15,6D3
1000000US110010076033004,"Block 3004, Block Group 3, Census Tract 76.03, District of Columbia, District of Columbia",61,5,55,1,0,0,0,0,61,60,5,55,0,0,0,0,0,1,0,0,1,0,0,0,0,110010076033004,6,606,606,6,psa_7,6D2
1000000US110010089032004,"Block 2004, Block Group 2, Census Tract 89.03, District of Columbia, District of Columbia",5,1,4,0,0,0,0,0,5,4,0,4,0,0,0,0,0,1,1,0,0,0,0,0,0,110010089032004,5,507,507,5,psa_23,5D3
1000000US110010062021062,"Block 1062, Block Group 1, Census Tract 62.02, District of Columbia, District of Columbia",0,0,0,0,0,0,0,0,0,0,0,0,0,0,0,0,0,0,0,0,0,0,0,0,0,110010062021062,2,207,207,2,psa_24,2D3
1000000US110010091023003,"Block 3003, Block Group 3, Census Tract 91.02, District of Columbia, District of Columbia",201,8,193,0,0,0,0,0,201,201,8,193,0,0,0,0,0,0,0,0,0,0,0,0,0,110010091023003,5,505,505,5,psa_34,5D2
1000000US110010001004036,"Block 4036, Block Group 4, Census Tract 1, District of Columbia, District of Columbia",0,0,0,0,0,0,0,0,0,0,0,0,0,0,0,0,0,0,0,0,0,0,0,0,0,110010001004036,2,206,206,2,psa_29,2D2
1000000US110010102002035,"Block 2035, Block Group 2, Census Tract 102, District of Columbia, District of Columbia",0,0,0,0,0,0,0,0,0,0,0,0,0,0,0,0,0,0,0,0,0,0,0,0,0,110010102002035,1,103,103,1,psa_12,1D1
1000000US110010103002012,"Block 2012, Block Group 2, Census Tract 103, District of Columbia, District of Columbia",106,12,87,0,4,0,0,3,106,102,9,87,0,4,0,0,2,4,3,0,0,0,0,0,1,110010103002012,4,401,401,4,psa_56,4D1
1000000US110010111001000,"Block 1000, Block Group 1, Census Tract 111, District of Columbia, District of Columbia",100,24,76,0,0,0,0,0,100,88,12,76,0,0,0,0,0,12,12,0,0,0,0,0,0,110010111001000,5,503,503,5,psa_45,5D2
1000000US110010078091004,"Block 1004, Block Group 1, Census Tract 78.09, District of Columbia, District of Columbia",127,0,125,1,0,0,0,1,127,127,0,125,1,0,0,0,1,0,0,0,0,0,0,0,0,110010078091004,6,608,608,6,psa_19,6D1
1000000US110010092032006,"Block 2006, Block Group 2, Census Tract 92.03, District of Columbia, District of Columbia",502,67,385,3,11,2,23,11,502,439,58,359,2,10,2,0,8,63,9,26,1,1,0,23,3,110010092032006,5,502,502,5,psa_40,5D1
1000000US110010098072004,"Block 2004, Block Group 2, Census Tract 98.07, District of Columbia, District of Columbia",0,0,0,0,0,0,0,0,0,0,0,0,0,0,0,0,0,0,0,0,0,0,0,0,0,110010098072004,7,708,708,7,psa_1,7D3
1000000US110010102001005,"Block 1005, Block Group 1, Census Tract 102, District of Columbia, District of Columbia",0,0,0,0,0,0,0,0,0,0,0,0,0,0,0,0,0,0,0,0,0,0,0,0,0,110010102001005,1,103,103,1,psa_12,1D1
1000000US110010106003004,"Block 3004, Block Group 3, Census Tract 106, District of Columbia, District of Columbia",130,46,84,0,0,0,0,0,130,130,46,84,0,0,0,0,0,0,0,0,0,0,0,0,0,110010106003004,5,501,501,5,psa_35,5D1
1000000US110010089032001,"Block 2001, Block Group 2, Census Tract 89.03, District of Columbia, District of Columbia",193,10,175,0,0,0,0,8,193,190,8,174,0,0,0,0,8,3,2,1,0,0,0,0,0,110010089032001,5,507,507,5,psa_23,5D3
1000000US110010095052004,"Block 2004, Block Group 2, Census Tract 95.05, District of Columbia, District of Columbia",52,2,49,0,0,0,0,1,52,51,2,48,0,0,0,0,1,1,0,1,0,0,0,0,0,110010095052004,4,406,406,4,psa_54,4D2
1000000US110010068022015,"Block 2015, Block Group 2, Census Tract 68.02, District of Columbia, District of Columbia",115,65,39,0,7,0,1,3,115,109,61,38,0,7,0,0,3,6,4,1,0,0,0,1,0,110010068022015,1,107,107,1,psa_16,1D2
